ERR6913179	Streptococcus sp. Marseille-Q3533	2759692	S	19440	1414	20854	0.03138
ERR6913179	Streptococcus sp. oral taxon 431	712633	S	14464	819	15283	0.02299
ERR6913179	Streptococcus sp. LPB0220	2610896	S	5628	971	6599	0.00993
ERR6913179	Streptococcus sp. oral taxon 061	712623	S	5586	680	6266	0.00943
ERR6913179	Streptococcus sp. Marseille-Q6470	2972784	S	5554	619	6173	0.00929
ERR6913179	Streptococcus sp. HSISM1	1316408	S	5404	884	6288	0.00946
ERR6913179	Streptococcus sp. A12	1759399	S	1665	173	1838	0.00277
ERR6913179	Streptococcus sp. 116-D4	2598453	S	1208	113	1321	0.00199
ERR6913179	Streptococcus sp. FDAARGOS_192	1839799	S	668	353	1021	0.00154
ERR6913179	Streptococcus sp. NPS 308	1902136	S	398	57	455	0.00068
ERR6913179	Streptococcus sp. HSISS2	1316411	S	246	152	398	0.00060
ERR6913179	Streptococcus sp. 1643	2576376	S	187	64	251	0.00038
ERR6913179	Streptococcus sp. HSISS3	1316412	S	145	84	229	0.00034
ERR6913179	Streptococcus sp. HSISS1	1316410	S	75	646	721	0.00108
ERR6913179	Streptococcus sp. oral taxon 064	712624	S	54	38	92	0.00014
ERR6913179	Streptococcus sp. NSJ-72	2763068	S	35	33	68	0.00010
ERR6913179	Streptococcus sp. FDAARGOS_522	2420310	S	17	304	321	0.00048
ERR6913179	Streptococcus sp. HN38	3020829	S	14	5	19	0.00003
ERR6913179	Streptococcus sp. zg-86	2664091	S	12	0	12	0.00002
ERR6913179	Streptococcus sp. KS 6	2598457	S	9	2	11	0.00002
ERR6913179	Streptococcus salivarius	1304	S	53429	10324	63753	0.09592
ERR6913179	Streptococcus parasanguinis	1318	S	22017	2178	24195	0.03640
ERR6913179	Streptococcus mitis	28037	S	7525	942	8467	0.01274
ERR6913179	Streptococcus oralis	1303	S	3784	719	4503	0.00677
ERR6913179	Streptococcus pneumoniae	1313	S	2622	1109	3731	0.00561
ERR6913179	Streptococcus infantis	68892	S	2291	125	2416	0.00363
ERR6913179	Streptococcus thermophilus	1308	S	1655	210	1865	0.00281
ERR6913179	Streptococcus australis	113107	S	1381	332	1713	0.00258
ERR6913179	Streptococcus lactarius	684066	S	1079	32	1111	0.00167
ERR6913179	Streptococcus intermedius	1338	S	451	59	510	0.00077
ERR6913179	Streptococcus constellatus	76860	S	173	375	548	0.00082
ERR6913179	Streptococcus anginosus	1328	S	164	161	325	0.00049
ERR6913179	Streptococcus ilei	1156431	S	800	205	1005	0.00151
ERR6913179	Streptococcus pseudopneumoniae	257758	S	627	103	730	0.00110
ERR6913179	Streptococcus sanguinis	1305	S	606	15	621	0.00093
ERR6913179	Streptococcus gwangjuense	1433513	S	533	90	623	0.00094
ERR6913179	Streptococcus gordonii	1302	S	478	11	489	0.00074
ERR6913179	Streptococcus toyakuensis	2819619	S	469	103	572	0.00086
ERR6913179	Streptococcus rubneri	1234680	S	449	88	537	0.00081
ERR6913179	Streptococcus koreensis	2382163	S	369	113	482	0.00073
ERR6913179	Streptococcus vestibularis	1343	S	337	33	370	0.00056
ERR6913179	Streptococcus cristatus	45634	S	242	11	253	0.00038
ERR6913179	Streptococcus suis	1307	S	174	26	200	0.00030
ERR6913179	Streptococcus agalactiae	1311	S	163	289	452	0.00068
ERR6913179	Streptococcus equi	1336	S	78	2	80	0.00012
ERR6913179	Streptococcus dysgalactiae	1334	S	14	1	15	0.00002
ERR6913179	Streptococcus pyogenes	1314	S	87	2	89	0.00013
ERR6913179	Streptococcus pseudoporcinus	361101	S	49	1	50	0.00008
ERR6913179	Streptococcus milleri	33040	S	42	26	68	0.00010
ERR6913179	Streptococcus acidominimus	1326	S	36	0	36	0.00005
ERR6913179	Streptococcus porcinus	1340	S	34	0	34	0.00005
ERR6913179	Streptococcus pluranimalium	82348	S	34	0	34	0.00005
ERR6913179	Streptococcus iniae	1346	S	33	0	33	0.00005
ERR6913179	Streptococcus parauberis	1348	S	32	0	32	0.00005
ERR6913179	Streptococcus ferus	1345	S	31	0	31	0.00005
ERR6913179	Streptococcus canis	1329	S	31	0	31	0.00005
ERR6913179	Streptococcus mutans	1309	S	30	4	34	0.00005
ERR6913179	Streptococcus respiraculi	2021971	S	30	0	30	0.00005
ERR6913179	Streptococcus himalayensis	1888195	S	29	0	29	0.00004
ERR6913179	Streptococcus oriscaviae	2781599	S	25	0	25	0.00004
ERR6913179	Streptococcus equinus	1335	S	24	1	25	0.00004
ERR6913179	Streptococcus sobrinus	1310	S	23	0	23	0.00003
ERR6913179	Streptococcus marmotae	1825069	S	19	0	19	0.00003
ERR6913179	Streptococcus halotolerans	1814128	S	18	0	18	0.00003
ERR6913179	Streptococcus periodonticum	2490633	S	17	6	23	0.00003
ERR6913179	Streptococcus alactolyticus	29389	S	17	0	17	0.00003
ERR6913179	Streptococcus urinalis	149016	S	15	0	15	0.00002
ERR6913179	Streptococcus parasuis	1501662	S	14	3	17	0.00003
ERR6913179	Streptococcus ratti	1341	S	13	0	13	0.00002
ERR6913179	Streptococcus uberis	1349	S	11	0	11	0.00002
ERR6913179	Streptococcus ruminantium	1917441	S	11	4	15	0.00002
ERR6913179	Streptococcus gallolyticus	315405	S	10	2	12	0.00002
ERR6913179	Streptococcus merionis	400065	S	9	0	9	0.00001
ERR6913179	Streptococcus pantholopis	1811193	S	8	0	8	0.00001
ERR6913179	Streptococcus troglodytae	1111760	S	8	0	8	0.00001
ERR6913179	Streptococcus chenjunshii	2173853	S	7	0	7	0.00001
ERR6913179	Streptococcus pasteurianus	197614	S	7	16	23	0.00003
ERR6913179	Streptococcus infantarius	102684	S	6	1	7	0.00001
ERR6913179	Streptococcus lutetiensis	150055	S	6	1	7	0.00001
ERR6913179	Streptococcus macedonicus	59310	S	5	5	10	0.00002
ERR6913179	Streptococcus halichoeri	254785	S	5	0	5	0.00001
ERR6913179	Lactococcus lactis	1358	S	970	332	1302	0.00196
ERR6913179	Lactococcus cremoris	1359	S	441	124	565	0.00085
ERR6913179	Lactococcus raffinolactis	1366	S	7	0	7	0.00001
ERR6913179	Floricoccus penangensis	1859475	S	6	0	6	0.00001
ERR6913179	Granulicatella adiacens	46124	S	2182	58	2240	0.00337
ERR6913179	Granulicatella elegans	137732	S	41	2	43	0.00006
ERR6913179	Carnobacterium divergens	2748	S	8	0	8	0.00001
ERR6913179	Carnobacterium maltaromaticum	2751	S	5	0	5	0.00001
ERR6913179	Jeotgalibaca dankookensis	708126	S	6	1	7	0.00001
ERR6913179	Dolosigranulum pigrum	29394	S	16	0	16	0.00002
ERR6913179	Marinilactibacillus sp. 15R	1911586	S	6	0	6	0.00001
ERR6913179	Lactobacillus iners	147802	S	16	0	16	0.00002
ERR6913179	Lactobacillus sp. 3B(2020)	2695882	S	5	2	7	0.00001
ERR6913179	Lactobacillus ultunensis	227945	S	6	0	6	0.00001
ERR6913179	Lactobacillus delbrueckii	1584	S	6	2	8	0.00001
ERR6913179	Lactobacillus gasseri	1596	S	6	8	14	0.00002
ERR6913179	Lactobacillus crispatus	47770	S	5	0	5	0.00001
ERR6913179	Leuconostoc mesenteroides	1245	S	11	11	22	0.00003
ERR6913179	Ligilactobacillus salivarius	1624	S	7	0	7	0.00001
ERR6913179	Ligilactobacillus murinus	1622	S	5	3	8	0.00001
ERR6913179	Weissella soli	155866	S	6	2	8	0.00001
ERR6913179	Limosilactobacillus reuteri	1598	S	5	0	5	0.00001
ERR6913179	Lactiplantibacillus plantarum	1590	S	8	6	14	0.00002
ERR6913179	Pediococcus claussenii	187452	S	8	2	10	0.00002
ERR6913179	Apilactobacillus bombintestini	2419772	S	9	0	9	0.00001
ERR6913179	Fructilactobacillus sanfranciscensis	1625	S	5	0	5	0.00001
ERR6913179	Schleiferilactobacillus harbinensis	304207	S	6	0	6	0.00001
ERR6913179	Paucilactobacillus nenjiangensis	1296540	S	5	1	6	0.00001
ERR6913179	Enterococcus faecalis	1351	S	30	11	41	0.00006
ERR6913179	Enterococcus faecium	1352	S	11	14	25	0.00004
ERR6913179	Enterococcus raffinosus	71452	S	10	0	10	0.00002
ERR6913179	Enterococcus cecorum	44008	S	9	0	9	0.00001
ERR6913179	Enterococcus mundtii	53346	S	9	0	9	0.00001
ERR6913179	Enterococcus casseliflavus	37734	S	6	2	8	0.00001
ERR6913179	Enterococcus gilvus	160453	S	6	0	6	0.00001
ERR6913179	Vagococcus lutrae	81947	S	8	1	9	0.00001
ERR6913179	Vagococcus xieshaowenii	2562451	S	7	2	9	0.00001
ERR6913179	Abiotrophia defectiva	46125	S	24	0	24	0.00004
ERR6913179	Ignavigranum ruoffiae	89093	S	5	0	5	0.00001
ERR6913179	Gemella sanguinis	84135	S	5953	245	6198	0.00933
ERR6913179	Gemella haemolysans	1379	S	756	23	779	0.00117
ERR6913179	Gemella morbillorum	29391	S	147	8	155	0.00023
ERR6913179	Gemella sp. zg-570	2840371	S	9	0	9	0.00001
ERR6913179	Gemella sp. oral taxon 928	1785995	S	6	14	20	0.00003
ERR6913179	Bacillus cereus	1396	S	16	46	62	0.00009
ERR6913179	Bacillus thuringiensis	1428	S	7	8	15	0.00002
ERR6913179	Bacillus mycoides	1405	S	5	5	10	0.00002
ERR6913179	Bacillus sp. ZJS3	2928154	S	8	8	16	0.00002
ERR6913179	Bacillus sp. Y1	352858	S	5	0	5	0.00001
ERR6913179	Bacillus sp. S3	486398	S	5	0	5	0.00001
ERR6913179	Bacillus badius	1455	S	7	0	7	0.00001
ERR6913179	Bacillus weihaiensis	1547283	S	7	0	7	0.00001
ERR6913179	Bacillus pumilus	1408	S	5	1	6	0.00001
ERR6913179	Anoxybacillus flavithermus	33934	S	10	5	15	0.00002
ERR6913179	Anoxybacillus caldiproteolyticus	247480	S	7	0	7	0.00001
ERR6913179	Oceanobacillus oncorhynchi	545501	S	7	1	8	0.00001
ERR6913179	Cytobacillus solani	1637975	S	6	0	6	0.00001
ERR6913179	Priestia megaterium	1404	S	13	32	45	0.00007
ERR6913179	Peribacillus psychrosaccharolyticus	1407	S	5	0	5	0.00001
ERR6913179	Halobacillus mangrovi	402384	S	5	0	5	0.00001
ERR6913179	Neobacillus mesonae	1193713	S	5	0	5	0.00001
ERR6913179	Heyndrickxia oleronia	38875	S	6	0	6	0.00001
ERR6913179	Paraliobacillus zengyii	2213194	S	7	0	7	0.00001
ERR6913179	Pradoshia sp. D12	2651284	S	7	0	7	0.00001
ERR6913179	Weizmannia coagulans	1398	S	5	2	7	0.00001
ERR6913179	Alkalihalophilus pseudofirmus	79885	S	5	0	5	0.00001
ERR6913179	Allobacillus halotolerans	570278	S	5	0	5	0.00001
ERR6913179	Paenibacillus guangzhouensis	1473112	S	11	0	11	0.00002
ERR6913179	Paenibacillus polymyxa	1406	S	9	27	36	0.00005
ERR6913179	Paenibacillus larvae	1464	S	7	126	133	0.00020
ERR6913179	Paenibacillus ihbetae	1870820	S	6	0	6	0.00001
ERR6913179	Paenibacillus baekrokdamisoli	1712516	S	6	0	6	0.00001
ERR6913179	Paenibacillus odorifer	189426	S	6	0	6	0.00001
ERR6913179	Paenibacillus antarcticus	253703	S	5	0	5	0.00001
ERR6913179	Brevibacillus sp. BB3-R1	2950604	S	6	0	6	0.00001
ERR6913179	Brevibacillus agri	51101	S	7	1	8	0.00001
ERR6913179	Brevibacillus brevis	1393	S	5	4	9	0.00001
ERR6913179	Brevibacillus laterosporus	1465	S	5	7	12	0.00002
ERR6913179	Cohnella cholangitidis	2598458	S	5	2	7	0.00001
ERR6913179	Staphylococcus saprophyticus	29385	S	10	0	10	0.00002
ERR6913179	Staphylococcus auricularis	29379	S	9	0	9	0.00001
ERR6913179	Staphylococcus aureus	1280	S	9	31	40	0.00006
ERR6913179	Staphylococcus haemolyticus	1283	S	9	5	14	0.00002
ERR6913179	Staphylococcus epidermidis	1282	S	8	3	11	0.00002
ERR6913179	Staphylococcus simulans	1286	S	7	0	7	0.00001
ERR6913179	Staphylococcus lugdunensis	28035	S	7	0	7	0.00001
ERR6913179	Staphylococcus simiae	308354	S	5	0	5	0.00001
ERR6913179	Staphylococcus schweitzeri	1654388	S	5	1	6	0.00001
ERR6913179	Mammaliicoccus sciuri	1296	S	12	2	14	0.00002
ERR6913179	Mammaliicoccus stepanovicii	643214	S	10	1	11	0.00002
ERR6913179	Macrococcus canis	1855823	S	8	3	11	0.00002
ERR6913179	Macrococcus brunensis	198483	S	5	0	5	0.00001
ERR6913179	Planococcus faecalis	1598147	S	5	3	8	0.00001
ERR6913179	Sporosarcina ureae	1571	S	6	2	8	0.00001
ERR6913179	Viridibacillus sp. JNUCC-6	2779527	S	12	1	13	0.00002
ERR6913179	Listeria innocua	1642	S	7	8	15	0.00002
ERR6913179	Listeria ivanovii	1638	S	6	0	6	0.00001
ERR6913179	Listeria monocytogenes	1639	S	6	2	8	0.00001
ERR6913179	Listeria welshimeri	1643	S	6	0	6	0.00001
ERR6913179	Listeria weihenstephanensis	1006155	S	5	0	5	0.00001
ERR6913179	Brochothrix thermosphacta	2756	S	8	0	8	0.00001
ERR6913179	Sporolactobacillus terrae	269673	S	5	0	5	0.00001
ERR6913179	Veillonella atypica	39777	S	28805	671	29476	0.04435
ERR6913179	Veillonella rogosae	423477	S	7801	562	8363	0.01258
ERR6913179	Veillonella nakazawae	2682456	S	4000	1324	5324	0.00801
ERR6913179	Veillonella parvula	29466	S	3668	135	3803	0.00572
ERR6913179	Veillonella sp. S12025-13	2682455	S	2347	686	3033	0.00456
ERR6913179	Veillonella dispar	39778	S	2171	328	2499	0.00376
ERR6913179	Veillonella rodentium	248315	S	440	6	446	0.00067
ERR6913179	Megasphaera stantonii	2144175	S	138	16	154	0.00023
ERR6913179	Megasphaera hexanoica	1675036	S	130	35	165	0.00025
ERR6913179	Megasphaera massiliensis	1232428	S	88	15	103	0.00015
ERR6913179	Megasphaera elsdenii	907	S	74	42	116	0.00017
ERR6913179	Dialister pneumosintes	39950	S	12	5	17	0.00003
ERR6913179	Dialister succinatiphilus	487173	S	12	10	22	0.00003
ERR6913179	Selenomonas sp. oral taxon 478	712538	S	1501	345	1846	0.00278
ERR6913179	Selenomonas sp. oral taxon 136	713030	S	1006	206	1212	0.00182
ERR6913179	Selenomonas sp. oral taxon 920	1884263	S	317	6	323	0.00049
ERR6913179	Selenomonas sp. oral taxon 126	712528	S	270	7	277	0.00042
ERR6913179	Selenomonas sputigena	69823	S	573	2	575	0.00087
ERR6913179	Selenomonas timonae	2754044	S	111	4	115	0.00017
ERR6913179	Selenomonas ruminantium	971	S	12	0	12	0.00002
ERR6913179	Megamonas funiformis	437897	S	13	0	13	0.00002
ERR6913179	Megamonas hypermegale	158847	S	8	0	8	0.00001
ERR6913179	Sporomusa termitida	2377	S	9	0	9	0.00001
ERR6913179	Phascolarctobacterium faecium	33025	S	10	3	13	0.00002
ERR6913179	Acidaminococcus intestini	187327	S	10	0	10	0.00002
ERR6913179	Lachnoanaerobaculum umeaense	617123	S	1338	11	1349	0.00203
ERR6913179	Blautia sp. NBRC 113351	2877527	S	12	2	14	0.00002
ERR6913179	Blautia sp. SC05B48	2479767	S	7	12	19	0.00003
ERR6913179	Blautia argi	1912897	S	16	1	17	0.00003
ERR6913179	Blautia obeum	40520	S	14	3	17	0.00003
ERR6913179	Blautia hansenii	1322	S	13	1	14	0.00002
ERR6913179	Blautia producta	33035	S	13	1	14	0.00002
ERR6913179	Blautia liquoris	2779518	S	10	0	10	0.00002
ERR6913179	Blautia wexlerae	418240	S	9	1	10	0.00002
ERR6913179	Butyrivibrio fibrisolvens	831	S	43	2	45	0.00007
ERR6913179	Butyrivibrio proteoclasticus	43305	S	28	3	31	0.00005
ERR6913179	Butyrivibrio crossotus	45851	S	15	0	15	0.00002
ERR6913179	Butyrivibrio hungatei	185008	S	15	2	17	0.00003
ERR6913179	Roseburia hominis	301301	S	27	2	29	0.00004
ERR6913179	Roseburia intestinalis	166486	S	25	11	36	0.00005
ERR6913179	Roseburia sp. NSJ-69	2763062	S	9	3	12	0.00002
ERR6913179	Lachnoclostridium phytofermentans	66219	S	19	0	19	0.00003
ERR6913179	[Clostridium] scindens	29347	S	18	0	18	0.00003
ERR6913179	Lachnoclostridium phocaeense	1871021	S	14	1	15	0.00002
ERR6913179	Lachnoclostridium sp. YL32	1834196	S	8	2	10	0.00002
ERR6913179	Enterocloster asparagiformis	333367	S	31	0	31	0.00005
ERR6913179	Enterocloster bolteae	208479	S	20	0	20	0.00003
ERR6913179	Enterocloster clostridioformis	1531	S	5	2	7	0.00001
ERR6913179	[Ruminococcus] gnavus	33038	S	16	318	334	0.00050
ERR6913179	[Ruminococcus] torques	33039	S	14	1	15	0.00002
ERR6913179	[Ruminococcus] lactaris	46228	S	12	0	12	0.00002
ERR6913179	Lacrimispora xylanolytica	29375	S	14	0	14	0.00002
ERR6913179	Lacrimispora sphenoides	29370	S	12	2	14	0.00002
ERR6913179	Lacrimispora saccharolytica	84030	S	12	2	14	0.00002
ERR6913179	Coprococcus comes	410072	S	16	1	17	0.00003
ERR6913179	Coprococcus catus	116085	S	8	0	8	0.00001
ERR6913179	Coprococcus eutactus	33043	S	5	0	5	0.00001
ERR6913179	Coprococcus sp. ART55/1	751585	S	5	0	5	0.00001
ERR6913179	Anaerostipes hadrus	649756	S	23	1	24	0.00004
ERR6913179	Anaerostipes caccae	105841	S	7	0	7	0.00001
ERR6913179	Dorea longicatena	88431	S	18	1	19	0.00003
ERR6913179	Dorea formicigenerans	39486	S	13	1	14	0.00002
ERR6913179	Anaerocolumna cellulosilytica	433286	S	11	0	11	0.00002
ERR6913179	Anaerocolumna chitinilytica	1727145	S	9	0	9	0.00001
ERR6913179	Anaerocolumna sedimenticola	2696063	S	7	0	7	0.00001
ERR6913179	Lachnospira eligens	39485	S	25	0	25	0.00004
ERR6913179	Anaerobutyricum hallii	39488	S	25	1	26	0.00004
ERR6913179	Pseudobutyrivibrio xylanivorans	185007	S	21	0	21	0.00003
ERR6913179	Marvinbryantia formatexigens	168384	S	21	0	21	0.00003
ERR6913179	Anaeromicropila herbilytica	2785025	S	20	0	20	0.00003
ERR6913179	Simiaoa sunii	2763672	S	16	1	17	0.00003
ERR6913179	Wansuia hejianensis	2763667	S	12	0	12	0.00002
ERR6913179	Sellimonas intestinalis	1653434	S	11	0	11	0.00002
ERR6913179	Faecalicatena sp. Marseille-Q4148	2823316	S	9	0	9	0.00001
ERR6913179	Novisyntrophococcus fermenticellae	2068655	S	9	0	9	0.00001
ERR6913179	Qiania dongpingensis	2763669	S	8	0	8	0.00001
ERR6913179	Anaerotignum propionicum	28446	S	6	0	6	0.00001
ERR6913179	[Clostridium] colinum	36835	S	6	0	6	0.00001
ERR6913179	Anaeropeptidivorans aminofermentans	2934315	S	5	0	5	0.00001
ERR6913179	Mogibacterium diversum	114527	S	1466	28	1494	0.00225
ERR6913179	Mogibacterium pumilum	86332	S	63	1	64	0.00010
ERR6913179	Emergencia timonensis	1776384	S	13	0	13	0.00002
ERR6913179	Aminipila terrae	2697030	S	6	0	6	0.00001
ERR6913179	Aminipila butyrica	433296	S	5	0	5	0.00001
ERR6913179	Fenollaria massiliensis	938288	S	6	2	8	0.00001
ERR6913179	Thermaerobacter sp. FW80	2546351	S	8	0	8	0.00001
ERR6913179	Filifactor alocis	143361	S	1156	49	1205	0.00181
ERR6913179	Peptostreptococcus sp. CBA3647	3003601	S	52	0	52	0.00008
ERR6913179	Clostridioides difficile	1496	S	36	19	55	0.00008
ERR6913179	Tepidibacter sp. 8C15b	2925782	S	12	0	12	0.00002
ERR6913179	Romboutsia hominis	1507512	S	6	0	6	0.00001
ERR6913179	Romboutsia sp. CE17	2724150	S	5	0	5	0.00001
ERR6913179	Acetoanaerobium sticklandii	1511	S	9	0	9	0.00001
ERR6913179	Peptacetobacter hiranonis	89152	S	7	0	7	0.00001
ERR6913179	Terrisporobacter hibernicus	2813371	S	5	0	5	0.00001
ERR6913179	Clostridium sp. SY8519	1042156	S	21	0	21	0.00003
ERR6913179	Clostridium sp. M62/1	411486	S	20	3	23	0.00003
ERR6913179	Clostridium sp. MD294	97138	S	7	0	7	0.00001
ERR6913179	Clostridium sp. DL-VIII	641107	S	6	1	7	0.00001
ERR6913179	Clostridium sp. BNL1100	755731	S	5	0	5	0.00001
ERR6913179	Clostridium botulinum	1491	S	31	10	41	0.00006
ERR6913179	Clostridium estertheticum	238834	S	21	0	21	0.00003
ERR6913179	Clostridium baratii	1561	S	15	0	15	0.00002
ERR6913179	Clostridium pasteurianum	1501	S	15	0	15	0.00002
ERR6913179	Clostridium butyricum	1492	S	12	18	30	0.00005
ERR6913179	Clostridium kluyveri	1534	S	12	0	12	0.00002
ERR6913179	Clostridium cadaveris	1529	S	10	0	10	0.00002
ERR6913179	Clostridium perfringens	1502	S	10	10	20	0.00003
ERR6913179	Clostridium beijerinckii	1520	S	9	6	15	0.00002
ERR6913179	Clostridium felsineum	36839	S	9	0	9	0.00001
ERR6913179	Clostridium intestinale	36845	S	9	0	9	0.00001
ERR6913179	Clostridium sporogenes	1509	S	8	22	30	0.00005
ERR6913179	Clostridium tagluense	360422	S	7	0	7	0.00001
ERR6913179	Clostridium bornimense	1216932	S	7	0	7	0.00001
ERR6913179	Clostridium gelidum	704125	S	6	0	6	0.00001
ERR6913179	Clostridium novyi	1542	S	5	0	5	0.00001
ERR6913179	Clostridium argentinense	29341	S	5	0	5	0.00001
ERR6913179	Clostridium isatidis	182773	S	5	0	5	0.00001
ERR6913179	Clostridium saccharobutylicum	169679	S	5	0	5	0.00001
ERR6913179	Hungatella hathewayi	154046	S	32	0	32	0.00005
ERR6913179	Crassaminicella profunda	1286698	S	13	0	13	0.00002
ERR6913179	Crassaminicella sp. 143-21	2855394	S	10	0	10	0.00002
ERR6913179	Caloramator sp. E03	2576307	S	6	0	6	0.00001
ERR6913179	Caloramator sp. mosi_1	3023090	S	6	0	6	0.00001
ERR6913179	Candidatus Arthromitus sp. SFB-rat-Yit	1041504	S	9	3	12	0.00002
ERR6913179	Alkaliphilus metalliredigens	208226	S	6	0	6	0.00001
ERR6913179	Oceanirhabdus sp. W0125-5	2999116	S	10	0	10	0.00002
ERR6913179	Paraclostridium bifermentans	1490	S	7	0	7	0.00001
ERR6913179	Geosporobacter ferrireducens	1424294	S	5	0	5	0.00001
ERR6913179	Faecalibacterium prausnitzii	853	S	24	25	49	0.00007
ERR6913179	Ruminococcus gauvreauii	438033	S	6	0	6	0.00001
ERR6913179	Ruminococcus bicirculans	1160721	S	6	0	6	0.00001
ERR6913179	Ruminococcus albus	1264	S	5	0	5	0.00001
ERR6913179	Ruminococcus champanellensis	1161942	S	5	0	5	0.00001
ERR6913179	Mageeibacillus indolicus	884684	S	21	0	21	0.00003
ERR6913179	Vescimonas fastidiosa	2714353	S	11	4	15	0.00002
ERR6913179	Vescimonas coprocola	2714355	S	5	2	7	0.00001
ERR6913179	Acetivibrio thermocellus	1515	S	7	3	10	0.00002
ERR6913179	Fastidiosipila sanguinis	236753	S	12	0	12	0.00002
ERR6913179	Caproicibacterium amylolyticum	2766537	S	9	0	9	0.00001
ERR6913179	Anaerotruncus colihominis	169435	S	8	2	10	0.00002
ERR6913179	Ruminiclostridium herbifermentans	2488810	S	5	0	5	0.00001
ERR6913179	Ethanoligenens harbinense	253239	S	6	0	6	0.00001
ERR6913179	Subdoligranulum variabile	214851	S	6	0	6	0.00001
ERR6913179	Pseudoclostridium thermosuccinogenes	84032	S	5	0	5	0.00001
ERR6913179	Thermoclostridium stercorarium	1510	S	5	0	5	0.00001
ERR6913179	Flavonifractor plautii	292800	S	5	0	5	0.00001
ERR6913179	Eubacterium sp. c-25	2841037	S	12	0	12	0.00002
ERR6913179	Eubacterium sp. MSJ-33	2841528	S	6	2	8	0.00001
ERR6913179	Eubacterium hominis	2764325	S	12	0	12	0.00002
ERR6913179	Eubacterium ventriosum	39496	S	9	3	12	0.00002
ERR6913179	Acetobacterium wieringae	52694	S	12	0	12	0.00002
ERR6913179	Acetobacterium woodii	33952	S	7	0	7	0.00001
ERR6913179	Alkalibacter rhizosphaerae	2815577	S	7	0	7	0.00001
ERR6913179	Dehalobacterium formicoaceticum	51515	S	6	0	6	0.00001
ERR6913179	Desulfitobacterium dichloroeliminans	233055	S	6	0	6	0.00001
ERR6913179	Candidatus Contubernalis alkalaceticum	338645	S	7	3	10	0.00002
ERR6913179	Christensenella minuta	626937	S	6	0	6	0.00001
ERR6913179	Christensenella sp. Marseille-P3954	2086585	S	6	0	6	0.00001
ERR6913179	Caldinitratiruptor microaerophilus	671077	S	5	0	5	0.00001
ERR6913179	Desulfotomaculum nigrificans	1565	S	6	0	6	0.00001
ERR6913179	Thermoanaerobacterium sp. RBIITD	1550240	S	6	1	7	0.00001
ERR6913179	Thermoanaerobacterium thermosaccharolyticum	1517	S	5	4	9	0.00001
ERR6913179	Mahella australiensis	252966	S	7	0	7	0.00001
ERR6913179	Halothermothrix orenii	31909	S	7	0	7	0.00001
ERR6913179	Halanaerobium praevalens	2331	S	5	0	5	0.00001
ERR6913179	Anoxybacter fermentans	1323375	S	5	0	5	0.00001
ERR6913179	Koleobacter methoxysyntrophicus	2751313	S	6	0	6	0.00001
ERR6913179	Parvimonas micra	33033	S	453	18	471	0.00071
ERR6913179	Finegoldia magna	1260	S	29	1	30	0.00005
ERR6913179	Anaerococcus mediterraneensis	1870984	S	11	4	15	0.00002
ERR6913179	Anaerococcus prevotii	33034	S	5	3	8	0.00001
ERR6913179	Peptoniphilus sp. CBA3646	3016343	S	5	0	5	0.00001
ERR6913179	Peptoniphilus harei	54005	S	6	0	6	0.00001
ERR6913179	Miniphocaeibacter halophilus	2931922	S	9	0	9	0.00001
ERR6913179	Murdochiella vaginalis	1852373	S	5	0	5	0.00001
ERR6913179	Keratinibaculum paraultunense	1278232	S	11	0	11	0.00002
ERR6913179	Acidilutibacter cellobiosedens	2507161	S	8	0	8	0.00001
ERR6913179	Gottschalkia acidurici	1556	S	5	0	5	0.00001
ERR6913179	Ezakiella coagulans	46507	S	13	2	15	0.00002
ERR6913179	Sedimentibacter sp. zth1	2816908	S	7	0	7	0.00001
ERR6913179	Bulleidia sp. zg-1006	2806552	S	115	2	117	0.00018
ERR6913179	Erysipelothrix sp. HDW6B	2714929	S	5	4	9	0.00001
ERR6913179	Faecalitalea cylindroides	39483	S	9	1	10	0.00002
ERR6913179	Amedibacterium intestinale	2583452	S	9	1	10	0.00002
ERR6913179	Longicatena caecimuris	1796635	S	6	1	7	0.00001
ERR6913179	Faecalibacillus intestinalis	1982626	S	6	1	7	0.00001
ERR6913179	[Clostridium] innocuum	1522	S	14	0	14	0.00002
ERR6913179	Thomasclavelia spiroformis	29348	S	6	0	6	0.00001
ERR6913179	Thomasclavelia ramosa	1547	S	5	0	5	0.00001
ERR6913179	Catenibacterium mitsuokai	100886	S	14	0	14	0.00002
ERR6913179	Turicibacter sanguinis	154288	S	6	1	7	0.00001
ERR6913179	Schaalia odontolytica	1660	S	10146	453	10599	0.01595
ERR6913179	Schaalia meyeri	52773	S	519	25	544	0.00082
ERR6913179	Schaalia turicensis	131111	S	68	3	71	0.00011
ERR6913179	Schaalia cardiffensis	181487	S	68	1	69	0.00010
ERR6913179	Schaalia sp. 19OD2882	2794089	S	33	0	33	0.00005
ERR6913179	Schaalia sp. ZJ405	2709403	S	18	0	18	0.00003
ERR6913179	Schaalia sp. JY-X169	2758572	S	11	0	11	0.00002
ERR6913179	Schaalia radingae	131110	S	6	0	6	0.00001
ERR6913179	Actinomyces pacaensis	1852377	S	4578	74	4652	0.00700
ERR6913179	Actinomyces sp. oral taxon 414	712122	S	37	2	39	0.00006
ERR6913179	Actinomyces sp. oral taxon 169	712116	S	24	16	40	0.00006
ERR6913179	Actinomyces sp. oral taxon 171	706438	S	16	4	20	0.00003
ERR6913179	Actinomyces sp. HMT 175	2789425	S	10	16	26	0.00004
ERR6913179	Actinomyces sp. MAS-1	2755559	S	7	0	7	0.00001
ERR6913179	Actinomyces sp. Z16	2079536	S	5	0	5	0.00001
ERR6913179	Actinomyces sp. zg-332	2708340	S	5	0	5	0.00001
ERR6913179	Actinomyces oris	544580	S	35	22	57	0.00009
ERR6913179	Actinomyces naeslundii	1655	S	24	3	27	0.00004
ERR6913179	Actinomyces trachealis	2763540	S	15	0	15	0.00002
ERR6913179	Actinomyces radicidentis	111015	S	11	0	11	0.00002
ERR6913179	Actinomyces qiguomingii	2057800	S	11	0	11	0.00002
ERR6913179	Actinomyces slackii	52774	S	8	0	8	0.00001
ERR6913179	Actinomyces faecalis	2722820	S	8	0	8	0.00001
ERR6913179	Actinomyces marmotae	2737173	S	7	1	8	0.00001
ERR6913179	Actinomyces viscosus	1656	S	6	0	6	0.00001
ERR6913179	Actinomyces procaprae	2560010	S	6	0	6	0.00001
ERR6913179	Pauljensenia hongkongensis	178339	S	159	8	167	0.00025
ERR6913179	Arcanobacterium haemolyticum	28264	S	9	0	9	0.00001
ERR6913179	Nanchangia anserum	2692125	S	16	0	16	0.00002
ERR6913179	Trueperella pecoris	2733571	S	6	0	6	0.00001
ERR6913179	Boudabousia tangfeifanii	1912795	S	8	0	8	0.00001
ERR6913179	Winkia neuii	33007	S	7	0	7	0.00001
ERR6913179	Fannyhessea vaginae	82135	S	7	0	7	0.00001
ERR6913179	Flaviflexus salsibiostraticola	1282737	S	5	0	5	0.00001
ERR6913179	Rothia mucilaginosa	43675	S	9368	184	9552	0.01437
ERR6913179	Rothia aeria	172042	S	315	8	323	0.00049
ERR6913179	Rothia dentocariosa	2047	S	222	7	229	0.00034
ERR6913179	Rothia terrae	396015	S	5	0	5	0.00001
ERR6913179	Arthrobacter alpinus	656366	S	6	0	6	0.00001
ERR6913179	Arthrobacter sulfonylureivorans	2486855	S	5	0	5	0.00001
ERR6913179	Kocuria rhizophila	72000	S	30	2	32	0.00005
ERR6913179	Kocuria palustris	71999	S	6	0	6	0.00001
ERR6913179	Microbacterium protaetiae	2509458	S	5	23	28	0.00004
ERR6913179	Leucobacter muris	1935379	S	7	6	13	0.00002
ERR6913179	Leucobacter viscericola	2714935	S	5	0	5	0.00001
ERR6913179	Agromyces badenianii	2080742	S	5	8	13	0.00002
ERR6913179	Cellulomonas sp. zg.Y908	2968085	S	6	2	8	0.00001
ERR6913179	Cellulomonas sp. NS3	2973977	S	6	0	6	0.00001
ERR6913179	Brachybacterium huguangmaarense	1652028	S	5	1	6	0.00001
ERR6913179	Janibacter limosus	53458	S	7	1	8	0.00001
ERR6913179	Corynebacterium matruchotii	43768	S	10	1	11	0.00002
ERR6913179	Corynebacterium hindlerae	699041	S	6	3	9	0.00001
ERR6913179	Corynebacterium argentoratense	42817	S	5	2	7	0.00001
ERR6913179	Corynebacterium pseudodiphtheriticum	37637	S	5	17	22	0.00003
ERR6913179	Rhodococcus qingshengii	334542	S	5	41	46	0.00007
ERR6913179	Nocardia asteroides	1824	S	5	2	7	0.00001
ERR6913179	Cutibacterium acnes	1747	S	204	15	219	0.00033
ERR6913179	Cutibacterium avidum	33010	S	5	0	5	0.00001
ERR6913179	Arachnia propionica	1750	S	26	1	27	0.00004
ERR6913179	Arachnia rubra	1547448	S	13	1	14	0.00002
ERR6913179	Acidipropionibacterium acidipropionici	1748	S	5	2	7	0.00001
ERR6913179	Vaginimicrobium propionicum	1871034	S	7	0	7	0.00001
ERR6913179	Pimelobacter simplex	2045	S	5	1	6	0.00001
ERR6913179	Streptomyces griseochromogenes	68214	S	6	21	27	0.00004
ERR6913179	Streptomyces coeruleorubidus	116188	S	5	45	50	0.00008
ERR6913179	Kitasatospora sp. YST-16	2998080	S	5	1	6	0.00001
ERR6913179	Streptacidiphilus sp. P02-A3a	2704468	S	5	0	5	0.00001
ERR6913179	Amycolatopsis thermalba	944492	S	7	3	10	0.00002
ERR6913179	Bifidobacterium longum	216816	S	8	7	15	0.00002
ERR6913179	Bifidobacterium dentium	1689	S	7	1	8	0.00001
ERR6913179	Bifidobacterium breve	1685	S	6	3	9	0.00001
ERR6913179	Gardnerella vaginalis	2702	S	9	6	15	0.00002
ERR6913179	Candidatus Planktophila sulfonica	1884904	S	6	3	9	0.00001
ERR6913179	Frankia casuarinae	106370	S	6	1	7	0.00001
ERR6913179	Lancefieldella parvula	1382	S	2389	16	2405	0.00362
ERR6913179	Olsenella uli	133926	S	30	1	31	0.00005
ERR6913179	Olsenella timonensis	1805478	S	12	0	12	0.00002
ERR6913179	Olsenella sp. oral taxon 807	712411	S	7	0	7	0.00001
ERR6913179	Atopobium sp. oral taxon 416	712157	S	11	0	11	0.00002
ERR6913179	Thermophilibacter immobilis	2779519	S	9	0	9	0.00001
ERR6913179	Parafannyhessea umbonata	604330	S	8	0	8	0.00001
ERR6913179	Collinsella aerofaciens	74426	S	20	1	21	0.00003
ERR6913179	Collinsella stercoris	147206	S	13	0	13	0.00002
ERR6913179	Raoultibacter timonensis	1907662	S	7	0	7	0.00001
ERR6913179	Slackia heliotrinireducens	84110	S	6	0	6	0.00001
ERR6913179	Arabiibacter massiliensis	1870985	S	6	0	6	0.00001
ERR6913179	Nostoc linckia	92942	S	6	6	12	0.00002
ERR6913179	Anabaenopsis circularis	109266	S	8	7	15	0.00002
ERR6913179	Sphaerospermopsis kisseleviana	289435	S	5	2	7	0.00001
ERR6913179	Fischerella sp. NIES-3754	1752063	S	5	1	6	0.00001
ERR6913179	Prochlorococcus marinus	1219	S	10	2	12	0.00002
ERR6913179	Mesomycoplasma ovipneumoniae	29562	S	5	1	6	0.00001
ERR6913179	Mesomycoplasma dispar	86660	S	5	0	5	0.00001
ERR6913179	Spiroplasma chinense	216932	S	5	3	8	0.00001
ERR6913179	Spiroplasma platyhelix	301585	S	5	0	5	0.00001
ERR6913179	Metamycoplasma salivarium	2124	S	31	0	31	0.00005
ERR6913179	Deinococcus sp. TS-293	2737050	S	5	0	5	0.00001
ERR6913179	Deinococcus peraridilitoris	432329	S	7	0	7	0.00001
ERR6913179	Dehalococcoides mccartyi	61435	S	5	5	10	0.00002
ERR6913179	Prevotella melaninogenica	28132	S	105736	9920	115656	0.17401
ERR6913179	Prevotella jejuni	1177574	S	24273	1462	25735	0.03872
ERR6913179	Prevotella nigrescens	28133	S	17260	1786	19046	0.02866
ERR6913179	Prevotella oris	28135	S	7685	148	7833	0.01178
ERR6913179	Prevotella histicola	470565	S	6587	147	6734	0.01013
ERR6913179	Prevotella intermedia	28131	S	6347	430	6777	0.01020
ERR6913179	Prevotella veroralis	28137	S	4902	173	5075	0.00764
ERR6913179	Prevotella sp. oral taxon 475	712471	S	1413	24	1437	0.00216
ERR6913179	Prevotella sp. oral taxon 299	652716	S	632	12	644	0.00097
ERR6913179	Prevotella sp. Rep29	2691580	S	84	3	87	0.00013
ERR6913179	Prevotella sp. E13-17	2913616	S	80	20	100	0.00015
ERR6913179	Prevotella sp. E9-3	2913621	S	72	17	89	0.00013
ERR6913179	Prevotella sp. E2-28	2913620	S	60	23	83	0.00012
ERR6913179	Prevotella sp. E15-22	2937774	S	58	27	85	0.00013
ERR6913179	Prevotella scopos	589437	S	1313	100	1413	0.00213
ERR6913179	Prevotella denticola	28129	S	1300	74	1374	0.00207
ERR6913179	Prevotella corporis	28128	S	590	19	609	0.00092
ERR6913179	Prevotella fusca	589436	S	527	17	544	0.00082
ERR6913179	Prevotella copri	165179	S	203	2	205	0.00031
ERR6913179	Prevotella bryantii	77095	S	190	0	190	0.00029
ERR6913179	Prevotella multiformis	282402	S	179	11	190	0.00029
ERR6913179	Prevotella herbatica	2801997	S	179	0	179	0.00027
ERR6913179	Prevotella dentalis	52227	S	173	3	176	0.00026
ERR6913179	Prevotella ruminicola	839	S	93	0	93	0.00014
ERR6913179	Hoylesella enoeca	76123	S	2783	121	2904	0.00437
ERR6913179	Hoylesella buccalis	28127	S	369	46	415	0.00062
ERR6913179	Pseudoprevotella muciniphila	2133944	S	74	0	74	0.00011
ERR6913179	Paraprevotella xylaniphila	454155	S	40	1	41	0.00006
ERR6913179	Porphyromonas endodontalis	28124	S	20049	455	20504	0.03085
ERR6913179	Porphyromonas gingivalis	837	S	617	64	681	0.00102
ERR6913179	Porphyromonas sp. oral taxon 275	712435	S	208	0	208	0.00031
ERR6913179	Porphyromonas somerae	322095	S	46	1	47	0.00007
ERR6913179	Porphyromonas crevioricanis	393921	S	45	0	45	0.00007
ERR6913179	Porphyromonas cangingivalis	36874	S	42	0	42	0.00006
ERR6913179	Porphyromonas asaccharolytica	28123	S	36	0	36	0.00005
ERR6913179	Tannerella serpentiformis	712710	S	16194	69	16263	0.02447
ERR6913179	Tannerella forsythia	28112	S	1206	93	1299	0.00195
ERR6913179	Parabacteroides distasonis	823	S	49	20	69	0.00010
ERR6913179	Parabacteroides faecis	1217282	S	26	0	26	0.00004
ERR6913179	Parabacteroides goldsteinii	328812	S	17	0	17	0.00003
ERR6913179	Parabacteroides merdae	46503	S	13	1	14	0.00002
ERR6913179	Parabacteroides johnsonii	387661	S	10	0	10	0.00002
ERR6913179	Bacteroides fragilis	817	S	74	74	148	0.00022
ERR6913179	Bacteroides eggerthii	28111	S	69	10	79	0.00012
ERR6913179	Bacteroides heparinolyticus	28113	S	69	14	83	0.00012
ERR6913179	Bacteroides thetaiotaomicron	818	S	48	12	60	0.00009
ERR6913179	Bacteroides zoogleoformans	28119	S	36	8	44	0.00007
ERR6913179	Bacteroides salyersiae	291644	S	35	2	37	0.00006
ERR6913179	Bacteroides stercoris	46506	S	31	3	34	0.00005
ERR6913179	Bacteroides coprosuis	151276	S	29	0	29	0.00004
ERR6913179	Bacteroides helcogenes	290053	S	29	0	29	0.00004
ERR6913179	Bacteroides caccae	47678	S	28	5	33	0.00005
ERR6913179	Bacteroides faecis	674529	S	22	7	29	0.00004
ERR6913179	Bacteroides nordii	291645	S	21	1	22	0.00003
ERR6913179	Bacteroides faecium	2715212	S	19	1	20	0.00003
ERR6913179	Bacteroides cellulosilyticus	246787	S	15	14	29	0.00004
ERR6913179	Bacteroides uniformis	820	S	15	37	52	0.00008
ERR6913179	Bacteroides intestinalis	329854	S	15	3	18	0.00003
ERR6913179	Bacteroides luhongzhouii	2650158	S	15	10	25	0.00004
ERR6913179	Bacteroides zhangwenhongii	2650157	S	14	3	17	0.00003
ERR6913179	Bacteroides caecimuris	1796613	S	10	6	16	0.00002
ERR6913179	Phocaeicola vulgatus	821	S	36	17	53	0.00008
ERR6913179	Phocaeicola salanitronis	376805	S	26	0	26	0.00004
ERR6913179	Phocaeicola coprophilus	387090	S	20	1	21	0.00003
ERR6913179	Phocaeicola dorei	357276	S	18	11	29	0.00004
ERR6913179	Muribaculum intestinale	1796646	S	21	2	23	0.00003
ERR6913179	Muribaculum gordoncarteri	2530390	S	10	2	12	0.00002
ERR6913179	Duncaniella dubosii	2518971	S	8	1	9	0.00001
ERR6913179	Sodaliphilus pleomorphus	2606626	S	15	0	15	0.00002
ERR6913179	Alistipes onderdonkii	328813	S	10	2	12	0.00002
ERR6913179	Alistipes ihumii	1470347	S	9	0	9	0.00001
ERR6913179	Alistipes shahii	328814	S	8	2	10	0.00002
ERR6913179	Alistipes megaguti	2364787	S	8	0	8	0.00001
ERR6913179	Alistipes dispar	2585119	S	6	0	6	0.00001
ERR6913179	Alistipes finegoldii	214856	S	5	1	6	0.00001
ERR6913179	Alistipes senegalensis	1288121	S	5	0	5	0.00001
ERR6913179	Alistipes communis	2585118	S	5	0	5	0.00001
ERR6913179	Odoribacter splanchnicus	28118	S	36	0	36	0.00005
ERR6913179	Butyricimonas faecalis	2093856	S	8	1	9	0.00001
ERR6913179	Proteiniphilum saccharofermentans	1642647	S	9	0	9	0.00001
ERR6913179	Proteiniphilum propionicum	2829812	S	9	0	9	0.00001
ERR6913179	Dysgonomonas sp. HDW5A	2714926	S	6	3	9	0.00001
ERR6913179	Dysgonomonas sp. HDW5B	2714927	S	5	2	7	0.00001
ERR6913179	Petrimonas mucosa	1642646	S	11	0	11	0.00002
ERR6913179	Coprobacter secundus	1501392	S	22	0	22	0.00003
ERR6913179	Barnesiella viscericola	397865	S	12	0	12	0.00002
ERR6913179	Candidatus Azobacteroides pseudotrichonymphae	511435	S	14	0	14	0.00002
ERR6913179	Tenuifilum thalassicum	2590900	S	11	0	11	0.00002
ERR6913179	Paludibacter propionicigenes	185300	S	9	0	9	0.00001
ERR6913179	Salinivirga cyanobacteriivorans	1307839	S	6	0	6	0.00001
ERR6913179	Draconibacterium halophilum	2706887	S	5	0	5	0.00001
ERR6913179	Maribellus comscasis	2681766	S	6	0	6	0.00001
ERR6913179	Alkaliflexus sp. Ai-910	2949635	S	7	0	7	0.00001
ERR6913179	Capnocytophaga gingivalis	1017	S	1136	41	1177	0.00177
ERR6913179	Capnocytophaga sp. FDAARGOS_737	2545799	S	335	59	394	0.00059
ERR6913179	Capnocytophaga sp. oral taxon 878	1316596	S	101	9	110	0.00017
ERR6913179	Capnocytophaga sp. oral taxon 864	1316593	S	26	21	47	0.00007
ERR6913179	Capnocytophaga sp. oral taxon 902	2748316	S	12	17	29	0.00004
ERR6913179	Capnocytophaga sp. oral taxon 323	1705617	S	11	10	21	0.00003
ERR6913179	Capnocytophaga leadbetteri	327575	S	342	60	402	0.00060
ERR6913179	Capnocytophaga sputigena	1019	S	220	24	244	0.00037
ERR6913179	Capnocytophaga endodontalis	2708117	S	108	17	125	0.00019
ERR6913179	Capnocytophaga ochracea	1018	S	64	33	97	0.00015
ERR6913179	Capnocytophaga canimorsus	28188	S	37	3	40	0.00006
ERR6913179	Capnocytophaga haemolytica	45243	S	20	0	20	0.00003
ERR6913179	Capnocytophaga stomatis	1848904	S	12	0	12	0.00002
ERR6913179	Flavobacterium sp. IMCC34518	3003623	S	12	5	17	0.00003
ERR6913179	Flavobacterium sp. KBS0721	1179672	S	11	13	24	0.00004
ERR6913179	Flavobacterium sp. IMCC36791	3003262	S	11	2	13	0.00002
ERR6913179	Flavobacterium sp. K5-23	2746225	S	10	3	13	0.00002
ERR6913179	Flavobacterium sp. IMCC36792	3016339	S	8	3	11	0.00002
ERR6913179	Flavobacterium sp. 140616W15	2478552	S	8	2	10	0.00002
ERR6913179	Flavobacterium sp. N1846	2986824	S	7	2	9	0.00001
ERR6913179	Flavobacterium sp. IMCC36793	3003263	S	7	2	9	0.00001
ERR6913179	Flavobacterium sp. N2820	2986834	S	6	2	8	0.00001
ERR6913179	Flavobacterium sp. MFBS3-15	2989816	S	6	0	6	0.00001
ERR6913179	Flavobacterium sp. IMCC34774	3003257	S	6	1	7	0.00001
ERR6913179	Flavobacterium sp. N502536	2986837	S	5	7	12	0.00002
ERR6913179	Flavobacterium psychrophilum	96345	S	12	2	14	0.00002
ERR6913179	Flavobacterium fluviale	2249356	S	10	10	20	0.00003
ERR6913179	Flavobacterium azooxidireducens	1871076	S	10	1	11	0.00002
ERR6913179	Flavobacterium ammoniigenes	1751095	S	10	4	14	0.00002
ERR6913179	Flavobacterium faecale	1355330	S	10	1	11	0.00002
ERR6913179	Flavobacterium crassostreae	1763534	S	6	1	7	0.00001
ERR6913179	Flavobacterium gilvum	1492737	S	6	1	7	0.00001
ERR6913179	Flavobacterium covae	2906076	S	5	13	18	0.00003
ERR6913179	Flavobacterium litorale	2856519	S	5	0	5	0.00001
ERR6913179	Flavobacterium alkalisoli	2602769	S	5	0	5	0.00001
ERR6913179	Flavobacterium nackdongense	2547394	S	5	0	5	0.00001
ERR6913179	Flavobacterium album	2175091	S	5	0	5	0.00001
ERR6913179	Flavobacterium ammonificans	1751056	S	5	2	7	0.00001
ERR6913179	Polaribacter sp. KT 15	1896175	S	7	7	14	0.00002
ERR6913179	Polaribacter sp. Hel1_33_78	1336804	S	5	1	6	0.00001
ERR6913179	Polaribacter sp. NJDZ03	2855841	S	5	4	9	0.00001
ERR6913179	Polaribacter haliotis	1888915	S	5	3	8	0.00001
ERR6913179	Polaribacter pectinis	2738844	S	5	3	8	0.00001
ERR6913179	Myroides phaeus	702745	S	13	5	18	0.00003
ERR6913179	Myroides odoratus	256	S	5	2	7	0.00001
ERR6913179	Myroides albus	2562892	S	5	5	10	0.00002
ERR6913179	Cellulophaga sp. HaHaR_3_176	1942464	S	5	1	6	0.00001
ERR6913179	Cellulophaga sp. L1A9	2686362	S	5	5	10	0.00002
ERR6913179	Cellulophaga lytica	979	S	6	9	15	0.00002
ERR6913179	Tenacibaculum mesophilum	104268	S	9	5	14	0.00002
ERR6913179	Maribacter sp. HL-LV01	2976127	S	8	1	9	0.00001
ERR6913179	Maribacter sp. MJ134	2496865	S	5	0	5	0.00001
ERR6913179	Maribacter hydrothermalis	1836467	S	6	1	7	0.00001
ERR6913179	Muricauda ruestringensis	111501	S	5	1	6	0.00001
ERR6913179	Muricauda lutaonensis	516051	S	5	1	6	0.00001
ERR6913179	Gramella sp. MT6	2705471	S	5	0	5	0.00001
ERR6913179	Formosa agariphila	320324	S	5	2	7	0.00001
ERR6913179	Salegentibacter mishustinae	270918	S	8	8	16	0.00002
ERR6913179	Salegentibacter salegens	143223	S	5	0	5	0.00001
ERR6913179	Lutibacter profundi	1622118	S	7	0	7	0.00001
ERR6913179	Lacinutrix sp. WUR7	2653681	S	7	2	9	0.00001
ERR6913179	Aquimarina sp. ERC-38	2949996	S	7	0	7	0.00001
ERR6913179	Seonamhaeicola sp. ML3	2937786	S	8	1	9	0.00001
ERR6913179	Seonamhaeicola sp. S2-3	1936081	S	5	2	7	0.00001
ERR6913179	Abyssalbus ytuae	2926907	S	12	0	12	0.00002
ERR6913179	Mariniflexile sp. TRM1-10	2027857	S	10	1	11	0.00002
ERR6913179	Amniculibacterium sp. G2-70	2767188	S	10	3	13	0.00002
ERR6913179	Salinimicrobium sp. HN-2-9-2	2809707	S	9	1	10	0.00002
ERR6913179	Dokdonia sp. 4H-3-7-5	983548	S	5	3	8	0.00001
ERR6913179	Olleya aquimaris	639310	S	6	4	10	0.00002
ERR6913179	Kordia antarctica	1218801	S	5	1	6	0.00001
ERR6913179	Aequorivita sublithincola	101385	S	6	2	8	0.00001
ERR6913179	Flagellimonas sp. HMM57	2905121	S	5	0	5	0.00001
ERR6913179	Rasiella rasia	2744027	S	5	0	5	0.00001
ERR6913179	Marixanthomonas sp. SCSIO 43207	2779360	S	5	1	6	0.00001
ERR6913179	Gilvibacter sp. SZ-19	754429	S	5	0	5	0.00001
ERR6913179	Chryseobacterium sp. CX-624	2758037	S	10	3	13	0.00002
ERR6913179	Chryseobacterium sp. Y16C	2920939	S	9	6	15	0.00002
ERR6913179	Chryseobacterium sp. CY350	2997336	S	7	2	9	0.00001
ERR6913179	Chryseobacterium sp.	1871047	S	7	2	9	0.00001
ERR6913179	Chryseobacterium sp. KACC 21268	3025664	S	6	0	6	0.00001
ERR6913179	Chryseobacterium sp. MEBOG07	2879939	S	6	4	10	0.00002
ERR6913179	Chryseobacterium sp. MMS21-Ot14	2983606	S	5	1	6	0.00001
ERR6913179	Chryseobacterium sp. POL2	2713414	S	5	1	6	0.00001
ERR6913179	Chryseobacterium indologenes	253	S	22	12	34	0.00005
ERR6913179	Chryseobacterium taklimakanense	536441	S	16	5	21	0.00003
ERR6913179	Chryseobacterium camelliae	1265445	S	13	3	16	0.00002
ERR6913179	Chryseobacterium oryzae	2929799	S	8	3	11	0.00002
ERR6913179	Chryseobacterium capnotolerans	2759528	S	8	5	13	0.00002
ERR6913179	Chryseobacterium gambrini	373672	S	6	6	12	0.00002
ERR6913179	Chryseobacterium gallinarum	1324352	S	5	1	6	0.00001
ERR6913179	Chryseobacterium paludis	2956784	S	5	0	5	0.00001
ERR6913179	Chryseobacterium suipulveris	2929800	S	5	1	6	0.00001
ERR6913179	Chryseobacterium turcicum	2898076	S	5	3	8	0.00001
ERR6913179	Chryseobacterium faecale	2852098	S	5	1	6	0.00001
ERR6913179	Chryseobacterium manosquense	2754694	S	5	3	8	0.00001
ERR6913179	Chryseobacterium salivictor	2547600	S	5	0	5	0.00001
ERR6913179	Chryseobacterium glaciei	1685010	S	5	2	7	0.00001
ERR6913179	Chryseobacterium balustinum	246	S	5	3	8	0.00001
ERR6913179	Chryseobacterium indoltheticum	254	S	5	2	7	0.00001
ERR6913179	Kaistella sp. GW4-15	2878534	S	5	0	5	0.00001
ERR6913179	Kaistella sp. BT6-1-3	2989820	S	5	3	8	0.00001
ERR6913179	Kaistella flava (ex Peng et al. 2021)	2038776	S	7	1	8	0.00001
ERR6913179	Epilithonimonas vandammei	2487072	S	12	9	21	0.00003
ERR6913179	Epilithonimonas zeae	1416779	S	7	1	8	0.00001
ERR6913179	Elizabethkingia anophelis	1117645	S	6	16	22	0.00003
ERR6913179	Bergeyella cardium	1585976	S	30	2	32	0.00005
ERR6913179	Empedobacter stercoris	1628248	S	9	1	10	0.00002
ERR6913179	Empedobacter brevis	247	S	7	0	7	0.00001
ERR6913179	Cloacibacterium caeni	2004710	S	7	10	17	0.00003
ERR6913179	Riemerella anatipestifer	34085	S	12	0	12	0.00002
ERR6913179	Cruoricaptor ignavus	1118202	S	9	0	9	0.00001
ERR6913179	Blattabacterium cuenoti	1653831	S	20	7	27	0.00004
ERR6913179	Owenweeksia hongkongensis	253245	S	6	0	6	0.00001
ERR6913179	Croceimicrobium hydrocarbonivorans	2761580	S	6	0	6	0.00001
ERR6913179	Hymenobacter sp. 5116S-27	2932249	S	5	4	9	0.00001
ERR6913179	Hymenobacter oligotrophus	2319843	S	5	13	18	0.00003
ERR6913179	Pontibacter sp. SGAir0037	2571030	S	6	1	7	0.00001
ERR6913179	Fibrella sp. ES10-3-2-2	1834519	S	5	0	5	0.00001
ERR6913179	Leadbetterella byssophila	316068	S	6	1	7	0.00001
ERR6913179	Spirosoma sp. RHs26	2898794	S	8	1	9	0.00001
ERR6913179	Spirosoma taeanense	2735870	S	6	3	9	0.00001
ERR6913179	Aquirufa lenticrescens	2696560	S	7	5	12	0.00002
ERR6913179	Algoriphagus sp. Y33	2772483	S	6	3	9	0.00001
ERR6913179	Belliella baltica	232259	S	10	3	13	0.00002
ERR6913179	Aquiflexum balticum	280473	S	5	0	5	0.00001
ERR6913179	Fulvivirga sp. SW1-E11	2904247	S	15	1	16	0.00002
ERR6913179	Flammeovirga pectinis	2494373	S	12	8	20	0.00003
ERR6913179	Marivirga tractuosa	1006	S	7	2	9	0.00001
ERR6913179	Persicobacter sp. JZB09	1085624	S	6	0	6	0.00001
ERR6913179	Bernardetia litoralis	999	S	5	0	5	0.00001
ERR6913179	Sphingobacterium sp. DR205	2713573	S	8	5	13	0.00002
ERR6913179	Sphingobacterium sp. dk4302	2662364	S	6	5	11	0.00002
ERR6913179	Sphingobacterium sp. KACC 22765	3025669	S	5	0	5	0.00001
ERR6913179	Sphingobacterium spiritivorum	258	S	14	9	23	0.00003
ERR6913179	Sphingobacterium psychroaquaticum	561061	S	7	1	8	0.00001
ERR6913179	Sphingobacterium thalpophilum	259	S	5	3	8	0.00001
ERR6913179	Mucilaginibacter sp. SMC90	2929803	S	10	0	10	0.00002
ERR6913179	Mucilaginibacter sp. KACC 22063	3025666	S	6	0	6	0.00001
ERR6913179	Mucilaginibacter sp. KACC 22773	3025671	S	6	0	6	0.00001
ERR6913179	Mucilaginibacter rubeus	2027860	S	8	9	17	0.00003
ERR6913179	Mucilaginibacter mali	2740462	S	6	0	6	0.00001
ERR6913179	Mucilaginibacter ginsenosidivorax	862126	S	5	0	5	0.00001
ERR6913179	Mucilaginibacter gotjawali	1550579	S	5	0	5	0.00001
ERR6913179	Pedobacter sp. PACM 27299	1727164	S	5	0	5	0.00001
ERR6913179	Pedobacter sp. D749	2856523	S	5	2	7	0.00001
ERR6913179	Pedobacter sp. SL55	2995161	S	5	0	5	0.00001
ERR6913179	Pedobacter cryoconitis	188932	S	7	0	7	0.00001
ERR6913179	Pedobacter schmidteae	2201271	S	7	0	7	0.00001
ERR6913179	Pedobacter riviphilus	2766984	S	7	1	8	0.00001
ERR6913179	Pedobacter mucosus	2895286	S	7	0	7	0.00001
ERR6913179	Pedobacter suwonensis	332999	S	5	0	5	0.00001
ERR6913179	Olivibacter sp. LS-1	2592345	S	7	0	7	0.00001
ERR6913179	Solitalea sp. S2-8	2911172	S	5	0	5	0.00001
ERR6913179	Chitinophaga sp. XS-30	2604421	S	5	3	8	0.00001
ERR6913179	Chitinophaga sp. HK235	2952571	S	5	3	8	0.00001
ERR6913179	Chitinophaga pinensis	79329	S	7	1	8	0.00001
ERR6913179	Lacibacter sp. S13-6-22	2760713	S	10	0	10	0.00002
ERR6913179	Pseudobacter ginsenosidimutans	661488	S	6	0	6	0.00001
ERR6913179	Phnomibacter ginsenosidimutans	2676868	S	6	0	6	0.00001
ERR6913179	Paraflavitalea soli	2315862	S	5	0	5	0.00001
ERR6913179	Pseudocnuella soli	2502779	S	5	0	5	0.00001
ERR6913179	Aureispira sp. EL160426	2864201	S	5	0	5	0.00001
ERR6913179	Leptotrichia wadei	157687	S	43294	3538	46832	0.07046
ERR6913179	Leptotrichia sp. oral taxon 212	712357	S	3494	42	3536	0.00532
ERR6913179	Leptotrichia sp. oral taxon 218	712361	S	3263	580	3843	0.00578
ERR6913179	Leptotrichia sp. oral taxon 847	1785996	S	3178	327	3505	0.00527
ERR6913179	Leptotrichia sp. oral taxon 221	712362	S	2300	153	2453	0.00369
ERR6913179	Leptotrichia sp. oral taxon 498	712368	S	897	175	1072	0.00161
ERR6913179	Leptotrichia trevisanii	109328	S	2498	133	2631	0.00396
ERR6913179	Leptotrichia shahii	157691	S	1483	143	1626	0.00245
ERR6913179	Leptotrichia hofstadii	157688	S	489	42	531	0.00080
ERR6913179	Leptotrichia buccalis	40542	S	479	31	510	0.00077
ERR6913179	Leptotrichia hongkongensis	554406	S	448	38	486	0.00073
ERR6913179	Pseudoleptotrichia goodfellowii	157692	S	104	0	104	0.00016
ERR6913179	Sebaldella termitidis	826	S	7	0	7	0.00001
ERR6913179	Streptobacillus moniliformis	34105	S	5	0	5	0.00001
ERR6913179	Fusobacterium pseudoperiodonticum	2663009	S	6558	1135	7693	0.01157
ERR6913179	Fusobacterium nucleatum	851	S	1677	410	2087	0.00314
ERR6913179	Fusobacterium periodonticum	860	S	687	454	1141	0.00172
ERR6913179	Fusobacterium hwasookii	1583098	S	202	150	352	0.00053
ERR6913179	Fusobacterium canifelinum	285729	S	60	13	73	0.00011
ERR6913179	Fusobacterium necrophorum	859	S	23	0	23	0.00003
ERR6913179	Fusobacterium sp. oral taxon 203	671211	S	15	5	20	0.00003
ERR6913179	Fusobacterium ulcerans	861	S	14	0	14	0.00002
ERR6913179	Fusobacterium hominis	2764326	S	11	0	11	0.00002
ERR6913179	Fusobacterium gastrosuis	1755100	S	7	0	7	0.00001
ERR6913179	Fusobacterium gonidiaformans	849	S	6	0	6	0.00001
ERR6913179	Fusobacterium mortiferum	850	S	6	0	6	0.00001
ERR6913179	Cetobacterium somerae	188913	S	5	0	5	0.00001
ERR6913179	Neisseria mucosa	488	S	3417	445	3862	0.00581
ERR6913179	Neisseria sicca	490	S	2969	352	3321	0.00500
ERR6913179	Neisseria subflava	28449	S	1877	218	2095	0.00315
ERR6913179	Neisseria flavescens	484	S	1512	193	1705	0.00257
ERR6913179	Neisseria meningitidis	487	S	509	329	838	0.00126
ERR6913179	Neisseria macacae	496	S	198	35	233	0.00035
ERR6913179	Neisseria elongata	495	S	156	5	161	0.00024
ERR6913179	Neisseria cinerea	483	S	120	9	129	0.00019
ERR6913179	Neisseria sp. oral taxon 014	641148	S	67	2	69	0.00010
ERR6913179	Neisseria sp. ZJ785	2709396	S	17	0	17	0.00003
ERR6913179	Neisseria sp. ZJ106	2912188	S	13	0	13	0.00002
ERR6913179	Neisseria sp. KEM232	655307	S	12	0	12	0.00002
ERR6913179	Neisseria sp. Dent CA1/247	2912675	S	8	0	8	0.00001
ERR6913179	Neisseria lactamica	486	S	103	19	122	0.00018
ERR6913179	Neisseria gonorrhoeae	485	S	94	14	108	0.00016
ERR6913179	Neisseria chenwenguii	1853278	S	25	0	25	0.00004
ERR6913179	Neisseria brasiliensis	2666100	S	19	0	19	0.00003
ERR6913179	Neisseria weaveri	28091	S	13	0	13	0.00002
ERR6913179	Neisseria animaloris	326522	S	12	0	12	0.00002
ERR6913179	Neisseria animalis	492	S	12	0	12	0.00002
ERR6913179	Neisseria zalophi	640030	S	11	0	11	0.00002
ERR6913179	Neisseria bacilliformis	267212	S	10	0	10	0.00002
ERR6913179	Neisseria arctica	1470200	S	10	0	10	0.00002
ERR6913179	Neisseria musculi	1815583	S	7	0	7	0.00001
ERR6913179	Neisseria dumasiana	1931275	S	7	0	7	0.00001
ERR6913179	Neisseria dentiae	194197	S	6	0	6	0.00001
ERR6913179	Neisseria weixii	1853276	S	6	0	6	0.00001
ERR6913179	Neisseria zoodegmatis	326523	S	5	0	5	0.00001
ERR6913179	Neisseria canis	493	S	5	0	5	0.00001
ERR6913179	Eikenella corrodens	539	S	201	6	207	0.00031
ERR6913179	Eikenella exigua	2528037	S	43	1	44	0.00007
ERR6913179	Kingella oralis	505	S	17	0	17	0.00003
ERR6913179	Kingella denitrificans	502	S	12	0	12	0.00002
ERR6913179	Morococcus cerebrosus	1056807	S	21	3	24	0.00004
ERR6913179	Simonsiella muelleri	72	S	9	0	9	0.00001
ERR6913179	Wielerella bovis	2917790	S	7	0	7	0.00001
ERR6913179	Lautropia mirabilis	47671	S	114	10	124	0.00019
ERR6913179	Polynucleobacter asymbioticus	576611	S	6	2	8	0.00001
ERR6913179	Cupriavidus pauculus	82633	S	18	10	28	0.00004
ERR6913179	Cupriavidus taiwanensis	164546	S	6	9	15	0.00002
ERR6913179	Acidovorax sp. KKS102	358220	S	6	5	11	0.00002
ERR6913179	Acidovorax temperans	80878	S	7	6	13	0.00002
ERR6913179	Acidovorax carolinensis	553814	S	5	5	10	0.00002
ERR6913179	Variovorax paradoxus	34073	S	7	3	10	0.00002
ERR6913179	Variovorax boronicumulans	436515	S	5	4	9	0.00001
ERR6913179	Rhodoferax sp. AJA081-3	2752316	S	6	0	6	0.00001
ERR6913179	Rhodoferax antarcticus	81479	S	6	0	6	0.00001
ERR6913179	Rhodoferax saidenbachensis	1484693	S	6	1	7	0.00001
ERR6913179	Hydrogenophaga crassostreae	1763535	S	6	0	6	0.00001
ERR6913179	Hydrogenophaga taeniospiralis	65656	S	5	3	8	0.00001
ERR6913179	Comamonas aquatica	225991	S	5	3	8	0.00001
ERR6913179	Limnohabitans sp. 103DPR2	1678129	S	7	1	8	0.00001
ERR6913179	Ramlibacter tataouinensis	94132	S	6	2	8	0.00001
ERR6913179	Collimonas fungivorans	158899	S	30	6	36	0.00005
ERR6913179	Collimonas arenae	279058	S	20	2	22	0.00003
ERR6913179	Collimonas pratensis	279113	S	8	1	9	0.00001
ERR6913179	Janthinobacterium sp. 1_2014MBL_MicDiv	1644131	S	9	4	13	0.00002
ERR6913179	Janthinobacterium sp. HH102	1537274	S	5	14	19	0.00003
ERR6913179	Achromobacter spanius	217203	S	8	2	10	0.00002
ERR6913179	Achromobacter xylosoxidans	85698	S	5	6	11	0.00002
ERR6913179	Orrella marina	2163011	S	5	0	5	0.00001
ERR6913179	Schlegelella aquatica	376175	S	13	2	15	0.00002
ERR6913179	Mitsuaria sp. 7	1658665	S	5	0	5	0.00001
ERR6913179	Tepidimonas taiwanensis	307486	S	6	1	7	0.00001
ERR6913179	Ferribacterium limneticum	76259	S	10	2	12	0.00002
ERR6913179	Methylotenera versatilis	1055487	S	5	3	8	0.00001
ERR6913179	Haemophilus parainfluenzae	729	S	4187	180	4367	0.00657
ERR6913179	Haemophilus parahaemolyticus	735	S	587	14	601	0.00090
ERR6913179	Haemophilus influenzae	727	S	190	71	261	0.00039
ERR6913179	Haemophilus haemolyticus	726	S	176	21	197	0.00030
ERR6913179	Haemophilus pittmaniae	249188	S	20	0	20	0.00003
ERR6913179	Haemophilus sp. oral taxon 036	712310	S	16	2	18	0.00003
ERR6913179	[Haemophilus] ducreyi	730	S	6	0	6	0.00001
ERR6913179	Aggregatibacter aphrophilus	732	S	254	14	268	0.00040
ERR6913179	Aggregatibacter sp. 2125159857	2820817	S	9	0	9	0.00001
ERR6913179	Aggregatibacter sp. oral taxon 513	712150	S	6	0	6	0.00001
ERR6913179	Aggregatibacter sp. Marseille-P9115	2866570	S	5	0	5	0.00001
ERR6913179	Aggregatibacter actinomycetemcomitans	714	S	9	0	9	0.00001
ERR6913179	Mannheimia granulomatis	85402	S	11	1	12	0.00002
ERR6913179	Mannheimia varigena	85404	S	10	7	17	0.00003
ERR6913179	Actinobacillus porcitonsillarum	189834	S	11	0	11	0.00002
ERR6913179	Actinobacillus pleuropneumoniae	715	S	8	9	17	0.00003
ERR6913179	Pasteurella multocida	747	S	17	2	19	0.00003
ERR6913179	Pasteurella canis	753	S	5	0	5	0.00001
ERR6913179	Glaesserella parasuis	738	S	15	1	16	0.00002
ERR6913179	Avibacterium volantium	762	S	5	2	7	0.00001
ERR6913179	Bibersteinia trehalosi	47735	S	5	18	23	0.00003
ERR6913179	Vibrio kanaloae	170673	S	567	206	773	0.00116
ERR6913179	Vibrio plantisponsor	664643	S	301	17	318	0.00048
ERR6913179	Vibrio parahaemolyticus	670	S	13	3	16	0.00002
ERR6913179	Vibrio alginolyticus	663	S	9	26	35	0.00005
ERR6913179	Vibrio diabolicus	50719	S	5	9	14	0.00002
ERR6913179	Vibrio natriegens	691	S	7	5	12	0.00002
ERR6913179	Vibrio campbellii	680	S	6	5	11	0.00002
ERR6913179	Vibrio toranzoniae	1194427	S	27	12	39	0.00006
ERR6913179	Vibrio cholerae	666	S	21	12	33	0.00005
ERR6913179	Vibrio ziniensis	2711221	S	21	0	21	0.00003
ERR6913179	Vibrio fluvialis	676	S	5	3	8	0.00001
ERR6913179	Vibrio pelagius	28169	S	5	0	5	0.00001
ERR6913179	Vibrio celticus	446372	S	5	2	7	0.00001
ERR6913179	Vibrio gangliei	2077090	S	5	0	5	0.00001
ERR6913179	Pseudoalteromonas prydzensis	182141	S	430	31	461	0.00069
ERR6913179	Pseudoalteromonas rhizosphaerae	2518973	S	110	10	120	0.00018
ERR6913179	Pseudoalteromonas sp. KAN5	2916633	S	9	28	37	0.00006
ERR6913179	Pseudoalteromonas mariniglutinosa	206042	S	14	18	32	0.00005
ERR6913179	Pseudoalteromonas luteoviolacea	43657	S	7	0	7	0.00001
ERR6913179	Pseudoalteromonas nigrifaciens	28109	S	6	14	20	0.00003
ERR6913179	Pseudoalteromonas piscicida	43662	S	5	3	8	0.00001
ERR6913179	Shewanella baltica	62322	S	6	26	32	0.00005
ERR6913179	Alteromonas macleodii	28108	S	6	4	10	0.00002
ERR6913179	Idiomarina loihiensis	135577	S	12	0	12	0.00002
ERR6913179	Enterobacter hormaechei	158836	S	5	33	38	0.00006
ERR6913179	Pluralibacter gergoviae	61647	S	22	1	23	0.00003
ERR6913179	Escherichia coli	562	S	11	170	181	0.00027
ERR6913179	Salmonella enterica	28901	S	5	4	9	0.00001
ERR6913179	Candidatus Profftia lariciata	1987921	S	5	0	5	0.00001
ERR6913179	Proteus mirabilis	584	S	7	10	17	0.00003
ERR6913179	Morganella morganii	582	S	7	0	7	0.00001
ERR6913179	Buchnera aphidicola	9	S	25	-1	24	0.00004
ERR6913179	Serratia sp. ATCC 39006	104623	S	5	0	5	0.00001
ERR6913179	Serratia marcescens	615	S	5	6	11	0.00002
ERR6913179	Pseudomonas fluorescens	294	S	31	28	59	0.00009
ERR6913179	Pseudomonas putida	303	S	13	18	31	0.00005
ERR6913179	Pseudomonas ficuserectae	53410	S	5	14	19	0.00003
ERR6913179	Pseudomonas aeruginosa	287	S	5	28	33	0.00005
ERR6913179	Stutzerimonas stutzeri	316	S	6	0	6	0.00001
ERR6913179	Acinetobacter sp. Marseille-Q1620	2714110	S	6	0	6	0.00001
ERR6913179	Acinetobacter sp. WCHA45	2004644	S	5	5	10	0.00002
ERR6913179	Acinetobacter sp. TTH0-4	1646498	S	5	0	5	0.00001
ERR6913179	Acinetobacter baumannii	470	S	5	30	35	0.00005
ERR6913179	Acinetobacter junii	40215	S	14	3	17	0.00003
ERR6913179	Acinetobacter schindleri	108981	S	7	2	9	0.00001
ERR6913179	Acinetobacter lwoffii	28090	S	6	12	18	0.00003
ERR6913179	Acinetobacter ursingii	108980	S	6	10	16	0.00002
ERR6913179	Acinetobacter radioresistens	40216	S	5	0	5	0.00001
ERR6913179	Psychrobacter sp. 28M-43	2772254	S	6	3	9	0.00001
ERR6913179	Psychrobacter sanguinis	861445	S	5	2	7	0.00001
ERR6913179	Moraxella osloensis	34062	S	6	0	6	0.00001
ERR6913179	Halomonas sp. GT	1971364	S	7	3	10	0.00002
ERR6913179	Halomonas alkaliphila	272774	S	7	23	30	0.00005
ERR6913179	Xanthomonas campestris	339	S	31	18	49	0.00007
ERR6913179	Stenotrophomonas maltophilia	40324	S	17	14	31	0.00005
ERR6913179	Legionella pneumophila	446	S	11	1	12	0.00002
ERR6913179	Legionella israelensis	454	S	6	0	6	0.00001
ERR6913179	Coxiella burnetii	777	S	5	0	5	0.00001
ERR6913179	Aquicella siphonis	254247	S	5	0	5	0.00001
ERR6913179	Candidatus Nitrosacidococcus sp. I8	2942908	S	6	0	6	0.00001
ERR6913179	Microbulbifer celer	435905	S	7	3	10	0.00002
ERR6913179	Thiothrix subterranea	2735563	S	8	0	8	0.00001
ERR6913179	Cardiobacterium hominis	2718	S	16	0	16	0.00002
ERR6913179	Cardiobacterium sp. Marseille-Q4385	2866573	S	10	0	10	0.00002
ERR6913179	Aeromonas veronii	654	S	8	8	16	0.00002
ERR6913179	Celerinatantimonas diazotrophica	412034	S	6	0	6	0.00001
ERR6913179	Rhodopseudomonas palustris	1076	S	10	12	22	0.00003
ERR6913179	Rhizobium leguminosarum	384	S	5	16	21	0.00003
ERR6913179	Agrobacterium tumefaciens	358	S	7	13	20	0.00003
ERR6913179	Methylobacterium aquaticum	270351	S	6	9	15	0.00002
ERR6913179	Devosia ginsengisoli	400770	S	5	6	11	0.00002
ERR6913179	Ancylobacter sp. SL191	2995166	S	5	8	13	0.00002
ERR6913179	Hyphomicrobium denitrificans	53399	S	6	4	10	0.00002
ERR6913179	Zymomonas mobilis	542	S	6	2	8	0.00001
ERR6913179	Rhodobacter capsulatus	1061	S	6	6	12	0.00002
ERR6913179	Cereibacter sphaeroides	1063	S	5	9	14	0.00002
ERR6913179	Hirschia baltica	2724	S	5	0	5	0.00001
ERR6913179	Sneathiella aquimaris	2599305	S	5	0	5	0.00001
ERR6913179	Hydrogenophilus thermoluteolus	297	S	11	0	11	0.00002
ERR6913179	Candidatus Nanosynbacter sp. HMT-352	2899133	S	12089	382	12471	0.01876
ERR6913179	Candidatus Nanosynbacter lyticus	2093824	S	128	6	134	0.00020
ERR6913179	Candidatus Nanosynbacter featherlites	2572088	S	59	0	59	0.00009
ERR6913179	Candidatus Saccharimonas aalborgensis	1332188	S	17	0	17	0.00003
ERR6913179	Candidatus Minimicrobia vallesae	2841264	S	876	91	967	0.00145
ERR6913179	Candidatus Mycosynbacter amalyticus	2665156	S	13	0	13	0.00002
ERR6913179	Campylobacter concisus	199	S	3219	32	3251	0.00489
ERR6913179	Campylobacter showae	204	S	1116	45	1161	0.00175
ERR6913179	Campylobacter rectus	203	S	626	28	654	0.00098
ERR6913179	Campylobacter gracilis	824	S	60	0	60	0.00009
ERR6913179	Campylobacter sp. RM16192	1660080	S	6	5	11	0.00002
ERR6913179	Campylobacter sp. RM6914	1032243	S	5	0	5	0.00001
ERR6913179	Campylobacter curvus	200	S	13	0	13	0.00002
ERR6913179	Campylobacter hominis	76517	S	11	0	11	0.00002
ERR6913179	Campylobacter ureolyticus	827	S	11	0	11	0.00002
ERR6913179	Campylobacter avium	522485	S	10	0	10	0.00002
ERR6913179	Campylobacter sputorum	206	S	8	0	8	0.00001
ERR6913179	Campylobacter fetus	196	S	7	0	7	0.00001
ERR6913179	Campylobacter pinnipediorum	1965231	S	5	0	5	0.00001
ERR6913179	Campylobacter geochelonis	1780362	S	5	0	5	0.00001
ERR6913179	Arcobacter venerupis	1054033	S	5	4	9	0.00001
ERR6913179	Aliarcobacter cryaerophilus	28198	S	7	4	11	0.00002
ERR6913179	Malaciobacter mytili	603050	S	6	1	7	0.00001
ERR6913179	Helicobacter pylori	210	S	8	1	9	0.00001
ERR6913179	Nitrosophilus alvini	2714855	S	6	0	6	0.00001
ERR6913179	Treponema sp. OMZ 906	2563662	S	419	405	824	0.00124
ERR6913179	Treponema sp. OMZ 803	120682	S	414	410	824	0.00124
ERR6913179	Treponema sp. OMZ 857	1643513	S	197	140	337	0.00051
ERR6913179	Treponema sp. OMZ 305	1659192	S	159	104	263	0.00040
ERR6913179	Treponema sp. OMZ 855	1643512	S	114	178	292	0.00044
ERR6913179	Treponema sp. OMZ 838	1539298	S	101	157	258	0.00039
ERR6913179	Treponema sp. Marseille-Q4132	2766701	S	27	1	28	0.00004
ERR6913179	Treponema sp. OMZ 788	2563664	S	6	6	12	0.00002
ERR6913179	Treponema sp. OMZ 799	2563668	S	5	6	11	0.00002
ERR6913179	Treponema vincentii	69710	S	837	126	963	0.00145
ERR6913179	Treponema medium	58231	S	397	50	447	0.00067
ERR6913179	Treponema socranskii	53419	S	117	3	120	0.00018
ERR6913179	Treponema denticola	158	S	114	73	187	0.00028
ERR6913179	Treponema pedis	409322	S	23	0	23	0.00003
ERR6913179	Treponema parvum	138851	S	19	0	19	0.00003
ERR6913179	Treponema phagedenis	162	S	14	0	14	0.00002
ERR6913179	Treponema brennaborense	81028	S	14	0	14	0.00002
ERR6913179	Treponema succinifaciens	167	S	11	0	11	0.00002
ERR6913179	Treponema putidum	221027	S	8	0	8	0.00001
ERR6913179	Sediminispirochaeta smaragdinae	55206	S	10	0	10	0.00002
ERR6913179	Oceanispirochaeta crateris	2518645	S	5	0	5	0.00001
ERR6913179	Breznakiella homolactica	2798577	S	5	0	5	0.00001
ERR6913179	Brachyspira intermedia	84377	S	5	3	8	0.00001
ERR6913179	Desulfonema magnum	45655	S	12	0	12	0.00002
ERR6913179	Desulfosarcina sp. BuS5	933262	S	8	3	11	0.00002
ERR6913179	Stieleria neptunia	2527979	S	5	7	12	0.00002
ERR6913179	Sorangium cellulosum	56	S	9	1	10	0.00002
ERR6913179	Sandaracinus amylolyticus	927083	S	5	0	5	0.00001
ERR6913179	Paludibaculum fermentans	1473598	S	7	0	7	0.00001
ERR6913179	Oceanotoga sp. DSM 15011	2984951	S	7	1	8	0.00001
ERR6913179	Pyramidobacter piscolens	638849	S	6	0	6	0.00001
ERR6913179	Homo sapiens	9606	S	524	3	527	0.00079
ERR6913179	Pyricularia oryzae	318829	S	5	5	10	0.00002
ERR6913179	Aspergillus puulaauensis	1220207	S	5	0	5	0.00001
ERR6913179	Debaryomyces hansenii	4959	S	5	0	5	0.00001
ERR6913179	Sugiyamaella lignohabitans	796027	S	5	0	5	0.00001
ERR6913179	Puccinia striiformis	27350	S	12	0	12	0.00002
ERR6913179	Malassezia restricta	76775	S	12	0	12	0.00002
ERR6913179	Plasmodium malariae	5858	S	7	3	10	0.00002
ERR6913179	Babesia bigemina	5866	S	7	1	8	0.00001
ERR6913179	Thalassiosira pseudonana	35128	S	5	0	5	0.00001
ERR6913179	Leishmania mexicana	5665	S	29	0	29	0.00004
ERR6913179	Trichomonas vaginalis	5722	S	13	0	13	0.00002
ERR6913179	Streptococcus phage PH10	644007	S	113	2	115	0.00017
ERR6913179	Streptococcus phage YMC-2011	1051631	S	40	1	41	0.00006
ERR6913179	Streptococcus phage Dp-1	59241	S	33	0	33	0.00005
ERR6913179	Streptococcus phage SpSL1	1566990	S	22	1	23	0.00003
ERR6913179	Streptococcus phage 9874	1814960	S	6	4	10	0.00002
ERR6913179	Streptococcus phage D4276	2006928	S	5	10	15	0.00002
ERR6913179	Streptococcus phage CHPC1148	2365028	S	5	10	15	0.00002
ERR6913179	Moineauvirus Abc2	633135	S	11	17	28	0.00004
ERR6913179	Vhmlvirus VP585	1922213	S	8	28	36	0.00005
ERR6913179	Streptococcus phage TP-778L	1385385	S	17	20	37	0.00006
ERR6913180	Streptococcus sp. oral taxon 061	712623	S	14799	1541	16340	0.02390
ERR6913180	Streptococcus sp. oral taxon 431	712633	S	6605	319	6924	0.01013
ERR6913180	Streptococcus sp. Marseille-Q6470	2972784	S	5961	575	6536	0.00956
ERR6913180	Streptococcus sp. Marseille-Q3533	2759692	S	5752	365	6117	0.00895
ERR6913180	Streptococcus sp. A12	1759399	S	3400	272	3672	0.00537
ERR6913180	Streptococcus sp. 116-D4	2598453	S	2264	168	2432	0.00356
ERR6913180	Streptococcus sp. NPS 308	1902136	S	843	94	937	0.00137
ERR6913180	Streptococcus sp. HSISM1	1316408	S	750	99	849	0.00124
ERR6913180	Streptococcus sp. LPB0220	2610896	S	678	96	774	0.00113
ERR6913180	Streptococcus sp. FDAARGOS_192	1839799	S	480	193	673	0.00098
ERR6913180	Streptococcus sp. 1643	2576376	S	238	63	301	0.00044
ERR6913180	Streptococcus sp. HSISS2	1316411	S	228	120	348	0.00051
ERR6913180	Streptococcus sp. oral taxon 064	712624	S	149	78	227	0.00033
ERR6913180	Streptococcus sp. HSISS3	1316412	S	144	71	215	0.00031
ERR6913180	Streptococcus sp. HSISS1	1316410	S	57	360	417	0.00061
ERR6913180	Streptococcus sp. NSJ-72	2763068	S	40	31	71	0.00010
ERR6913180	Streptococcus sp. KS 6	2598457	S	28	5	33	0.00005
ERR6913180	Streptococcus sp. zg-86	2664091	S	22	0	22	0.00003
ERR6913180	Streptococcus sp. HN38	3020829	S	12	3	15	0.00002
ERR6913180	Streptococcus sp. DAT741	1940319	S	5	2	7	0.00001
ERR6913180	Streptococcus mitis	28037	S	31187	2988	34175	0.04999
ERR6913180	Streptococcus salivarius	1304	S	25030	3887	28917	0.04230
ERR6913180	Streptococcus oralis	1303	S	11231	1214	12445	0.01820
ERR6913180	Streptococcus pneumoniae	1313	S	9767	11032	20799	0.03042
ERR6913180	Streptococcus australis	113107	S	5032	914	5946	0.00870
ERR6913180	Streptococcus infantis	68892	S	2672	115	2787	0.00408
ERR6913180	Streptococcus pseudopneumoniae	257758	S	2319	306	2625	0.00384
ERR6913180	Streptococcus toyakuensis	2819619	S	2295	412	2707	0.00396
ERR6913180	Streptococcus gwangjuense	1433513	S	1902	259	2161	0.00316
ERR6913180	Streptococcus gordonii	1302	S	1819	110	1929	0.00282
ERR6913180	Streptococcus ilei	1156431	S	1621	309	1930	0.00282
ERR6913180	Streptococcus sanguinis	1305	S	1465	31	1496	0.00219
ERR6913180	Streptococcus parasanguinis	1318	S	1445	113	1558	0.00228
ERR6913180	Streptococcus rubneri	1234680	S	1161	187	1348	0.00197
ERR6913180	Streptococcus koreensis	2382163	S	883	205	1088	0.00159
ERR6913180	Streptococcus thermophilus	1308	S	673	423	1096	0.00160
ERR6913180	Streptococcus anginosus	1328	S	255	147	402	0.00059
ERR6913180	Streptococcus intermedius	1338	S	199	54	253	0.00037
ERR6913180	Streptococcus constellatus	76860	S	147	63	210	0.00031
ERR6913180	Streptococcus vestibularis	1343	S	599	46	645	0.00094
ERR6913180	Streptococcus cristatus	45634	S	599	15	614	0.00090
ERR6913180	Streptococcus lactarius	684066	S	485	13	498	0.00073
ERR6913180	Streptococcus suis	1307	S	330	31	361	0.00053
ERR6913180	Streptococcus equi	1336	S	178	3	181	0.00026
ERR6913180	Streptococcus dysgalactiae	1334	S	22	1	23	0.00003
ERR6913180	Streptococcus pyogenes	1314	S	140	480	620	0.00091
ERR6913180	Streptococcus mutans	1309	S	82	6	88	0.00013
ERR6913180	Streptococcus agalactiae	1311	S	77	113	190	0.00028
ERR6913180	Streptococcus pseudoporcinus	361101	S	63	2	65	0.00010
ERR6913180	Streptococcus milleri	33040	S	60	28	88	0.00013
ERR6913180	Streptococcus canis	1329	S	59	1	60	0.00009
ERR6913180	Streptococcus pluranimalium	82348	S	54	0	54	0.00008
ERR6913180	Streptococcus oriscaviae	2781599	S	52	0	52	0.00008
ERR6913180	Streptococcus porcinus	1340	S	52	0	52	0.00008
ERR6913180	Streptococcus himalayensis	1888195	S	46	0	46	0.00007
ERR6913180	Streptococcus parasuis	1501662	S	42	7	49	0.00007
ERR6913180	Streptococcus sobrinus	1310	S	41	0	41	0.00006
ERR6913180	Streptococcus halotolerans	1814128	S	41	0	41	0.00006
ERR6913180	Streptococcus respiraculi	2021971	S	40	0	40	0.00006
ERR6913180	Streptococcus uberis	1349	S	33	0	33	0.00005
ERR6913180	Streptococcus marmotae	1825069	S	33	1	34	0.00005
ERR6913180	Streptococcus merionis	400065	S	33	0	33	0.00005
ERR6913180	Streptococcus equinus	1335	S	33	1	34	0.00005
ERR6913180	Streptococcus acidominimus	1326	S	30	0	30	0.00004
ERR6913180	Streptococcus alactolyticus	29389	S	27	0	27	0.00004
ERR6913180	Streptococcus iniae	1346	S	25	0	25	0.00004
ERR6913180	Streptococcus ratti	1341	S	23	0	23	0.00003
ERR6913180	Streptococcus gallolyticus	315405	S	22	4	26	0.00004
ERR6913180	Streptococcus parauberis	1348	S	22	0	22	0.00003
ERR6913180	Streptococcus ferus	1345	S	21	0	21	0.00003
ERR6913180	Streptococcus ruminantium	1917441	S	21	6	27	0.00004
ERR6913180	Streptococcus chenjunshii	2173853	S	20	0	20	0.00003
ERR6913180	Streptococcus urinalis	149016	S	20	0	20	0.00003
ERR6913180	Streptococcus pantholopis	1811193	S	15	0	15	0.00002
ERR6913180	Streptococcus halichoeri	254785	S	15	0	15	0.00002
ERR6913180	Streptococcus troglodytae	1111760	S	14	0	14	0.00002
ERR6913180	Streptococcus periodonticum	2490633	S	14	4	18	0.00003
ERR6913180	Streptococcus lutetiensis	150055	S	11	1	12	0.00002
ERR6913180	Streptococcus infantarius	102684	S	7	1	8	0.00001
ERR6913180	Streptococcus pasteurianus	197614	S	5	4	9	0.00001
ERR6913180	Lactococcus lactis	1358	S	10	18	28	0.00004
ERR6913180	Lactococcus raffinolactis	1366	S	8	1	9	0.00001
ERR6913180	Lactococcus allomyrinae	2419773	S	8	3	11	0.00002
ERR6913180	Lactococcus formosensis	1281486	S	5	5	10	0.00001
ERR6913180	Floricoccus penangensis	1859475	S	5	0	5	0.00001
ERR6913180	Granulicatella adiacens	46124	S	6967	151	7118	0.01041
ERR6913180	Granulicatella elegans	137732	S	771	47	818	0.00120
ERR6913180	Carnobacterium divergens	2748	S	12	1	13	0.00002
ERR6913180	Carnobacterium maltaromaticum	2751	S	9	1	10	0.00001
ERR6913180	Jeotgalibaca sp. MA1X17-3	2908211	S	5	1	6	0.00001
ERR6913180	Jeotgalibaca ciconiae	2496265	S	5	11	16	0.00002
ERR6913180	Dolosigranulum pigrum	29394	S	27	0	27	0.00004
ERR6913180	Marinilactibacillus sp. 15R	1911586	S	11	0	11	0.00002
ERR6913180	Lactobacillus iners	147802	S	37	1	38	0.00006
ERR6913180	Lactobacillus sp. CBA3606	2099789	S	5	1	6	0.00001
ERR6913180	Lactobacillus johnsonii	33959	S	10	2	12	0.00002
ERR6913180	Lactobacillus crispatus	47770	S	8	1	9	0.00001
ERR6913180	Lactobacillus kefiranofaciens	267818	S	7	3	10	0.00001
ERR6913180	Lactobacillus gasseri	1596	S	6	18	24	0.00004
ERR6913180	Lactobacillus ultunensis	227945	S	5	0	5	0.00001
ERR6913180	Lactobacillus acetotolerans	1600	S	5	0	5	0.00001
ERR6913180	Ligilactobacillus salivarius	1624	S	25	32	57	0.00008
ERR6913180	Ligilactobacillus ruminis	1623	S	6	0	6	0.00001
ERR6913180	Ligilactobacillus saerimneri	228229	S	5	0	5	0.00001
ERR6913180	Limosilactobacillus reuteri	1598	S	13	3	16	0.00002
ERR6913180	Limosilactobacillus mucosae	97478	S	10	0	10	0.00001
ERR6913180	Limosilactobacillus vaginalis	1633	S	6	3	9	0.00001
ERR6913180	Limosilactobacillus gastricus	227942	S	5	0	5	0.00001
ERR6913180	Weissella cibaria	137591	S	12	4	16	0.00002
ERR6913180	Weissella soli	155866	S	8	0	8	0.00001
ERR6913180	Companilactobacillus paralimentarius	83526	S	5	4	9	0.00001
ERR6913180	Lentilactobacillus buchneri	1581	S	9	2	11	0.00002
ERR6913180	Lentilactobacillus laojiaonis	2883998	S	5	0	5	0.00001
ERR6913180	Lactiplantibacillus pentosus	1589	S	7	0	7	0.00001
ERR6913180	Lactiplantibacillus plantarum	1590	S	7	25	32	0.00005
ERR6913180	Lactiplantibacillus paraplantarum	60520	S	5	1	6	0.00001
ERR6913180	Lacticaseibacillus manihotivorans	88233	S	5	6	11	0.00002
ERR6913180	Latilactobacillus curvatus	28038	S	8	2	10	0.00001
ERR6913180	Latilactobacillus sakei	1599	S	5	0	5	0.00001
ERR6913180	Pediococcus acidilactici	1254	S	10	0	10	0.00001
ERR6913180	Apilactobacillus kunkeei	148814	S	9	0	9	0.00001
ERR6913180	Fructilactobacillus sanfranciscensis	1625	S	5	4	9	0.00001
ERR6913180	Levilactobacillus brevis	1580	S	7	1	8	0.00001
ERR6913180	Loigolactobacillus coryniformis	1610	S	5	1	6	0.00001
ERR6913180	Furfurilactobacillus rossiae	231049	S	8	1	9	0.00001
ERR6913180	Fructobacillus americanaquae	2940302	S	7	0	7	0.00001
ERR6913180	Lapidilactobacillus dextrinicus	51664	S	5	0	5	0.00001
ERR6913180	Abiotrophia defectiva	46125	S	514	14	528	0.00077
ERR6913180	Aerococcus urinaeequi	51665	S	6	0	6	0.00001
ERR6913180	Enterococcus cecorum	44008	S	31	1	32	0.00005
ERR6913180	Enterococcus faecalis	1351	S	17	19	36	0.00005
ERR6913180	Enterococcus hirae	1354	S	14	1	15	0.00002
ERR6913180	Enterococcus mundtii	53346	S	12	0	12	0.00002
ERR6913180	Enterococcus faecium	1352	S	9	22	31	0.00005
ERR6913180	Enterococcus thailandicus	417368	S	8	0	8	0.00001
ERR6913180	Enterococcus wangshanyuanii	2005703	S	7	0	7	0.00001
ERR6913180	Enterococcus durans	53345	S	7	0	7	0.00001
ERR6913180	Enterococcus gilvus	160453	S	6	0	6	0.00001
ERR6913180	Enterococcus raffinosus	71452	S	5	0	5	0.00001
ERR6913180	Enterococcus casseliflavus	37734	S	5	5	10	0.00001
ERR6913180	Vagococcus fluvialis	2738	S	11	3	14	0.00002
ERR6913180	Vagococcus hydrophili	2714947	S	10	2	12	0.00002
ERR6913180	Vagococcus xieshaowenii	2562451	S	6	2	8	0.00001
ERR6913180	Tetragenococcus halophilus	51669	S	7	0	7	0.00001
ERR6913180	Tetragenococcus osmophilus	526944	S	6	0	6	0.00001
ERR6913180	Gemella sanguinis	84135	S	12161	594	12755	0.01866
ERR6913180	Gemella haemolysans	1379	S	2272	80	2352	0.00344
ERR6913180	Gemella morbillorum	29391	S	580	36	616	0.00090
ERR6913180	Gemella sp. ND 6198	2040624	S	22	38	60	0.00009
ERR6913180	Gemella sp. zg-570	2840371	S	20	0	20	0.00003
ERR6913180	Gemella sp. oral taxon 928	1785995	S	8	11	19	0.00003
ERR6913180	Exiguobacterium acetylicum	41170	S	5	7	12	0.00002
ERR6913180	Bacillus sp. Y1	352858	S	12	1	13	0.00002
ERR6913180	Bacillus sp. FJAT-18017	1705566	S	8	0	8	0.00001
ERR6913180	Bacillus sp. KH172YL63	2709784	S	7	0	7	0.00001
ERR6913180	Bacillus sp. S3	486398	S	5	0	5	0.00001
ERR6913180	Bacillus cereus	1396	S	20	63	83	0.00012
ERR6913180	Bacillus mycoides	1405	S	8	10	18	0.00003
ERR6913180	Bacillus thuringiensis	1428	S	5	10	15	0.00002
ERR6913180	Bacillus cytotoxicus	580165	S	5	0	5	0.00001
ERR6913180	Lysinibacillus sp. PLM2	2929796	S	9	6	15	0.00002
ERR6913180	Lysinibacillus sp. 2017	2169540	S	7	1	8	0.00001
ERR6913180	Lysinibacillus sp. SGAir0095	2070463	S	5	1	6	0.00001
ERR6913180	Lysinibacillus timonensis	2086577	S	5	2	7	0.00001
ERR6913180	Priestia megaterium	1404	S	13	38	51	0.00007
ERR6913180	Priestia filamentosa	1402861	S	8	0	8	0.00001
ERR6913180	Geobacillus subterraneus	129338	S	7	14	21	0.00003
ERR6913180	Virgibacillus sp. Bac332	2419842	S	5	5	10	0.00001
ERR6913180	Anoxybacillus flavithermus	33934	S	8	7	15	0.00002
ERR6913180	Anoxybacillus caldiproteolyticus	247480	S	5	0	5	0.00001
ERR6913180	Metabacillus litoralis	152268	S	9	1	10	0.00001
ERR6913180	Parageobacillus thermoglucosidasius	1426	S	6	13	19	0.00003
ERR6913180	Radiobacillus kanasensis	2844358	S	16	0	16	0.00002
ERR6913180	Radiobacillus deserti	2594883	S	7	0	7	0.00001
ERR6913180	Halobacillus litoralis	45668	S	6	0	6	0.00001
ERR6913180	Cytobacillus kochii	859143	S	8	0	8	0.00001
ERR6913180	Cytobacillus solani	1637975	S	5	0	5	0.00001
ERR6913180	Oceanobacillus zhaokaii	2052660	S	9	1	10	0.00001
ERR6913180	Weizmannia coagulans	1398	S	15	7	22	0.00003
ERR6913180	Psychrobacillus sp. INOP01	2829187	S	14	0	14	0.00002
ERR6913180	Gracilibacillus sp. SSPM10-3	2932255	S	6	0	6	0.00001
ERR6913180	Gracilibacillus sp. SSWR10-1	2932256	S	5	0	5	0.00001
ERR6913180	Gracilibacillus salitolerans	2663022	S	5	0	5	0.00001
ERR6913180	Niallia sp. Man26	2912824	S	8	0	8	0.00001
ERR6913180	Niallia circulans	1397	S	6	0	6	0.00001
ERR6913180	Peribacillus frigoritolerans	450367	S	7	0	7	0.00001
ERR6913180	Mesobacillus jeotgali	129985	S	7	1	8	0.00001
ERR6913180	Mesobacillus sp. S13	2880221	S	5	1	6	0.00001
ERR6913180	Rossellomorea marisflavi	189381	S	5	4	9	0.00001
ERR6913180	Evansella cellulosilytica	1413	S	11	0	11	0.00002
ERR6913180	Neobacillus drentensis	220684	S	5	0	5	0.00001
ERR6913180	Salicibibacter cibarius	2743000	S	5	0	5	0.00001
ERR6913180	Heyndrickxia oleronia	38875	S	9	0	9	0.00001
ERR6913180	Pontibacillus sp. HMF3514	2692425	S	6	0	6	0.00001
ERR6913180	Fictibacillus phosphorivorans	1221500	S	5	0	5	0.00001
ERR6913180	Gottfriedia acidiceleris	371036	S	8	0	8	0.00001
ERR6913180	Amphibacillus xylanus	1449	S	7	0	7	0.00001
ERR6913180	Pradoshia sp. D12	2651284	S	6	0	6	0.00001
ERR6913180	Salisediminibacterium beveridgei	632773	S	5	0	5	0.00001
ERR6913180	Aeribacillus pallidus	33936	S	6	2	8	0.00001
ERR6913180	Paraliobacillus zengyii	2213194	S	5	0	5	0.00001
ERR6913180	Paenibacillus sp. SYP-B4298	2996034	S	24	0	24	0.00004
ERR6913180	Paenibacillus sp. PHS-Z3	2909671	S	13	0	13	0.00002
ERR6913180	Paenibacillus sp. SS4	2975482	S	11	0	11	0.00002
ERR6913180	Paenibacillus sp. PK3_47	2072642	S	10	0	10	0.00001
ERR6913180	Paenibacillus sp. FSL R7-0331	1536773	S	9	2	11	0.00002
ERR6913180	Paenibacillus sp. 32O-W	1695218	S	8	0	8	0.00001
ERR6913180	Paenibacillus sp. JDR-2	324057	S	6	0	6	0.00001
ERR6913180	Paenibacillus sp. FSL R7-0273	1536772	S	6	1	7	0.00001
ERR6913180	Paenibacillus sp. FSL H7-0357	1536774	S	6	0	6	0.00001
ERR6913180	Paenibacillus sp. URB8-2	2741301	S	5	0	5	0.00001
ERR6913180	Paenibacillus sp. FSL H7-0737	1536775	S	5	2	7	0.00001
ERR6913180	Paenibacillus alvei	44250	S	18	1	19	0.00003
ERR6913180	Paenibacillus polymyxa	1406	S	15	27	42	0.00006
ERR6913180	Paenibacillus beijingensis	1126833	S	13	0	13	0.00002
ERR6913180	Paenibacillus jilunlii	682956	S	10	6	16	0.00002
ERR6913180	Paenibacillus lautus	1401	S	10	11	21	0.00003
ERR6913180	Paenibacillus cellulosilyticus	375489	S	10	0	10	0.00001
ERR6913180	Paenibacillus baekrokdamisoli	1712516	S	10	0	10	0.00001
ERR6913180	Paenibacillus larvae	1464	S	10	93	103	0.00015
ERR6913180	Paenibacillus pabuli	1472	S	8	2	10	0.00001
ERR6913180	Paenibacillus physcomitrellae	1619311	S	8	1	9	0.00001
ERR6913180	Paenibacillus psychroresistens	1778678	S	7	0	7	0.00001
ERR6913180	Paenibacillus borealis	160799	S	7	2	9	0.00001
ERR6913180	Paenibacillus durus	44251	S	6	1	7	0.00001
ERR6913180	Paenibacillus albus	2495582	S	6	0	6	0.00001
ERR6913180	Paenibacillus dendritiformis	130049	S	5	1	6	0.00001
ERR6913180	Paenibacillus lentus	1338368	S	5	0	5	0.00001
ERR6913180	Paenibacillus lycopersici	2704462	S	5	0	5	0.00001
ERR6913180	Brevibacillus sp. BB3-R1	2950604	S	7	1	8	0.00001
ERR6913180	Brevibacillus brevis	1393	S	9	6	15	0.00002
ERR6913180	Brevibacillus laterosporus	1465	S	9	7	16	0.00002
ERR6913180	Aneurinibacillus sp. B1	2966586	S	6	6	12	0.00002
ERR6913180	Cohnella sp. LGH	1619153	S	7	5	12	0.00002
ERR6913180	Cohnella candidum	2674991	S	5	0	5	0.00001
ERR6913180	Staphylococcus epidermidis	1282	S	15	1	16	0.00002
ERR6913180	Staphylococcus pseudintermedius	283734	S	10	1	11	0.00002
ERR6913180	Staphylococcus aureus	1280	S	9	36	45	0.00007
ERR6913180	Staphylococcus lugdunensis	28035	S	9	0	9	0.00001
ERR6913180	Staphylococcus hominis	1290	S	7	0	7	0.00001
ERR6913180	Staphylococcus auricularis	29379	S	7	0	7	0.00001
ERR6913180	Staphylococcus caprae	29380	S	7	0	7	0.00001
ERR6913180	Staphylococcus simiae	308354	S	6	0	6	0.00001
ERR6913180	Staphylococcus schleiferi	1295	S	6	5	11	0.00002
ERR6913180	Staphylococcus capitis	29388	S	6	1	7	0.00001
ERR6913180	Staphylococcus felis	46127	S	5	0	5	0.00001
ERR6913180	Staphylococcus arlettae	29378	S	5	0	5	0.00001
ERR6913180	Staphylococcus agnetis	985762	S	5	0	5	0.00001
ERR6913180	Macrococcus canis	1855823	S	11	2	13	0.00002
ERR6913180	Macrococcus caseolyticus	69966	S	7	11	18	0.00003
ERR6913180	Mammaliicoccus sciuri	1296	S	19	2	21	0.00003
ERR6913180	Mammaliicoccus sp. Marseille-Q6498	2962659	S	8	0	8	0.00001
ERR6913180	Salinicoccus halodurans	407035	S	5	0	5	0.00001
ERR6913180	Nosocomiicoccus ampullae	489910	S	5	0	5	0.00001
ERR6913180	Planococcus halocryophilus	1215089	S	8	5	13	0.00002
ERR6913180	Kurthia zopfii	1650	S	11	0	11	0.00002
ERR6913180	Kurthia sp. 11kri321	1750719	S	6	0	6	0.00001
ERR6913180	Sporosarcina ureae	1571	S	5	1	6	0.00001
ERR6913180	Solibacillus sp. ZS111008	2912187	S	9	0	9	0.00001
ERR6913180	Listeria monocytogenes	1639	S	20	8	28	0.00004
ERR6913180	Listeria welshimeri	1643	S	7	0	7	0.00001
ERR6913180	Listeria innocua	1642	S	5	0	5	0.00001
ERR6913180	Brochothrix thermosphacta	2756	S	5	0	5	0.00001
ERR6913180	Alicyclobacillus sp. ALC3	2796143	S	7	0	7	0.00001
ERR6913180	Tumebacillus avium	1903704	S	15	0	15	0.00002
ERR6913180	Veillonella rogosae	423477	S	51359	2667	54026	0.07902
ERR6913180	Veillonella atypica	39777	S	11487	200	11687	0.01709
ERR6913180	Veillonella parvula	29466	S	5808	148	5956	0.00871
ERR6913180	Veillonella nakazawae	2682456	S	3037	726	3763	0.00550
ERR6913180	Veillonella dispar	39778	S	2343	245	2588	0.00379
ERR6913180	Veillonella sp. S12025-13	2682455	S	2209	445	2654	0.00388
ERR6913180	Veillonella rodentium	248315	S	343	3	346	0.00051
ERR6913180	Megasphaera stantonii	2144175	S	67	7	74	0.00011
ERR6913180	Megasphaera hexanoica	1675036	S	41	9	50	0.00007
ERR6913180	Megasphaera elsdenii	907	S	31	15	46	0.00007
ERR6913180	Megasphaera massiliensis	1232428	S	25	3	28	0.00004
ERR6913180	Dialister succinatiphilus	487173	S	32	18	50	0.00007
ERR6913180	Dialister pneumosintes	39950	S	14	4	18	0.00003
ERR6913180	Selenomonas sp. oral taxon 920	1884263	S	24	4	28	0.00004
ERR6913180	Selenomonas sp. oral taxon 478	712538	S	21	12	33	0.00005
ERR6913180	Selenomonas sp. oral taxon 126	712528	S	17	5	22	0.00003
ERR6913180	Selenomonas sp. oral taxon 136	713030	S	16	8	24	0.00004
ERR6913180	Selenomonas sputigena	69823	S	53	1	54	0.00008
ERR6913180	Selenomonas timonae	2754044	S	16	9	25	0.00004
ERR6913180	Selenomonas ruminantium	971	S	9	0	9	0.00001
ERR6913180	Megamonas funiformis	437897	S	17	0	17	0.00002
ERR6913180	Megamonas hypermegale	158847	S	8	0	8	0.00001
ERR6913180	Pectinatus frisingensis	865	S	8	0	8	0.00001
ERR6913180	Pelosinus sp. UFO1	484770	S	15	1	16	0.00002
ERR6913180	Pelosinus fermentans	365349	S	6	0	6	0.00001
ERR6913180	Phascolarctobacterium faecium	33025	S	8	0	8	0.00001
ERR6913180	Phascolarctobacterium succinatutens	626940	S	7	0	7	0.00001
ERR6913180	Phascolarctobacterium sp. Marseille-Q4147	2823317	S	6	0	6	0.00001
ERR6913180	Acidaminococcus intestini	187327	S	5	0	5	0.00001
ERR6913180	Mogibacterium diversum	114527	S	6321	118	6439	0.00942
ERR6913180	Mogibacterium pumilum	86332	S	94	1	95	0.00014
ERR6913180	Emergencia timonensis	1776384	S	42	0	42	0.00006
ERR6913180	Aminipila terrae	2697030	S	18	0	18	0.00003
ERR6913180	Aminipila butyrica	433296	S	14	0	14	0.00002
ERR6913180	Aminipila luticellarii	2507160	S	6	0	6	0.00001
ERR6913180	Fenollaria massiliensis	938288	S	24	2	26	0.00004
ERR6913180	Fenollaria sporofastidiosus	2811778	S	6	0	6	0.00001
ERR6913180	Massilistercora timonensis	2086584	S	19	1	20	0.00003
ERR6913180	Intestinimonas butyriciproducens	1297617	S	18	0	18	0.00003
ERR6913180	Flintibacter sp. KGMB00164	2610895	S	16	0	16	0.00002
ERR6913180	Lachnoanaerobaculum umeaense	617123	S	1038	9	1047	0.00153
ERR6913180	Enterocloster bolteae	208479	S	252	11	263	0.00038
ERR6913180	Enterocloster asparagiformis	333367	S	41	0	41	0.00006
ERR6913180	Enterocloster clostridioformis	1531	S	7	2	9	0.00001
ERR6913180	Blautia producta	33035	S	32	6	38	0.00006
ERR6913180	Blautia obeum	40520	S	32	9	41	0.00006
ERR6913180	Blautia sp. NBRC 113351	2877527	S	17	5	22	0.00003
ERR6913180	Blautia sp. SC05B48	2479767	S	7	20	27	0.00004
ERR6913180	Blautia argi	1912897	S	20	2	22	0.00003
ERR6913180	Blautia wexlerae	418240	S	19	4	23	0.00003
ERR6913180	Blautia pseudococcoides	1796616	S	19	3	22	0.00003
ERR6913180	Blautia hansenii	1322	S	16	2	18	0.00003
ERR6913180	Blautia liquoris	2779518	S	13	0	13	0.00002
ERR6913180	Butyrivibrio fibrisolvens	831	S	57	5	62	0.00009
ERR6913180	Butyrivibrio proteoclasticus	43305	S	28	6	34	0.00005
ERR6913180	Butyrivibrio crossotus	45851	S	25	1	26	0.00004
ERR6913180	Butyrivibrio hungatei	185008	S	19	4	23	0.00003
ERR6913180	[Clostridium] scindens	29347	S	35	0	35	0.00005
ERR6913180	Lachnoclostridium phocaeense	1871021	S	34	1	35	0.00005
ERR6913180	Lachnoclostridium phytofermentans	66219	S	25	0	25	0.00004
ERR6913180	[Clostridium] hylemonae	89153	S	17	0	17	0.00002
ERR6913180	Lachnoclostridium sp. YL32	1834196	S	13	2	15	0.00002
ERR6913180	Lacrimispora saccharolytica	84030	S	54	10	64	0.00009
ERR6913180	Lacrimispora sphenoides	29370	S	28	4	32	0.00005
ERR6913180	Lacrimispora xylanolytica	29375	S	19	1	20	0.00003
ERR6913180	Roseburia hominis	301301	S	30	3	33	0.00005
ERR6913180	Roseburia intestinalis	166486	S	22	34	56	0.00008
ERR6913180	Roseburia sp. NSJ-69	2763062	S	12	13	25	0.00004
ERR6913180	[Ruminococcus] gnavus	33038	S	41	735	776	0.00114
ERR6913180	[Ruminococcus] lactaris	46228	S	20	0	20	0.00003
ERR6913180	[Ruminococcus] torques	33039	S	18	1	19	0.00003
ERR6913180	Anaerostipes hadrus	649756	S	38	1	39	0.00006
ERR6913180	Anaerostipes rhamnosivorans	1229621	S	18	1	19	0.00003
ERR6913180	Anaerostipes caccae	105841	S	12	0	12	0.00002
ERR6913180	Coprococcus comes	410072	S	29	2	31	0.00005
ERR6913180	Coprococcus catus	116085	S	16	0	16	0.00002
ERR6913180	Coprococcus eutactus	33043	S	10	1	11	0.00002
ERR6913180	Coprococcus sp. ART55/1	751585	S	9	1	10	0.00001
ERR6913180	Anaerocolumna chitinilytica	1727145	S	29	0	29	0.00004
ERR6913180	Anaerocolumna cellulosilytica	433286	S	22	0	22	0.00003
ERR6913180	Pseudobutyrivibrio xylanivorans	185007	S	53	0	53	0.00008
ERR6913180	Dorea longicatena	88431	S	33	2	35	0.00005
ERR6913180	Dorea formicigenerans	39486	S	11	1	12	0.00002
ERR6913180	Anaerobutyricum hallii	39488	S	45	1	46	0.00007
ERR6913180	Marvinbryantia formatexigens	168384	S	27	0	27	0.00004
ERR6913180	Simiaoa sunii	2763672	S	26	1	27	0.00004
ERR6913180	[Clostridium] colinum	36835	S	25	0	25	0.00004
ERR6913180	Lachnospira eligens	39485	S	24	0	24	0.00004
ERR6913180	Wansuia hejianensis	2763667	S	20	0	20	0.00003
ERR6913180	Wujia chipingensis	2763670	S	20	2	22	0.00003
ERR6913180	Faecalicatena sp. Marseille-Q4148	2823316	S	19	1	20	0.00003
ERR6913180	Sellimonas intestinalis	1653434	S	18	0	18	0.00003
ERR6913180	Anaeromicropila herbilytica	2785025	S	13	0	13	0.00002
ERR6913180	Qiania dongpingensis	2763669	S	13	0	13	0.00002
ERR6913180	Novisyntrophococcus fermenticellae	2068655	S	13	0	13	0.00002
ERR6913180	Herbinix luporum	1679721	S	13	1	14	0.00002
ERR6913180	Anaerotignum propionicum	28446	S	10	0	10	0.00001
ERR6913180	Anaeropeptidivorans aminofermentans	2934315	S	10	0	10	0.00001
ERR6913180	Clostridium sp. M62/1	411486	S	31	3	34	0.00005
ERR6913180	Clostridium sp. SY8519	1042156	S	28	0	28	0.00004
ERR6913180	Clostridium sp. MD294	97138	S	14	0	14	0.00002
ERR6913180	Clostridium sp. C1	1155388	S	12	0	12	0.00002
ERR6913180	Clostridium sp. BJN0001	2930219	S	10	0	10	0.00001
ERR6913180	Clostridium sp. DL-VIII	641107	S	9	0	9	0.00001
ERR6913180	Clostridium sp. JN-1	2483110	S	8	0	8	0.00001
ERR6913180	Clostridium sp. JN-9	2507159	S	8	0	8	0.00001
ERR6913180	Clostridium sp. AWRP	2212991	S	5	7	12	0.00002
ERR6913180	Clostridium botulinum	1491	S	40	24	64	0.00009
ERR6913180	Clostridium pasteurianum	1501	S	22	0	22	0.00003
ERR6913180	Clostridium felsineum	36839	S	15	0	15	0.00002
ERR6913180	Clostridium baratii	1561	S	15	1	16	0.00002
ERR6913180	Clostridium estertheticum	238834	S	15	0	15	0.00002
ERR6913180	Clostridium gasigenes	94869	S	13	0	13	0.00002
ERR6913180	Clostridium septicum	1504	S	13	1	14	0.00002
ERR6913180	Clostridium cochlearium	1494	S	12	0	12	0.00002
ERR6913180	Clostridium neonatale	137838	S	12	0	12	0.00002
ERR6913180	Clostridium chauvoei	46867	S	11	1	12	0.00002
ERR6913180	Clostridium perfringens	1502	S	10	13	23	0.00003
ERR6913180	Clostridium sporogenes	1509	S	10	33	43	0.00006
ERR6913180	Clostridium drakei	332101	S	10	5	15	0.00002
ERR6913180	Clostridium taeniosporum	394958	S	9	0	9	0.00001
ERR6913180	Clostridium saccharoperbutylacetonicum	36745	S	9	0	9	0.00001
ERR6913180	Clostridium gelidum	704125	S	9	0	9	0.00001
ERR6913180	Clostridium isatidis	182773	S	8	0	8	0.00001
ERR6913180	Clostridium saccharobutylicum	169679	S	8	0	8	0.00001
ERR6913180	Clostridium argentinense	29341	S	8	0	8	0.00001
ERR6913180	Clostridium beijerinckii	1520	S	8	10	18	0.00003
ERR6913180	Clostridium tetani	1513	S	8	0	8	0.00001
ERR6913180	Clostridium intestinale	36845	S	7	0	7	0.00001
ERR6913180	Clostridium fermenticellae	2068654	S	7	0	7	0.00001
ERR6913180	Clostridium acetobutylicum	1488	S	7	0	7	0.00001
ERR6913180	Clostridium kluyveri	1534	S	7	0	7	0.00001
ERR6913180	Clostridium cellulovorans	1493	S	6	0	6	0.00001
ERR6913180	Clostridium thermarum	1716543	S	6	0	6	0.00001
ERR6913180	Clostridium bornimense	1216932	S	6	0	6	0.00001
ERR6913180	Clostridium tagluense	360422	S	6	0	6	0.00001
ERR6913180	Clostridium carboxidivorans	217159	S	6	1	7	0.00001
ERR6913180	Clostridium novyi	1542	S	6	0	6	0.00001
ERR6913180	Clostridium butyricum	1492	S	5	9	14	0.00002
ERR6913180	Clostridium aceticum	84022	S	5	0	5	0.00001
ERR6913180	Clostridium formicaceticum	1497	S	5	0	5	0.00001
ERR6913180	Clostridium manihotivorum	2320868	S	5	0	5	0.00001
ERR6913180	Hungatella hathewayi	154046	S	70	1	71	0.00010
ERR6913180	Crassaminicella profunda	1286698	S	12	0	12	0.00002
ERR6913180	Crassaminicella sp. 143-21	2855394	S	12	1	13	0.00002
ERR6913180	Crassaminicella thermophila	2599308	S	5	0	5	0.00001
ERR6913180	Paraclostridium bifermentans	1490	S	24	1	25	0.00004
ERR6913180	Caloramator sp. E03	2576307	S	6	0	6	0.00001
ERR6913180	Caloramator sp. mosi_1	3023090	S	6	2	8	0.00001
ERR6913180	Caloramator sp. Dgby_cultured_2	3029174	S	5	1	6	0.00001
ERR6913180	Alkaliphilus oremlandii	461876	S	5	0	5	0.00001
ERR6913180	Serpentinicella alkaliphila	1734049	S	8	0	8	0.00001
ERR6913180	Geosporobacter ferrireducens	1424294	S	7	0	7	0.00001
ERR6913180	Faecalibacterium prausnitzii	853	S	87	38	125	0.00018
ERR6913180	Faecalibacterium sp. I2-3-92	2929490	S	53	64	117	0.00017
ERR6913180	Faecalibacterium sp. I4-1-79	2929494	S	13	5	18	0.00003
ERR6913180	Ruminococcus gauvreauii	438033	S	21	0	21	0.00003
ERR6913180	Ruminococcus albus	1264	S	15	0	15	0.00002
ERR6913180	Ruminococcus bicirculans	1160721	S	8	0	8	0.00001
ERR6913180	Ruminococcus champanellensis	1161942	S	6	0	6	0.00001
ERR6913180	Ruminococcus bovis	2564099	S	6	0	6	0.00001
ERR6913180	Subdoligranulum variabile	214851	S	39	5	44	0.00006
ERR6913180	Fastidiosipila sanguinis	236753	S	35	0	35	0.00005
ERR6913180	Vescimonas fastidiosa	2714353	S	25	7	32	0.00005
ERR6913180	Dysosmobacter welbionis	2093857	S	10	18	28	0.00004
ERR6913180	Caproicibacterium lactatifermentans	2666138	S	11	0	11	0.00002
ERR6913180	Caproicibacterium sp. BJN0003	2994078	S	7	0	7	0.00001
ERR6913180	Caproicibacterium amylolyticum	2766537	S	5	0	5	0.00001
ERR6913180	Acetivibrio clariflavus	288965	S	14	2	16	0.00002
ERR6913180	Acetivibrio thermocellus	1515	S	5	0	5	0.00001
ERR6913180	Anaerotruncus colihominis	169435	S	21	6	27	0.00004
ERR6913180	Ruminiclostridium herbifermentans	2488810	S	11	1	12	0.00002
ERR6913180	Ruminiclostridium cellulolyticum	1521	S	8	0	8	0.00001
ERR6913180	Pseudoclostridium thermosuccinogenes	84032	S	16	1	17	0.00002
ERR6913180	Oscillibacter hominis	2763056	S	15	1	16	0.00002
ERR6913180	Ruthenibacterium lactatiformans	1550024	S	13	1	14	0.00002
ERR6913180	Ethanoligenens harbinense	253239	S	12	0	12	0.00002
ERR6913180	Flavonifractor plautii	292800	S	11	1	12	0.00002
ERR6913180	Acutalibacter muris	1796620	S	10	0	10	0.00001
ERR6913180	Solibaculum mannosilyticum	2780922	S	9	2	11	0.00002
ERR6913180	Caproicibacter fermentans	2576756	S	8	0	8	0.00001
ERR6913180	Monoglobus pectinilyticus	1981510	S	7	0	7	0.00001
ERR6913180	Thermoclostridium stercorarium	1510	S	5	9	14	0.00002
ERR6913180	Filifactor alocis	143361	S	252	9	261	0.00038
ERR6913180	Clostridioides difficile	1496	S	79	20	99	0.00014
ERR6913180	Clostridioides sp. ES-S-0054-01	2770780	S	7	2	9	0.00001
ERR6913180	Peptostreptococcus sp. CBA3647	3003601	S	55	0	55	0.00008
ERR6913180	Romboutsia ilealis	1115758	S	6	0	6	0.00001
ERR6913180	Romboutsia hominis	1507512	S	6	0	6	0.00001
ERR6913180	Peptoclostridium acidaminophilum	1731	S	15	0	15	0.00002
ERR6913180	Peptacetobacter hiranonis	89152	S	14	0	14	0.00002
ERR6913180	Terrisporobacter hibernicus	2813371	S	13	0	13	0.00002
ERR6913180	Tepidibacter sp. 8C15b	2925782	S	10	0	10	0.00001
ERR6913180	Paeniclostridium sordellii	1505	S	9	0	9	0.00001
ERR6913180	Eubacterium sp. c-25	2841037	S	33	2	35	0.00005
ERR6913180	Eubacterium sp. MSJ-33	2841528	S	9	4	13	0.00002
ERR6913180	Eubacterium hominis	2764325	S	17	1	18	0.00003
ERR6913180	Eubacterium ventriosum	39496	S	9	3	12	0.00002
ERR6913180	Acetobacterium wieringae	52694	S	15	0	15	0.00002
ERR6913180	Acetobacterium woodii	33952	S	7	0	7	0.00001
ERR6913180	Acetobacterium sp. KB-1	2184575	S	6	0	6	0.00001
ERR6913180	Alkalibacter rhizosphaerae	2815577	S	5	0	5	0.00001
ERR6913180	Acididesulfobacillus acetoxydans	1561005	S	18	0	18	0.00003
ERR6913180	Desulforamulus ferrireducens	1833852	S	5	0	5	0.00001
ERR6913180	Candidatus Formimonas warabiya	1761012	S	7	0	7	0.00001
ERR6913180	Desulfosporosinus youngiae	339862	S	9	0	9	0.00001
ERR6913180	Desulfosporosinus meridiei	79209	S	6	0	6	0.00001
ERR6913180	Vallitalea pronyensis	1348613	S	13	2	15	0.00002
ERR6913180	Vallitalea guaymasensis	1185412	S	9	1	10	0.00001
ERR6913180	Petrocella atlantisensis	2173034	S	8	0	8	0.00001
ERR6913180	Christensenella sp. Marseille-P3954	2086585	S	14	0	14	0.00002
ERR6913180	Christensenella minuta	626937	S	13	0	13	0.00002
ERR6913180	Symbiobacterium thermophilum	2734	S	15	0	15	0.00002
ERR6913180	Caldinitratiruptor microaerophilus	671077	S	8	0	8	0.00001
ERR6913180	Cellulosilyticum lentocellum	29360	S	6	9	15	0.00002
ERR6913180	Heliomicrobium modesticaldum	35701	S	8	1	9	0.00001
ERR6913180	Heliorestis convoluta	356322	S	6	0	6	0.00001
ERR6913180	Alkalicella caledoniensis	2731377	S	7	0	7	0.00001
ERR6913180	Thermoanaerobacterium thermosaccharolyticum	1517	S	14	3	17	0.00002
ERR6913180	Moorella thermoacetica	1525	S	9	1	10	0.00001
ERR6913180	Moorella glycerini	55779	S	8	1	9	0.00001
ERR6913180	Carboxydothermus hydrogenoformans	129958	S	5	1	6	0.00001
ERR6913180	Halanaerobium praevalens	2331	S	6	0	6	0.00001
ERR6913180	Anoxybacter fermentans	1323375	S	10	0	10	0.00001
ERR6913180	Biomaibacter acetigenes	2316383	S	6	0	6	0.00001
ERR6913180	Tepidanaerobacter acetatoxydans	499229	S	5	0	5	0.00001
ERR6913180	Koleobacter methoxysyntrophicus	2751313	S	8	0	8	0.00001
ERR6913180	Parvimonas micra	33033	S	1220	47	1267	0.00185
ERR6913180	Anaerococcus mediterraneensis	1870984	S	17	1	18	0.00003
ERR6913180	Anaerococcus prevotii	33034	S	7	0	7	0.00001
ERR6913180	Anaerococcus obesiensis	1287640	S	5	12	17	0.00002
ERR6913180	Murdochiella vaginalis	1852373	S	28	0	28	0.00004
ERR6913180	Peptoniphilus sp. CBA3646	3016343	S	8	0	8	0.00001
ERR6913180	Peptoniphilus harei	54005	S	5	3	8	0.00001
ERR6913180	Peptoniphilus ivorii	54006	S	5	0	5	0.00001
ERR6913180	Finegoldia magna	1260	S	23	1	24	0.00004
ERR6913180	Helcococcus kunzii	40091	S	14	0	14	0.00002
ERR6913180	Miniphocaeibacter halophilus	2931922	S	12	0	12	0.00002
ERR6913180	Schnuerera ultunensis	45497	S	11	0	11	0.00002
ERR6913180	Gottschalkia acidurici	1556	S	6	0	6	0.00001
ERR6913180	Ezakiella coagulans	46507	S	37	2	39	0.00006
ERR6913180	Sedimentibacter sp. zth1	2816908	S	7	0	7	0.00001
ERR6913180	Bulleidia sp. zg-1006	2806552	S	236	4	240	0.00035
ERR6913180	Erysipelothrix sp. HDW6A	2714928	S	7	2	9	0.00001
ERR6913180	Erysipelothrix sp. HDW6C	2714930	S	6	3	9	0.00001
ERR6913180	Erysipelothrix larvae	1514105	S	9	1	10	0.00001
ERR6913180	Erysipelothrix inopinata	225084	S	5	1	6	0.00001
ERR6913180	Amedibacterium intestinale	2583452	S	15	1	16	0.00002
ERR6913180	Allobaculum sp. Allo2	2853432	S	10	0	10	0.00001
ERR6913180	Longicatena caecimuris	1796635	S	13	1	14	0.00002
ERR6913180	Faecalitalea cylindroides	39483	S	10	1	11	0.00002
ERR6913180	Faecalibacillus intestinalis	1982626	S	9	1	10	0.00001
ERR6913180	Tannockella kyphosi	2899121	S	7	0	7	0.00001
ERR6913180	Faecalibaculum rodentium	1702221	S	5	0	5	0.00001
ERR6913180	[Clostridium] innocuum	1522	S	43	1	44	0.00006
ERR6913180	Thomasclavelia ramosa	1547	S	13	1	14	0.00002
ERR6913180	Catenibacterium mitsuokai	100886	S	24	0	24	0.00004
ERR6913180	Turicibacter sp. TJ11	2806443	S	6	13	19	0.00003
ERR6913180	Schaalia odontolytica	1660	S	8865	590	9455	0.01383
ERR6913180	Schaalia meyeri	52773	S	512	32	544	0.00080
ERR6913180	Schaalia sp. ZJ405	2709403	S	35	1	36	0.00005
ERR6913180	Schaalia sp. 19OD2882	2794089	S	30	1	31	0.00005
ERR6913180	Schaalia sp. JY-X169	2758572	S	6	0	6	0.00001
ERR6913180	Schaalia cardiffensis	181487	S	40	1	41	0.00006
ERR6913180	Schaalia turicensis	131111	S	22	1	23	0.00003
ERR6913180	Schaalia radingae	131110	S	13	0	13	0.00002
ERR6913180	Actinomyces pacaensis	1852377	S	5562	129	5691	0.00832
ERR6913180	Actinomyces oris	544580	S	347	172	519	0.00076
ERR6913180	Actinomyces sp. HMT 175	2789425	S	56	71	127	0.00019
ERR6913180	Actinomyces sp. oral taxon 414	712122	S	33	2	35	0.00005
ERR6913180	Actinomyces sp. oral taxon 171	706438	S	31	7	38	0.00006
ERR6913180	Actinomyces sp. oral taxon 169	712116	S	26	15	41	0.00006
ERR6913180	Actinomyces sp. MAS-1	2755559	S	12	0	12	0.00002
ERR6913180	Actinomyces sp. Chiba101	1851395	S	10	1	11	0.00002
ERR6913180	Actinomyces sp. zg-332	2708340	S	7	0	7	0.00001
ERR6913180	Actinomyces sp. Z16	2079536	S	6	0	6	0.00001
ERR6913180	Actinomyces naeslundii	1655	S	57	7	64	0.00009
ERR6913180	Actinomyces viscosus	1656	S	30	3	33	0.00005
ERR6913180	Actinomyces faecalis	2722820	S	26	1	27	0.00004
ERR6913180	Actinomyces radicidentis	111015	S	24	2	26	0.00004
ERR6913180	Actinomyces respiraculi	2744574	S	19	1	20	0.00003
ERR6913180	Actinomyces lilanjuaniae	2321394	S	17	1	18	0.00003
ERR6913180	Actinomyces trachealis	2763540	S	16	0	16	0.00002
ERR6913180	Actinomyces gaoshouyii	1960083	S	12	1	13	0.00002
ERR6913180	Actinomyces slackii	52774	S	10	0	10	0.00001
ERR6913180	Actinomyces procaprae	2560010	S	8	0	8	0.00001
ERR6913180	Actinomyces weissii	675090	S	8	0	8	0.00001
ERR6913180	Actinomyces marmotae	2737173	S	6	0	6	0.00001
ERR6913180	Pauljensenia hongkongensis	178339	S	139	12	151	0.00022
ERR6913180	Trueperella pyogenes	1661	S	12	3	15	0.00002
ERR6913180	Flaviflexus equikiangi	2758573	S	10	1	11	0.00002
ERR6913180	Flaviflexus salsibiostraticola	1282737	S	5	1	6	0.00001
ERR6913180	Nanchangia anserum	2692125	S	11	0	11	0.00002
ERR6913180	Mobiluncus curtisii	2051	S	10	0	10	0.00001
ERR6913180	Fannyhessea vaginae	82135	S	10	0	10	0.00001
ERR6913180	Varibaculum prostatecancerukia	2811781	S	9	0	9	0.00001
ERR6913180	Winkia neuii	33007	S	7	0	7	0.00001
ERR6913180	Rothia mucilaginosa	43675	S	1025	57	1082	0.00158
ERR6913180	Rothia aeria	172042	S	795	29	824	0.00121
ERR6913180	Rothia dentocariosa	2047	S	424	21	445	0.00065
ERR6913180	Arthrobacter sp. DNA4	2963432	S	13	31	44	0.00006
ERR6913180	Arthrobacter sp. StoSoilB20	2830995	S	8	3	11	0.00002
ERR6913180	Arthrobacter sp. PAMC25564	2565366	S	6	2	8	0.00001
ERR6913180	Arthrobacter sp. ERGS1:01	1704044	S	6	0	6	0.00001
ERR6913180	Arthrobacter alpinus	656366	S	9	2	11	0.00002
ERR6913180	Arthrobacter polaris	2813727	S	6	0	6	0.00001
ERR6913180	Arthrobacter agilis	37921	S	5	0	5	0.00001
ERR6913180	Glutamicibacter sp. MNS18	2989817	S	7	2	9	0.00001
ERR6913180	Pseudarthrobacter sp. BIM B-2242	2772401	S	6	1	7	0.00001
ERR6913180	Paenarthrobacter ureafaciens	37931	S	5	4	9	0.00001
ERR6913180	Microbacterium sp. nov. GSS16	3019890	S	8	15	23	0.00003
ERR6913180	Microbacterium sp. MPKO10	2989818	S	7	2	9	0.00001
ERR6913180	Microbacterium sp. YJN-G	2763257	S	6	12	18	0.00003
ERR6913180	Microbacterium sp. KUDC0405	2909587	S	5	3	8	0.00001
ERR6913180	Microbacterium atlanticum	2782168	S	7	8	15	0.00002
ERR6913180	Microbacterium hydrocarbonoxydans	273678	S	7	13	20	0.00003
ERR6913180	Microbacterium oleivorans	273677	S	6	7	13	0.00002
ERR6913180	Leucobacter sp. Psy1	2875729	S	9	2	11	0.00002
ERR6913180	Leucobacter sp. CX169	2813744	S	6	2	8	0.00001
ERR6913180	Leucobacter sp. NB 10	2873270	S	5	2	7	0.00001
ERR6913180	Leucobacter denitrificans	683042	S	6	0	6	0.00001
ERR6913180	Leucobacter aridicollis	283878	S	5	1	6	0.00001
ERR6913180	Leucobacter muris	1935379	S	5	2	7	0.00001
ERR6913180	Agromyces sp. H17E-10	2932244	S	8	9	17	0.00002
ERR6913180	Gulosibacter molinativorax	256821	S	15	4	19	0.00003
ERR6913180	Rathayibacter sp. VKM Ac-2759	2609252	S	7	7	14	0.00002
ERR6913180	Rhodoluna lacicola	529884	S	5	0	5	0.00001
ERR6913180	Protaetiibacter larvae	2592654	S	5	4	9	0.00001
ERR6913180	Brevibacterium sp. CS2	2575923	S	22	7	29	0.00004
ERR6913180	Brevibacterium sp. BRM-1	2999062	S	5	2	7	0.00001
ERR6913180	Brevibacterium linens	1703	S	5	23	28	0.00004
ERR6913180	Brachybacterium sp. P6-10-X1	1903186	S	6	3	9	0.00001
ERR6913180	Brachybacterium vulturis	2017484	S	9	2	11	0.00002
ERR6913180	Brachybacterium halotolerans	2795215	S	6	3	9	0.00001
ERR6913180	Dermabacter jinjuensis	1667168	S	7	5	12	0.00002
ERR6913180	Cellulomonas sp. S1-8	2904790	S	11	5	16	0.00002
ERR6913180	Cellulomonas sp. H30R-01	2704467	S	5	4	9	0.00001
ERR6913180	Xylanimonas allomyrinae	2509459	S	10	4	14	0.00002
ERR6913180	Isoptericola dokdonensis	372663	S	6	2	8	0.00001
ERR6913180	Intrasporangium calvum	53358	S	7	1	8	0.00001
ERR6913180	Ornithinimicrobium sp. HY006	2508882	S	10	1	11	0.00002
ERR6913180	Georgenia wutianyii	2585135	S	8	2	10	0.00001
ERR6913180	Georgenia faecalis	2483799	S	7	1	8	0.00001
ERR6913180	Sanguibacter sp. HDW7	2714931	S	12	4	16	0.00002
ERR6913180	Sanguibacter keddieii	60920	S	5	1	6	0.00001
ERR6913180	Ruania halotolerans	2897773	S	6	1	7	0.00001
ERR6913180	Beutenbergia cavernae	84757	S	8	1	9	0.00001
ERR6913180	Jonesia denitrificans	43674	S	6	0	6	0.00001
ERR6913180	Kytococcus sedentarius	1276	S	6	1	7	0.00001
ERR6913180	Corynebacterium matruchotii	43768	S	50	1	51	0.00007
ERR6913180	Corynebacterium pseudotuberculosis	1719	S	16	2	18	0.00003
ERR6913180	Corynebacterium aurimucosum	169292	S	14	3	17	0.00002
ERR6913180	Corynebacterium falsenii	108486	S	14	2	16	0.00002
ERR6913180	Corynebacterium humireducens	1223514	S	14	3	17	0.00002
ERR6913180	Corynebacterium vitaeruminis	38305	S	7	1	8	0.00001
ERR6913180	Corynebacterium singulare	161899	S	7	2	9	0.00001
ERR6913180	Corynebacterium diphtheriae	1717	S	6	15	21	0.00003
ERR6913180	Corynebacterium freneyi	134034	S	6	2	8	0.00001
ERR6913180	Corynebacterium timonense	441500	S	6	1	7	0.00001
ERR6913180	Corynebacterium epidermidicanis	1050174	S	6	0	6	0.00001
ERR6913180	Corynebacterium jeikeium	38289	S	6	11	17	0.00002
ERR6913180	Corynebacterium argentoratense	42817	S	6	0	6	0.00001
ERR6913180	Corynebacterium testudinoris	136857	S	5	0	5	0.00001
ERR6913180	Corynebacterium striatum	43770	S	5	2	7	0.00001
ERR6913180	Corynebacterium genitalium	38288	S	5	0	5	0.00001
ERR6913180	Corynebacterium minutissimum	38301	S	5	5	10	0.00001
ERR6913180	Corynebacterium callunae	1721	S	5	0	5	0.00001
ERR6913180	Mycobacterium sp. MS1601	1936029	S	16	2	18	0.00003
ERR6913180	Mycobacterium sp. IDR2000157661	2867005	S	6	1	7	0.00001
ERR6913180	Mycobacterium florentinum	292462	S	8	1	9	0.00001
ERR6913180	Mycobacterium mantenii	560555	S	6	0	6	0.00001
ERR6913180	Mycobacterium intracellulare	1767	S	5	14	19	0.00003
ERR6913180	Mycobacterium diernhoferi	1801	S	8	1	9	0.00001
ERR6913180	Mycobacterium marinum	1781	S	5	2	7	0.00001
ERR6913180	Mycobacterium xenopi	1789	S	5	0	5	0.00001
ERR6913180	Mycolicibacterium gilvum	1804	S	11	8	19	0.00003
ERR6913180	Mycolicibacterium celeriflavum	1249101	S	6	2	8	0.00001
ERR6913180	Mycolicibacterium alvei	67081	S	5	3	8	0.00001
ERR6913180	Mycobacteroides chelonae	1774	S	5	1	6	0.00001
ERR6913180	Mycobacteroides abscessus	36809	S	5	4	9	0.00001
ERR6913180	Mycobacteroides immunogenum	83262	S	5	0	5	0.00001
ERR6913180	Rhodococcus sp. ABRD24	2507582	S	11	3	14	0.00002
ERR6913180	Rhodococcus sp. USK13	2806442	S	6	8	14	0.00002
ERR6913180	Rhodococcus sp. PBTS 1	1653478	S	5	1	6	0.00001
ERR6913180	Rhodococcus fascians	1828	S	6	1	7	0.00001
ERR6913180	Rhodococcus rhodochrous	1829	S	5	17	22	0.00003
ERR6913180	Nocardia arthritidis	228602	S	8	1	9	0.00001
ERR6913180	Nocardia huaxiensis	2755382	S	5	1	6	0.00001
ERR6913180	Nocardia brasiliensis	37326	S	5	2	7	0.00001
ERR6913180	Nocardia asteroides	1824	S	5	2	7	0.00001
ERR6913180	Gordonia otitidis	249058	S	9	3	12	0.00002
ERR6913180	Gordonia terrae	2055	S	5	11	16	0.00002
ERR6913180	Tsukamurella tyrosinosolvens	57704	S	6	3	9	0.00001
ERR6913180	Lawsonella clevelandensis	1528099	S	6	0	6	0.00001
ERR6913180	Arachnia propionica	1750	S	278	11	289	0.00042
ERR6913180	Arachnia rubra	1547448	S	5	0	5	0.00001
ERR6913180	Cutibacterium acnes	1747	S	150	6	156	0.00023
ERR6913180	Cutibacterium avidum	33010	S	12	1	13	0.00002
ERR6913180	Cutibacterium sp. CBA3108	3016342	S	7	0	7	0.00001
ERR6913180	Acidipropionibacterium acidipropionici	1748	S	6	6	12	0.00002
ERR6913180	Acidipropionibacterium jensenii	1749	S	6	4	10	0.00001
ERR6913180	Propionibacterium acidifaciens	556499	S	10	0	10	0.00001
ERR6913180	Propionibacterium freudenreichii	1744	S	6	0	6	0.00001
ERR6913180	Microlunatus sagamiharensis	546874	S	5	0	5	0.00001
ERR6913180	Microlunatus elymi	2596828	S	5	0	5	0.00001
ERR6913180	Propioniciclava coleopterorum	2714937	S	5	0	5	0.00001
ERR6913180	Raineyella fluvialis	2662261	S	6	0	6	0.00001
ERR6913180	Nocardioides sp. cx-173	2898796	S	6	2	8	0.00001
ERR6913180	Nocardioides sp. WS12	2486272	S	5	1	6	0.00001
ERR6913180	Nocardioides sp. S-1144	2582905	S	5	1	6	0.00001
ERR6913180	Nocardioides sp. LMS-CY	2840457	S	5	1	6	0.00001
ERR6913180	Nocardioides humi	449461	S	7	3	10	0.00001
ERR6913180	Nocardioides euryhalodurans	2518370	S	6	1	7	0.00001
ERR6913180	Micropruina glycogenica	75385	S	17	1	18	0.00003
ERR6913180	Aeromicrobium sp. HA	3009077	S	5	1	6	0.00001
ERR6913180	Pimelobacter simplex	2045	S	6	5	11	0.00002
ERR6913180	Mumia sp. ZJ1417	2708082	S	5	0	5	0.00001
ERR6913180	Streptomyces sp. CdTB01	1725411	S	10	9	19	0.00003
ERR6913180	Streptomyces sp. DSM 40868	2721173	S	7	10	17	0.00002
ERR6913180	Streptomyces sp. 3214.6	1882757	S	7	8	15	0.00002
ERR6913180	Streptomyces sp. SN-593	659352	S	7	1	8	0.00001
ERR6913180	Streptomyces sp. GS7	2692234	S	6	5	11	0.00002
ERR6913180	Streptomyces sp. CA-210063	2801029	S	5	14	19	0.00003
ERR6913180	Streptomyces sp. INR7	2607753	S	5	16	21	0.00003
ERR6913180	Streptomyces sp. HUAS 15-9	2981136	S	5	4	9	0.00001
ERR6913180	Streptomyces venezuelae	54571	S	27	23	50	0.00007
ERR6913180	Streptomyces buecherae	2763006	S	17	4	21	0.00003
ERR6913180	Streptomyces lydicus	47763	S	12	26	38	0.00006
ERR6913180	Streptomyces durmitorensis	319947	S	9	3	12	0.00002
ERR6913180	Streptomyces filamentosus	67294	S	8	34	42	0.00006
ERR6913180	Streptomyces rapamycinicus	1226757	S	6	5	11	0.00002
ERR6913180	Streptomyces formicae	1616117	S	8	7	15	0.00002
ERR6913180	Streptomyces ferrugineus	1413221	S	7	5	12	0.00002
ERR6913180	Streptomyces bathyalis	2710756	S	6	0	6	0.00001
ERR6913180	Streptomyces qinzhouensis	2599401	S	5	2	7	0.00001
ERR6913180	Streptomyces aquilus	2548456	S	5	3	8	0.00001
ERR6913180	Streptomyces chromofuscus	42881	S	5	4	9	0.00001
ERR6913180	Streptomyces tsukubensis	83656	S	5	1	6	0.00001
ERR6913180	Streptomyces olivoreticuli	68246	S	5	1	6	0.00001
ERR6913180	Kitasatospora sp. NA04385	2742135	S	5	0	5	0.00001
ERR6913180	Streptacidiphilus sp. P02-A3a	2704468	S	7	0	7	0.00001
ERR6913180	Peterkaempfera bronchialis	2126346	S	7	1	8	0.00001
ERR6913180	Actinacidiphila bryophytorum	1436133	S	5	0	5	0.00001
ERR6913180	Amycolatopsis sp. FDAARGOS 1241	2778070	S	9	2	11	0.00002
ERR6913180	Amycolatopsis pretoriensis	218821	S	5	7	12	0.00002
ERR6913180	Actinoalloteichus sp. GBA129-24	1612551	S	7	13	20	0.00003
ERR6913180	Saccharomonospora xinjiangensis	75294	S	5	1	6	0.00001
ERR6913180	Lentzea sp. HUAS12	2951806	S	10	1	11	0.00002
ERR6913180	Kibdelosporangium phytohabitans	860235	S	5	0	5	0.00001
ERR6913180	Prauserella marina	530584	S	5	0	5	0.00001
ERR6913180	Bifidobacterium catenulatum	1686	S	16	13	29	0.00004
ERR6913180	Bifidobacterium breve	1685	S	10	5	15	0.00002
ERR6913180	Bifidobacterium asteroides	1684	S	8	0	8	0.00001
ERR6913180	Bifidobacterium bifidum	1681	S	7	23	30	0.00004
ERR6913180	Bifidobacterium dentium	1689	S	7	0	7	0.00001
ERR6913180	Gardnerella vaginalis	2702	S	10	4	14	0.00002
ERR6913180	Micromonospora sp. WMMA2032	2039870	S	6	8	14	0.00002
ERR6913180	Verrucosispora sp. NA02020	2742132	S	5	4	9	0.00001
ERR6913180	Actinoplanes friuliensis	196914	S	6	0	6	0.00001
ERR6913180	Phytohabitans suffuscus	624315	S	8	0	8	0.00001
ERR6913180	Actinocatenispora thailandica	227318	S	6	0	6	0.00001
ERR6913180	Thermobifida fusca	2021	S	5	1	6	0.00001
ERR6913180	Actinomadura sp. WMMA1423	2591108	S	9	0	9	0.00001
ERR6913180	Candidatus Planktophila versatilis	1884905	S	10	0	10	0.00001
ERR6913180	Kineococcus radiotolerans	131568	S	6	0	6	0.00001
ERR6913180	Lancefieldella parvula	1382	S	10465	75	10540	0.01542
ERR6913180	Olsenella uli	133926	S	107	2	109	0.00016
ERR6913180	Olsenella sp. oral taxon 807	712411	S	44	0	44	0.00006
ERR6913180	Olsenella timonensis	1805478	S	11	0	11	0.00002
ERR6913180	Atopobium sp. oral taxon 416	712157	S	38	0	38	0.00006
ERR6913180	Parolsenella massiliensis	1871022	S	20	6	26	0.00004
ERR6913180	Parolsenella catena	2003188	S	10	3	13	0.00002
ERR6913180	Leptogranulimonas caecicola	2894156	S	15	0	15	0.00002
ERR6913180	Parafannyhessea umbonata	604330	S	9	0	9	0.00001
ERR6913180	Thermophilibacter immobilis	2779519	S	8	0	8	0.00001
ERR6913180	Collinsella sp. zg1085	2844380	S	48	0	48	0.00007
ERR6913180	Collinsella aerofaciens	74426	S	40	3	43	0.00006
ERR6913180	Collinsella stercoris	147206	S	5	0	5	0.00001
ERR6913180	Eggerthella lenta	84112	S	27	17	44	0.00006
ERR6913180	Gordonibacter pamelaeae	471189	S	18	2	20	0.00003
ERR6913180	Gordonibacter urolithinfaciens	1335613	S	13	1	14	0.00002
ERR6913180	Berryella intestinalis	1531429	S	10	1	11	0.00002
ERR6913180	Berryella wangjianweii	2734634	S	8	0	8	0.00001
ERR6913180	Phoenicibacter congonensis	1944646	S	10	0	10	0.00001
ERR6913180	Cryptobacterium curtum	84163	S	6	0	6	0.00001
ERR6913180	Conexibacter woesei	191495	S	14	0	14	0.00002
ERR6913180	Iamia sp. SCSIO 61187	2722752	S	9	0	9	0.00001
ERR6913180	Iamia majanohamensis	467976	S	5	0	5	0.00001
ERR6913180	Rubrobacter radiotolerans	42256	S	5	0	5	0.00001
ERR6913180	Nostoc sp. UHCC 0870	2914041	S	16	11	27	0.00004
ERR6913180	Nostoc linckia	92942	S	13	7	20	0.00003
ERR6913180	Calothrix sp. NIES-3974	2005462	S	5	5	10	0.00001
ERR6913180	Dolichospermum compactum	136073	S	5	14	19	0.00003
ERR6913180	Fischerella sp. NIES-3754	1752063	S	6	2	8	0.00001
ERR6913180	Synechococcus sp. CBW1108	1353147	S	12	5	17	0.00002
ERR6913180	Synechococcus sp. JA-3-3Ab	321327	S	8	4	12	0.00002
ERR6913180	Synechococcus sp. A10-1-5-1	2936507	S	7	4	11	0.00002
ERR6913180	Synechococcus sp. PCC 7003	374981	S	6	4	10	0.00001
ERR6913180	Synechococcus sp. A15-62	1050657	S	5	18	23	0.00003
ERR6913180	Prochlorococcus marinus	1219	S	11	2	13	0.00002
ERR6913180	Cyanobium sp. NS01	261284	S	7	5	12	0.00002
ERR6913180	Chamaesiphon minutus	1173032	S	7	0	7	0.00001
ERR6913180	Microcystis aeruginosa	1126	S	10	3	13	0.00002
ERR6913180	Geitlerinema sp. PCC 7407	1173025	S	6	1	7	0.00001
ERR6913180	Microcoleus vaginatus	119532	S	5	1	6	0.00001
ERR6913180	Leptolyngbya sp. 7M	2812896	S	6	0	6	0.00001
ERR6913180	Pseudanabaena sp. PCC 7367	82654	S	6	0	6	0.00001
ERR6913180	Thermosynechococcus vestitus	146786	S	7	1	8	0.00001
ERR6913180	Chroococcidiopsis sp. CCMEE 29	155894	S	14	6	20	0.00003
ERR6913180	Anthocerotibacter panamensis	2857077	S	5	0	5	0.00001
ERR6913180	Mycoplasma mycoides	2102	S	5	6	11	0.00002
ERR6913180	Mycoplasma miroungigenitalium	754515	S	5	1	6	0.00001
ERR6913180	Mycoplasmopsis bovigenitalium	2112	S	5	1	6	0.00001
ERR6913180	Mycoplasmopsis edwardii	53558	S	5	3	8	0.00001
ERR6913180	Mesomycoplasma ovipneumoniae	29562	S	12	1	13	0.00002
ERR6913180	Mesomycoplasma hyorhinis	2100	S	6	3	9	0.00001
ERR6913180	Spiroplasma cantharicola	362837	S	6	2	8	0.00001
ERR6913180	Spiroplasma clarkii	2139	S	6	0	6	0.00001
ERR6913180	Candidatus Phytoplasma luffae	35773	S	5	5	10	0.00001
ERR6913180	Haploplasma axanthum	29552	S	5	0	5	0.00001
ERR6913180	Malacoplasma penetrans	28227	S	6	0	6	0.00001
ERR6913180	Deinococcus maricopensis	309887	S	24	0	24	0.00004
ERR6913180	Deinococcus sp. AJ005	2652443	S	6	0	6	0.00001
ERR6913180	Deinococcus sp. KNUC1210	2917691	S	5	0	5	0.00001
ERR6913180	Deinococcus wulumuqiensis	980427	S	9	0	9	0.00001
ERR6913180	Deinococcus aetherius	200252	S	6	0	6	0.00001
ERR6913180	Thermus thermophilus	274	S	19	6	25	0.00004
ERR6913180	Thermus oshimai	56957	S	6	0	6	0.00001
ERR6913180	Meiothermus ruber	277	S	7	0	7	0.00001
ERR6913180	Truepera radiovictrix	332249	S	6	0	6	0.00001
ERR6913180	Pelolinea submarina	913107	S	8	3	11	0.00002
ERR6913180	Ktedonosporobacter rubrisoli	2509675	S	12	0	12	0.00002
ERR6913180	Dehalococcoides mccartyi	61435	S	6	5	11	0.00002
ERR6913180	Tepidiforma sp. YIM 72310	3004094	S	9	0	9	0.00001
ERR6913180	Candidatus Promineofilum breve	1806508	S	7	0	7	0.00001
ERR6913180	Fimbriimonas ginsengisoli	1005039	S	6	0	6	0.00001
ERR6913180	Prevotella melaninogenica	28132	S	94919	10493	105412	0.15419
ERR6913180	Prevotella sp. oral taxon 299	652716	S	30651	581	31232	0.04568
ERR6913180	Prevotella sp. oral taxon 475	712471	S	2757	42	2799	0.00409
ERR6913180	Prevotella sp. Rep29	2691580	S	375	6	381	0.00056
ERR6913180	Prevotella sp. E13-17	2913616	S	321	5	326	0.00048
ERR6913180	Prevotella sp. E15-22	2937774	S	310	9	319	0.00047
ERR6913180	Prevotella sp. E9-3	2913621	S	241	5	246	0.00036
ERR6913180	Prevotella sp. E2-28	2913620	S	193	4	197	0.00029
ERR6913180	Prevotella sp. E2-25	2913619	S	41	121	162	0.00024
ERR6913180	Prevotella sp. E13-3	2913617	S	8	23	31	0.00005
ERR6913180	Prevotella sp. E15-14	2913618	S	5	331	336	0.00049
ERR6913180	Prevotella nigrescens	28133	S	12728	1783	14511	0.02123
ERR6913180	Prevotella intermedia	28131	S	7122	643	7765	0.01136
ERR6913180	Prevotella jejuni	1177574	S	5297	355	5652	0.00827
ERR6913180	Prevotella denticola	28129	S	2934	1885	4819	0.00705
ERR6913180	Prevotella oris	28135	S	1858	49	1907	0.00279
ERR6913180	Prevotella histicola	470565	S	1373	37	1410	0.00206
ERR6913180	Prevotella scopos	589437	S	1325	109	1434	0.00210
ERR6913180	Prevotella corporis	28128	S	1056	60	1116	0.00163
ERR6913180	Prevotella veroralis	28137	S	755	31	786	0.00115
ERR6913180	Prevotella fusca	589436	S	736	27	763	0.00112
ERR6913180	Prevotella dentalis	52227	S	541	16	557	0.00081
ERR6913180	Prevotella copri	165179	S	460	12	472	0.00069
ERR6913180	Prevotella herbatica	2801997	S	330	1	331	0.00048
ERR6913180	Prevotella multiformis	282402	S	277	18	295	0.00043
ERR6913180	Prevotella ruminicola	839	S	271	1	272	0.00040
ERR6913180	Prevotella bryantii	77095	S	254	2	256	0.00037
ERR6913180	Hoylesella enoeca	76123	S	1477	101	1578	0.00231
ERR6913180	Hoylesella buccalis	28127	S	544	41	585	0.00086
ERR6913180	Pseudoprevotella muciniphila	2133944	S	1031	5	1036	0.00152
ERR6913180	Paraprevotella xylaniphila	454155	S	342	31	373	0.00055
ERR6913180	Tannerella serpentiformis	712710	S	23119	197	23316	0.03410
ERR6913180	Tannerella forsythia	28112	S	471	42	513	0.00075
ERR6913180	Parabacteroides merdae	46503	S	116	28	144	0.00021
ERR6913180	Parabacteroides goldsteinii	328812	S	100	8	108	0.00016
ERR6913180	Parabacteroides faecis	1217282	S	92	4	96	0.00014
ERR6913180	Parabacteroides distasonis	823	S	86	173	259	0.00038
ERR6913180	Parabacteroides johnsonii	387661	S	59	10	69	0.00010
ERR6913180	Porphyromonas sp. oral taxon 275	712435	S	9564	134	9698	0.01419
ERR6913180	Porphyromonas endodontalis	28124	S	3436	194	3630	0.00531
ERR6913180	Porphyromonas gingivalis	837	S	985	84	1069	0.00156
ERR6913180	Porphyromonas cangingivalis	36874	S	273	23	296	0.00043
ERR6913180	Porphyromonas asaccharolytica	28123	S	245	18	263	0.00038
ERR6913180	Porphyromonas somerae	322095	S	177	17	194	0.00028
ERR6913180	Porphyromonas crevioricanis	393921	S	128	7	135	0.00020
ERR6913180	Bacteroides heparinolyticus	28113	S	567	104	671	0.00098
ERR6913180	Bacteroides thetaiotaomicron	818	S	281	72	353	0.00052
ERR6913180	Bacteroides zoogleoformans	28119	S	220	46	266	0.00039
ERR6913180	Bacteroides stercoris	46506	S	177	36	213	0.00031
ERR6913180	Bacteroides fragilis	817	S	148	118	266	0.00039
ERR6913180	Bacteroides helcogenes	290053	S	138	3	141	0.00021
ERR6913180	Bacteroides salyersiae	291644	S	118	12	130	0.00019
ERR6913180	Bacteroides eggerthii	28111	S	111	26	137	0.00020
ERR6913180	Bacteroides faecis	674529	S	103	37	140	0.00020
ERR6913180	Bacteroides uniformis	820	S	101	145	246	0.00036
ERR6913180	Bacteroides faecium	2715212	S	94	7	101	0.00015
ERR6913180	Bacteroides nordii	291645	S	90	6	96	0.00014
ERR6913180	Bacteroides zhangwenhongii	2650157	S	90	26	116	0.00017
ERR6913180	Bacteroides cellulosilyticus	246787	S	71	51	122	0.00018
ERR6913180	Bacteroides caccae	47678	S	66	24	90	0.00013
ERR6913180	Bacteroides intestinalis	329854	S	66	10	76	0.00011
ERR6913180	Bacteroides caecimuris	1796613	S	59	33	92	0.00013
ERR6913180	Bacteroides ovatus	28116	S	52	185	237	0.00035
ERR6913180	Bacteroides xylanisolvens	371601	S	49	89	138	0.00020
ERR6913180	Bacteroides coprosuis	151276	S	40	0	40	0.00006
ERR6913180	Bacteroides sp. M10	2763022	S	12	14	26	0.00004
ERR6913180	Bacteroides sp. D2	556259	S	11	21	32	0.00005
ERR6913180	Bacteroides humanifaecis	2792859	S	28	328	356	0.00052
ERR6913180	Bacteroides luhongzhouii	2650158	S	19	8	27	0.00004
ERR6913180	Phocaeicola salanitronis	376805	S	184	11	195	0.00029
ERR6913180	Phocaeicola coprophilus	387090	S	117	24	141	0.00021
ERR6913180	Phocaeicola dorei	357276	S	95	73	168	0.00025
ERR6913180	Phocaeicola vulgatus	821	S	81	67	148	0.00022
ERR6913180	Alistipes communis	2585118	S	138	22	160	0.00023
ERR6913180	Alistipes megaguti	2364787	S	129	13	142	0.00021
ERR6913180	Alistipes onderdonkii	328813	S	125	55	180	0.00026
ERR6913180	Alistipes indistinctus	626932	S	95	4	99	0.00014
ERR6913180	Alistipes dispar	2585119	S	89	13	102	0.00015
ERR6913180	Alistipes finegoldii	214856	S	86	59	145	0.00021
ERR6913180	Alistipes senegalensis	1288121	S	85	30	115	0.00017
ERR6913180	Alistipes sp. dk3624	2662363	S	63	3	66	0.00010
ERR6913180	Alistipes shahii	328814	S	61	43	104	0.00015
ERR6913180	Alistipes ihumii	1470347	S	58	1	59	0.00009
ERR6913180	Duncaniella dubosii	2518971	S	171	40	211	0.00031
ERR6913180	Muribaculum gordoncarteri	2530390	S	166	22	188	0.00027
ERR6913180	Muribaculum intestinale	1796646	S	155	10	165	0.00024
ERR6913180	Sodaliphilus pleomorphus	2606626	S	179	5	184	0.00027
ERR6913180	Barnesiella viscericola	397865	S	200	15	215	0.00031
ERR6913180	Coprobacter secundus	1501392	S	124	9	133	0.00019
ERR6913180	Petrimonas mucosa	1642646	S	91	9	100	0.00015
ERR6913180	Proteiniphilum propionicum	2829812	S	38	3	41	0.00006
ERR6913180	Proteiniphilum saccharofermentans	1642647	S	36	4	40	0.00006
ERR6913180	Dysgonomonas sp. HDW5B	2714927	S	10	16	26	0.00004
ERR6913180	Dysgonomonas sp. HDW5A	2714926	S	6	10	16	0.00002
ERR6913180	Odoribacter splanchnicus	28118	S	113	38	151	0.00022
ERR6913180	Butyricimonas faecalis	2093856	S	28	9	37	0.00005
ERR6913180	Butyricimonas virosa	544645	S	18	2	20	0.00003
ERR6913180	Salinivirga cyanobacteriivorans	1307839	S	21	0	21	0.00003
ERR6913180	Tenuifilum thalassicum	2590900	S	17	0	17	0.00002
ERR6913180	Paludibacter propionicigenes	185300	S	16	0	16	0.00002
ERR6913180	Candidatus Azobacteroides pseudotrichonymphae	511435	S	14	0	14	0.00002
ERR6913180	Draconibacterium orientale	1168034	S	52	1	53	0.00008
ERR6913180	Draconibacterium halophilum	2706887	S	6	0	6	0.00001
ERR6913180	Maribellus comscasis	2681766	S	22	0	22	0.00003
ERR6913180	Alkaliflexus sp. Ai-910	2949635	S	15	1	16	0.00002
ERR6913180	Alkalitalea saponilacus	889453	S	11	0	11	0.00002
ERR6913180	Labilibaculum antarcticum	1717717	S	21	1	22	0.00003
ERR6913180	Capnocytophaga sp. FDAARGOS_737	2545799	S	8184	897	9081	0.01328
ERR6913180	Capnocytophaga sp. oral taxon 878	1316596	S	487	21	508	0.00074
ERR6913180	Capnocytophaga sp. oral taxon 323	1705617	S	63	37	100	0.00015
ERR6913180	Capnocytophaga sp. oral taxon 864	1316593	S	44	23	67	0.00010
ERR6913180	Capnocytophaga sp. oral taxon 902	2748316	S	25	23	48	0.00007
ERR6913180	Capnocytophaga sp. H2931	1945657	S	5	6	11	0.00002
ERR6913180	Capnocytophaga sp. H4358	1945658	S	5	6	11	0.00002
ERR6913180	Capnocytophaga leadbetteri	327575	S	8735	934	9669	0.01414
ERR6913180	Capnocytophaga gingivalis	1017	S	4317	75	4392	0.00642
ERR6913180	Capnocytophaga sputigena	1019	S	1830	112	1942	0.00284
ERR6913180	Capnocytophaga endodontalis	2708117	S	446	42	488	0.00071
ERR6913180	Capnocytophaga ochracea	1018	S	396	143	539	0.00079
ERR6913180	Capnocytophaga stomatis	1848904	S	76	2	78	0.00011
ERR6913180	Capnocytophaga canimorsus	28188	S	69	2	71	0.00010
ERR6913180	Capnocytophaga haemolytica	45243	S	63	0	63	0.00009
ERR6913180	Capnocytophaga cynodegmi	28189	S	8	0	8	0.00001
ERR6913180	Flavobacterium sp. N2820	2986834	S	14	4	18	0.00003
ERR6913180	Flavobacterium sp. CJ74	2294119	S	13	0	13	0.00002
ERR6913180	Flavobacterium sp. MFBS3-15	2989816	S	12	0	12	0.00002
ERR6913180	Flavobacterium sp. Sr18	935222	S	11	5	16	0.00002
ERR6913180	Flavobacterium sp. IMCC36793	3003263	S	11	4	15	0.00002
ERR6913180	Flavobacterium sp. IMCC36792	3016339	S	9	3	12	0.00002
ERR6913180	Flavobacterium sp. K5-23	2746225	S	8	2	10	0.00001
ERR6913180	Flavobacterium sp. N1736	2986823	S	8	7	15	0.00002
ERR6913180	Flavobacterium sp. M31R6	2739062	S	8	4	12	0.00002
ERR6913180	Flavobacterium sp. 140616W15	2478552	S	8	2	10	0.00001
ERR6913180	Flavobacterium sp. KK2020170	2830782	S	7	2	9	0.00001
ERR6913180	Flavobacterium sp. N1719	2885633	S	7	0	7	0.00001
ERR6913180	Flavobacterium sp. xlx-214	2654325	S	7	0	7	0.00001
ERR6913180	Flavobacterium sp. N3904	2986835	S	7	4	11	0.00002
ERR6913180	Flavobacterium sp. N502536	2986837	S	6	9	15	0.00002
ERR6913180	Flavobacterium sp. CC-SYL302	2870839	S	6	0	6	0.00001
ERR6913180	Flavobacterium sp. KACC 22763	3025668	S	6	23	29	0.00004
ERR6913180	Flavobacterium sp. N1994	2986827	S	5	0	5	0.00001
ERR6913180	Flavobacterium sp. SLB02	2665645	S	5	8	13	0.00002
ERR6913180	Flavobacterium sp. LPB0248	2614441	S	5	11	16	0.00002
ERR6913180	Flavobacterium sp. MDT1-60	1979344	S	5	4	9	0.00001
ERR6913180	Flavobacterium sp. IMCC36791	3003262	S	5	1	6	0.00001
ERR6913180	Flavobacterium pallidum	2172098	S	18	1	19	0.00003
ERR6913180	Flavobacterium faecale	1355330	S	17	1	18	0.00003
ERR6913180	Flavobacterium davisii	2906077	S	14	5	19	0.00003
ERR6913180	Flavobacterium magnum	2162713	S	12	1	13	0.00002
ERR6913180	Flavobacterium branchiophilum	55197	S	11	0	11	0.00002
ERR6913180	Flavobacterium psychrophilum	96345	S	9	1	10	0.00001
ERR6913180	Flavobacterium haoranii	683124	S	9	4	13	0.00002
ERR6913180	Flavobacterium sediminis	2201181	S	9	1	10	0.00001
ERR6913180	Flavobacterium album	2175091	S	8	0	8	0.00001
ERR6913180	Flavobacterium kingsejongi	1678728	S	8	1	9	0.00001
ERR6913180	Flavobacterium covae	2906076	S	7	15	22	0.00003
ERR6913180	Flavobacterium litorale	2856519	S	7	0	7	0.00001
ERR6913180	Flavobacterium azooxidireducens	1871076	S	6	0	6	0.00001
ERR6913180	Flavobacterium commune	1306519	S	6	1	7	0.00001
ERR6913180	Flavobacterium channae	2897181	S	6	3	9	0.00001
ERR6913180	Flavobacterium fluviale	2249356	S	5	4	9	0.00001
ERR6913180	Flavobacterium nackdongense	2547394	S	5	0	5	0.00001
ERR6913180	Flavobacterium inviolabile	2748320	S	5	0	5	0.00001
ERR6913180	Flavobacterium endoglycinae	2816357	S	5	2	7	0.00001
ERR6913180	Flavobacterium oreochromis	2906078	S	5	1	6	0.00001
ERR6913180	Flavobacterium anhuiense	459526	S	5	5	10	0.00001
ERR6913180	Flavobacterium collinsii	1114861	S	5	6	11	0.00002
ERR6913180	Polaribacter sp. Hel1_33_78	1336804	S	7	0	7	0.00001
ERR6913180	Polaribacter sp. Q13	2806551	S	7	2	9	0.00001
ERR6913180	Polaribacter sp. NJDZ03	2855841	S	7	4	11	0.00002
ERR6913180	Polaribacter sejongensis	985043	S	7	7	14	0.00002
ERR6913180	Polaribacter reichenbachii	996801	S	5	0	5	0.00001
ERR6913180	Muricauda sp. SCSIO 64092	2908842	S	17	0	17	0.00002
ERR6913180	Muricauda sp. SCSIO 65647	2908843	S	5	0	5	0.00001
ERR6913180	Muricauda oceani	2698672	S	14	1	15	0.00002
ERR6913180	Muricauda ruestringensis	111501	S	12	0	12	0.00002
ERR6913180	Muricauda aquimarina	254955	S	8	1	9	0.00001
ERR6913180	Muricauda lutaonensis	516051	S	7	0	7	0.00001
ERR6913180	Muricauda aurantiaca	1383885	S	6	0	6	0.00001
ERR6913180	Myroides odoratus	256	S	17	0	17	0.00002
ERR6913180	Myroides odoratimimus	76832	S	12	11	23	0.00003
ERR6913180	Myroides phaeus	702745	S	11	0	11	0.00002
ERR6913180	Nonlabens sp. Ci31	2608253	S	14	0	14	0.00002
ERR6913180	Nonlabens sp. SY33080	2719911	S	9	3	12	0.00002
ERR6913180	Nonlabens sp. Hel1_33_55	1336802	S	8	0	8	0.00001
ERR6913180	Nonlabens marinus	930802	S	7	0	7	0.00001
ERR6913180	Nonlabens ponticola	2496866	S	6	0	6	0.00001
ERR6913180	Nonlabens spongiae	331648	S	5	0	5	0.00001
ERR6913180	Gramella forsetii	411153	S	19	1	20	0.00003
ERR6913180	Gramella sp. MAR_2010_147	1250205	S	6	0	6	0.00001
ERR6913180	Gramella sp. MT6	2705471	S	5	0	5	0.00001
ERR6913180	Gramella fulva	2126553	S	8	0	8	0.00001
ERR6913180	Gramella salexigens	1913577	S	6	0	6	0.00001
ERR6913180	Tenacibaculum jejuense	584609	S	14	0	14	0.00002
ERR6913180	Tenacibaculum sp. SZ-18	754423	S	5	4	9	0.00001
ERR6913180	Tenacibaculum pacificus	3018314	S	8	1	9	0.00001
ERR6913180	Tenacibaculum mesophilum	104268	S	6	1	7	0.00001
ERR6913180	Tenacibaculum singaporense	2358479	S	5	0	5	0.00001
ERR6913180	Zunongwangia profunda	398743	S	21	3	24	0.00004
ERR6913180	Zunongwangia sp. HGR-M22	3015168	S	6	2	8	0.00001
ERR6913180	Zunongwangia sp. SCSIO 43204	2779359	S	5	0	5	0.00001
ERR6913180	Zunongwangia sp. HRR-M8	3015170	S	5	2	7	0.00001
ERR6913180	Winogradskyella sp. J14-2	1936080	S	7	0	7	0.00001
ERR6913180	Winogradskyella sp. PG-2	754409	S	6	0	6	0.00001
ERR6913180	Winogradskyella sp. HaHa_3_26	2749995	S	5	1	6	0.00001
ERR6913180	Formosa sp. Hel1_33_131	1336794	S	7	0	7	0.00001
ERR6913180	Formosa sp. Hel3_A1_48	1336795	S	6	0	6	0.00001
ERR6913180	Formosa sp. L2A11	2686363	S	5	0	5	0.00001
ERR6913180	Formosa agariphila	320324	S	10	0	10	0.00001
ERR6913180	Salegentibacter salegens	143223	S	22	0	22	0.00003
ERR6913180	Salegentibacter sp. T436	1729720	S	9	1	10	0.00001
ERR6913180	Maribacter sp. HL-LV01	2976127	S	5	0	5	0.00001
ERR6913180	Maribacter cobaltidurans	1178778	S	8	2	10	0.00001
ERR6913180	Antarcticibacterium flavum	2058175	S	10	0	10	0.00001
ERR6913180	Antarcticibacterium arcticum	2585771	S	9	0	9	0.00001
ERR6913180	Antarcticibacterium sp. 1MA-6-2	2908210	S	6	0	6	0.00001
ERR6913180	Aequorivita sublithincola	101385	S	5	17	22	0.00003
ERR6913180	Lutibacter sp. A64	2918526	S	6	8	14	0.00002
ERR6913180	Lutibacter profundi	1622118	S	6	0	6	0.00001
ERR6913180	Aquimarina sp. AD1	1714848	S	8	1	9	0.00001
ERR6913180	Zobellia galactanivorans	63186	S	21	0	21	0.00003
ERR6913180	Cellulophaga sp. HaHaR_3_176	1942464	S	7	4	11	0.00002
ERR6913180	Muriicola soli	2507538	S	18	0	18	0.00003
ERR6913180	Lacinutrix sp. HL-RS19	2980107	S	6	0	6	0.00001
ERR6913180	Lacinutrix venerupis	1486034	S	5	0	5	0.00001
ERR6913180	Tamlana carrageenivorans	2069432	S	8	4	12	0.00002
ERR6913180	Kordia antarctica	1218801	S	9	0	9	0.00001
ERR6913180	Kordia sp. SMS9	2282170	S	7	0	7	0.00001
ERR6913180	Seonamhaeicola sp. S2-3	1936081	S	10	0	10	0.00001
ERR6913180	Seonamhaeicola sp. ML3	2937786	S	5	0	5	0.00001
ERR6913180	Dokdonia sp. 4H-3-7-5	983548	S	6	4	10	0.00001
ERR6913180	Mesoflavibacter sp. SCSIO 43206	2779362	S	10	6	16	0.00002
ERR6913180	Croceibacter atlanticus	313588	S	12	0	12	0.00002
ERR6913180	Aureibaculum algae	2584122	S	10	0	10	0.00001
ERR6913180	Mariniflexile sp. TRM1-10	2027857	S	10	0	10	0.00001
ERR6913180	Candidatus Arcticimaribacter forsetii	2820661	S	10	0	10	0.00001
ERR6913180	Sinomicrobium kalidii	2900738	S	9	0	9	0.00001
ERR6913180	Psychroserpens sp. MSW6	2932268	S	5	0	5	0.00001
ERR6913180	Flavivirga eckloniae	1803846	S	9	0	9	0.00001
ERR6913180	Abyssalbus ytuae	2926907	S	9	0	9	0.00001
ERR6913180	Psychroflexus sp. ALD_RP9	2777186	S	8	0	8	0.00001
ERR6913180	Amniculibacterium sp. G2-70	2767188	S	9	1	10	0.00001
ERR6913180	Zhouia spongiae	2202721	S	8	0	8	0.00001
ERR6913180	Siansivirga zeaxanthinifaciens	762954	S	8	0	8	0.00001
ERR6913180	Aegicerativicinus sediminis	2893202	S	7	0	7	0.00001
ERR6913180	Wenyingzhuangia fucanilytica	1790137	S	6	0	6	0.00001
ERR6913180	Gilvibacter sp. SZ-19	754429	S	6	0	6	0.00001
ERR6913180	Pukyongia salina	2094025	S	6	0	6	0.00001
ERR6913180	Constantimarinum furrinae	2562285	S	6	0	6	0.00001
ERR6913180	Salinimicrobium sp. HN-2-9-2	2809707	S	6	0	6	0.00001
ERR6913180	Urechidicola croceus	1850246	S	5	0	5	0.00001
ERR6913180	Robiginitalea biformata	252307	S	5	0	5	0.00001
ERR6913180	Chryseobacterium sp. KACC 21268	3025664	S	18	1	19	0.00003
ERR6913180	Chryseobacterium sp.	1871047	S	17	6	23	0.00003
ERR6913180	Chryseobacterium sp. 6424	2039166	S	11	2	13	0.00002
ERR6913180	Chryseobacterium sp. T16E-39	2015076	S	10	1	11	0.00002
ERR6913180	Chryseobacterium sp. MEBOG07	2879939	S	10	6	16	0.00002
ERR6913180	Chryseobacterium sp. IHB B 17019	1721091	S	8	1	9	0.00001
ERR6913180	Chryseobacterium sp. CY350	2997336	S	8	2	10	0.00001
ERR6913180	Chryseobacterium sp. ZHDP1	2838877	S	8	9	17	0.00002
ERR6913180	Chryseobacterium sp. POL2	2713414	S	7	1	8	0.00001
ERR6913180	Chryseobacterium sp. LJ668	2864040	S	6	1	7	0.00001
ERR6913180	Chryseobacterium shandongense	1493872	S	28	11	39	0.00006
ERR6913180	Chryseobacterium indologenes	253	S	24	9	33	0.00005
ERR6913180	Chryseobacterium indoltheticum	254	S	18	6	24	0.00004
ERR6913180	Chryseobacterium aureum	2497456	S	13	4	17	0.00002
ERR6913180	Chryseobacterium arthrosphaerae	651561	S	13	4	17	0.00002
ERR6913180	Chryseobacterium capnotolerans	2759528	S	12	5	17	0.00002
ERR6913180	Chryseobacterium gallinarum	1324352	S	10	1	11	0.00002
ERR6913180	Chryseobacterium suipulveris	2929800	S	9	1	10	0.00001
ERR6913180	Chryseobacterium piperi	558152	S	9	1	10	0.00001
ERR6913180	Chryseobacterium salivictor	2547600	S	8	1	9	0.00001
ERR6913180	Chryseobacterium taklimakanense	536441	S	8	1	9	0.00001
ERR6913180	Chryseobacterium gleum	250	S	7	6	13	0.00002
ERR6913180	Chryseobacterium camelliae	1265445	S	7	1	8	0.00001
ERR6913180	Chryseobacterium carnipullorum	1124835	S	7	2	9	0.00001
ERR6913180	Chryseobacterium oranimense	421058	S	7	1	8	0.00001
ERR6913180	Chryseobacterium balustinum	246	S	6	3	9	0.00001
ERR6913180	Chryseobacterium oryzae	2929799	S	5	1	6	0.00001
ERR6913180	Chryseobacterium joostei	112234	S	5	2	7	0.00001
ERR6913180	Chryseobacterium gambrini	373672	S	5	3	8	0.00001
ERR6913180	Kaistella sp. 97-N-M2	2908645	S	8	0	8	0.00001
ERR6913180	Kaistella sp. GW4-15	2878534	S	6	0	6	0.00001
ERR6913180	Kaistella sp. BT6-1-3	2989820	S	6	3	9	0.00001
ERR6913180	Kaistella carnis	1241979	S	8	2	10	0.00001
ERR6913180	Kaistella flava (ex Peng et al. 2021)	2038776	S	5	0	5	0.00001
ERR6913180	Epilithonimonas vandammei	2487072	S	6	3	9	0.00001
ERR6913180	Cruoricaptor ignavus	1118202	S	159	9	168	0.00025
ERR6913180	Riemerella anatipestifer	34085	S	55	2	57	0.00008
ERR6913180	Elizabethkingia sp. JS20170427COW	2583851	S	11	0	11	0.00002
ERR6913180	Elizabethkingia anophelis	1117645	S	9	7	16	0.00002
ERR6913180	Elizabethkingia meningoseptica	238	S	7	0	7	0.00001
ERR6913180	Elizabethkingia bruuniana	1756149	S	5	8	13	0.00002
ERR6913180	Elizabethkingia ursingii	1756150	S	5	0	5	0.00001
ERR6913180	Bergeyella cardium	1585976	S	29	0	29	0.00004
ERR6913180	Cloacibacterium caeni	2004710	S	13	8	21	0.00003
ERR6913180	Cloacibacterium sp. TD35	2976818	S	8	2	10	0.00001
ERR6913180	Ornithobacterium rhinotracheale	28251	S	26	1	27	0.00004
ERR6913180	Apibacter raozihei	2500547	S	7	1	8	0.00001
ERR6913180	Empedobacter brevis	247	S	8	0	8	0.00001
ERR6913180	Blattabacterium cuenoti	1653831	S	38	1	39	0.00006
ERR6913180	Blattabacterium sp. (Blaberus giganteus)	1186051	S	6	0	6	0.00001
ERR6913180	Owenweeksia hongkongensis	253245	S	12	0	12	0.00002
ERR6913180	Croceimicrobium hydrocarbonivorans	2761580	S	9	0	9	0.00001
ERR6913180	Paracrocinitomix mangrovi	2862509	S	8	0	8	0.00001
ERR6913180	Hymenobacter sp. 5413J-13	2932251	S	40	6	46	0.00007
ERR6913180	Hymenobacter sp. PAMC 26628	1484118	S	34	9	43	0.00006
ERR6913180	Hymenobacter sp. BRD128	2675878	S	23	3	26	0.00004
ERR6913180	Hymenobacter sp. BT18	2835648	S	22	3	25	0.00004
ERR6913180	Hymenobacter sp. APR13	1356852	S	19	28	47	0.00007
ERR6913180	Hymenobacter sp. 5116S-3	2932248	S	17	3	20	0.00003
ERR6913180	Hymenobacter sp. 5116S-27	2932249	S	17	3	20	0.00003
ERR6913180	Hymenobacter sp. S2-20-2	2761579	S	13	2	15	0.00002
ERR6913180	Hymenobacter sp. YIM 151858-1	2987688	S	12	2	14	0.00002
ERR6913180	Hymenobacter sp. 5317J-9	2932250	S	12	3	15	0.00002
ERR6913180	Hymenobacter sp. 5420S-77	2932254	S	10	0	10	0.00001
ERR6913180	Hymenobacter sp. DG01	2584940	S	9	2	11	0.00002
ERR6913180	Hymenobacter sp. BRD67	2675877	S	9	6	15	0.00002
ERR6913180	Hymenobacter sp. 5516S-25	2933777	S	8	28	36	0.00005
ERR6913180	Hymenobacter sp. PAMC 29467	2999067	S	7	4	11	0.00002
ERR6913180	Hymenobacter sp. 5516J-16	2932253	S	6	23	29	0.00004
ERR6913180	Hymenobacter sp. HDW8	2714932	S	6	13	19	0.00003
ERR6913180	Hymenobacter sp. DG25A	1385663	S	6	2	8	0.00001
ERR6913180	Hymenobacter sp. NBH84	2596915	S	5	0	5	0.00001
ERR6913180	Hymenobacter sp. YIM 151500-1	2987689	S	5	0	5	0.00001
ERR6913180	Hymenobacter psoromatis	1484116	S	19	2	21	0.00003
ERR6913180	Hymenobacter jejuensis	2502781	S	18	1	19	0.00003
ERR6913180	Hymenobacter monticola	1705399	S	15	2	17	0.00002
ERR6913180	Hymenobacter nivis	1850093	S	15	4	19	0.00003
ERR6913180	Hymenobacter radiodurans	2496028	S	15	36	51	0.00007
ERR6913180	Hymenobacter tibetensis	497967	S	11	1	12	0.00002
ERR6913180	Hymenobacter sedentarius	1411621	S	11	1	12	0.00002
ERR6913180	Hymenobacter oligotrophus	2319843	S	11	2	13	0.00002
ERR6913180	Hymenobacter qilianensis	1385715	S	10	1	11	0.00002
ERR6913180	Hymenobacter yonginensis	748197	S	5	6	11	0.00002
ERR6913180	Pontibacter sp. XAAS-72	2592049	S	34	4	38	0.00006
ERR6913180	Pontibacter sp. SGAir0037	2571030	S	9	1	10	0.00001
ERR6913180	Pontibacter actiniarum	323450	S	14	2	16	0.00002
ERR6913180	Pontibacter korlensis	400092	S	13	1	14	0.00002
ERR6913180	Rufibacter radiotolerans	1379910	S	22	1	23	0.00003
ERR6913180	Rufibacter tibetensis	512763	S	11	0	11	0.00002
ERR6913180	Rufibacter sp. DG15C	1379909	S	11	3	14	0.00002
ERR6913180	Adhaeribacter radiodurans	2745197	S	5	0	5	0.00001
ERR6913180	Dyadobacter sp. U1	2910158	S	20	0	20	0.00003
ERR6913180	Dyadobacter sp. NIV53	2861765	S	7	0	7	0.00001
ERR6913180	Dyadobacter sp. CY399	2906443	S	7	0	7	0.00001
ERR6913180	Dyadobacter fermentans	94254	S	34	2	36	0.00005
ERR6913180	Dyadobacter sandarakinus	2747268	S	12	0	12	0.00002
ERR6913180	Runella rosea	2259595	S	31	2	33	0.00005
ERR6913180	Runella sp. SP2	2268026	S	22	0	22	0.00003
ERR6913180	Runella slithyformis	106	S	6	0	6	0.00001
ERR6913180	Fibrella aestuarina	651143	S	31	3	34	0.00005
ERR6913180	Fibrella sp. ES10-3-2-2	1834519	S	15	1	16	0.00002
ERR6913180	Larkinella sp. IE-0392	2907205	S	17	1	18	0.00003
ERR6913180	Marinilongibacter aquaticus	2975157	S	17	0	17	0.00002
ERR6913180	Leadbetterella byssophila	316068	S	9	0	9	0.00001
ERR6913180	Arcticibacterium luteifluviistationis	1784714	S	7	0	7	0.00001
ERR6913180	Spirosoma sp. KCTC 42546	2520506	S	12	5	17	0.00002
ERR6913180	Spirosoma sp. KUDC1026	2745947	S	12	1	13	0.00002
ERR6913180	Spirosoma pollinicola	2057025	S	33	2	35	0.00005
ERR6913180	Spirosoma rhododendri	2728024	S	16	1	17	0.00002
ERR6913180	Spirosoma montaniterrae	1178516	S	14	0	14	0.00002
ERR6913180	Spirosoma taeanense	2735870	S	14	1	15	0.00002
ERR6913180	Spirosoma endbachense	2666025	S	12	12	24	0.00004
ERR6913180	Spirosoma radiotolerans	1379870	S	7	0	7	0.00001
ERR6913180	Spirosoma aerolatum	1211326	S	6	0	6	0.00001
ERR6913180	Tellurirhabdus rosea	2674997	S	29	3	32	0.00005
ERR6913180	Aquirufa antheringensis	2516559	S	13	3	16	0.00002
ERR6913180	Rhodocytophaga rosea	2704465	S	5	0	5	0.00001
ERR6913180	Echinicola sp. 20G	2781961	S	34	1	35	0.00005
ERR6913180	Echinicola vietnamensis	390884	S	17	2	19	0.00003
ERR6913180	Echinicola strongylocentroti	1795355	S	14	0	14	0.00002
ERR6913180	Echinicola soli	2591634	S	9	0	9	0.00001
ERR6913180	Echinicola marina	2859768	S	8	1	9	0.00001
ERR6913180	Echinicola rosea	1807691	S	5	0	5	0.00001
ERR6913180	Algoriphagus sp. NBT04N3	2705473	S	7	9	16	0.00002
ERR6913180	Algoriphagus sanaruensis	1727163	S	8	0	8	0.00001
ERR6913180	Algoriphagus machipongonensis	388413	S	6	0	6	0.00001
ERR6913180	Belliella baltica	232259	S	11	0	11	0.00002
ERR6913180	Cyclobacterium amurskyense	320787	S	6	1	7	0.00001
ERR6913180	Mongoliitalea daihaiensis	2782006	S	6	0	6	0.00001
ERR6913180	Fulvivirga sp. SS9-22	2904245	S	15	0	15	0.00002
ERR6913180	Fulvivirga sp. SW1-E11	2904247	S	10	0	10	0.00001
ERR6913180	Chryseolinea soli	2321403	S	24	0	24	0.00004
ERR6913180	Flammeovirga kamogawensis	373891	S	15	9	24	0.00004
ERR6913180	Flammeovirga pectinis	2494373	S	6	3	9	0.00001
ERR6913180	Reichenbachiella sp. BKB1-1	2979464	S	7	0	7	0.00001
ERR6913180	Persicobacter sp. JZB09	1085624	S	8	0	8	0.00001
ERR6913180	Bernardetia litoralis	999	S	7	0	7	0.00001
ERR6913180	Marivirga tractuosa	1006	S	5	0	5	0.00001
ERR6913180	Sphingobacterium sp. LZ7M1	2961941	S	21	1	22	0.00003
ERR6913180	Sphingobacterium sp. CZ-2	2557994	S	16	0	16	0.00002
ERR6913180	Sphingobacterium sp. G1-14	2003121	S	9	7	16	0.00002
ERR6913180	Sphingobacterium sp. UDSM-2020	2795738	S	9	0	9	0.00001
ERR6913180	Sphingobacterium sp. KACC 22765	3025669	S	9	0	9	0.00001
ERR6913180	Sphingobacterium sp. ML3W	1538644	S	6	0	6	0.00001
ERR6913180	Sphingobacterium thalpophilum	259	S	31	1	32	0.00005
ERR6913180	Sphingobacterium multivorum	28454	S	19	5	24	0.00004
ERR6913180	Sphingobacterium lactis	797291	S	16	0	16	0.00002
ERR6913180	Sphingobacterium hotanense	649196	S	15	0	15	0.00002
ERR6913180	Sphingobacterium spiritivorum	258	S	12	0	12	0.00002
ERR6913180	Sphingobacterium mizutaii	1010	S	12	0	12	0.00002
ERR6913180	Sphingobacterium psychroaquaticum	561061	S	11	0	11	0.00002
ERR6913180	Sphingobacterium faecium	34087	S	7	3	10	0.00001
ERR6913180	Sphingobacterium daejeonense	371142	S	6	0	6	0.00001
ERR6913180	Pedobacter sp. G11	2482728	S	15	1	16	0.00002
ERR6913180	Pedobacter sp. HDW13	2714940	S	10	0	10	0.00001
ERR6913180	Pedobacter sp. PACM 27299	1727164	S	7	0	7	0.00001
ERR6913180	Pedobacter cryoconitis	188932	S	20	0	20	0.00003
ERR6913180	Pedobacter suwonensis	332999	S	19	3	22	0.00003
ERR6913180	Pedobacter mucosus	2895286	S	14	0	14	0.00002
ERR6913180	Pedobacter endophyticus	2789740	S	11	0	11	0.00002
ERR6913180	Pedobacter schmidteae	2201271	S	10	0	10	0.00001
ERR6913180	Pedobacter heparinus	984	S	9	0	9	0.00001
ERR6913180	Pedobacter ginsengisoli	363852	S	7	0	7	0.00001
ERR6913180	Pedobacter riviphilus	2766984	S	5	1	6	0.00001
ERR6913180	Mucilaginibacter sp. KACC 22773	3025671	S	9	19	28	0.00004
ERR6913180	Mucilaginibacter sp. 14171R-50	2703789	S	7	1	8	0.00001
ERR6913180	Mucilaginibacter paludis	423351	S	14	1	15	0.00002
ERR6913180	Mucilaginibacter ginkgonis	2682091	S	12	1	13	0.00002
ERR6913180	Mucilaginibacter daejeonensis	398049	S	8	1	9	0.00001
ERR6913180	Mucilaginibacter ginsenosidivorans	398053	S	8	0	8	0.00001
ERR6913180	Mucilaginibacter gotjawali	1550579	S	8	1	9	0.00001
ERR6913180	Mucilaginibacter jinjuensis	1176721	S	6	1	7	0.00001
ERR6913180	Mucilaginibacter robiniae	2728022	S	5	0	5	0.00001
ERR6913180	Olivibacter sp. LS-1	2592345	S	9	0	9	0.00001
ERR6913180	Pseudopedobacter saltans	151895	S	12	0	12	0.00002
ERR6913180	Solitalea canadensis	995	S	5	1	6	0.00001
ERR6913180	Anseongella ginsenosidimutans	496056	S	6	0	6	0.00001
ERR6913180	Chitinophaga sp. XS-30	2604421	S	12	10	22	0.00003
ERR6913180	Chitinophaga sp. HK235	2952571	S	9	7	16	0.00002
ERR6913180	Chitinophaga sp. R8	2920382	S	5	5	10	0.00001
ERR6913180	Chitinophaga oryzae	2725414	S	20	4	24	0.00004
ERR6913180	Chitinophaga pinensis	79329	S	14	4	18	0.00003
ERR6913180	Chitinophaga filiformis	104663	S	10	2	12	0.00002
ERR6913180	Chitinophaga caeni	2029983	S	7	0	7	0.00001
ERR6913180	Chitinophaga agri	2703787	S	6	2	8	0.00001
ERR6913180	Arachidicoccus sp. B3-10	2545455	S	11	1	12	0.00002
ERR6913180	Arachidicoccus sp. BS20	1850526	S	7	0	7	0.00001
ERR6913180	Arachidicoccus ginsenosidivorans	496057	S	5	0	5	0.00001
ERR6913180	Arachidicoccus terrestris	2875539	S	5	0	5	0.00001
ERR6913180	Ferruginibacter albus	2875540	S	15	1	16	0.00002
ERR6913180	Ferruginibacter lapsinanis	563172	S	11	0	11	0.00002
ERR6913180	Flavisolibacter ginsenosidimutans	661481	S	15	0	15	0.00002
ERR6913180	Flavisolibacter tropicus	1492898	S	5	0	5	0.00001
ERR6913180	Niabella ginsenosidivorans	1176587	S	12	1	13	0.00002
ERR6913180	Niabella soli	446683	S	7	0	7	0.00001
ERR6913180	Phnomibacter ginsenosidimutans	2676868	S	16	2	18	0.00003
ERR6913180	Lacibacter sp. S13-6-22	2760713	S	13	1	14	0.00002
ERR6913180	Flavihumibacter rivuli	2838156	S	12	1	13	0.00002
ERR6913180	Pseudobacter ginsenosidimutans	661488	S	10	1	11	0.00002
ERR6913180	Pseudocnuella soli	2502779	S	10	1	11	0.00002
ERR6913180	Niastella koreensis	354356	S	7	0	7	0.00001
ERR6913180	Sediminibacterium sp. TEGAF015	575378	S	5	0	5	0.00001
ERR6913180	Filimonas lacunae	477680	S	5	0	5	0.00001
ERR6913180	Panacibacter ginsenosidivorans	1813871	S	5	0	5	0.00001
ERR6913180	Paraflavitalea soli	2315862	S	5	0	5	0.00001
ERR6913180	Rhodothermus marinus	29549	S	37	0	37	0.00005
ERR6913180	Salinibacter ruber	146919	S	18	0	18	0.00003
ERR6913180	Rhodocaloribacter litoris	2558931	S	17	0	17	0.00002
ERR6913180	Candidatus Sulfidibacterium hydrothermale	2875962	S	8	0	8	0.00001
ERR6913180	Saprospira grandis	1008	S	11	0	11	0.00002
ERR6913180	Aureispira sp. EL160426	2864201	S	9	0	9	0.00001
ERR6913180	Haliscomenobacter hydrossis	2350	S	19	0	19	0.00003
ERR6913180	Chlorobaculum limnaeum	274537	S	9	3	12	0.00002
ERR6913180	Chlorobaculum parvum	274539	S	9	3	12	0.00002
ERR6913180	Chlorobium phaeovibrioides	1094	S	7	0	7	0.00001
ERR6913180	Cyclonatronum proteinivorum	1457365	S	8	0	8	0.00001
ERR6913180	Ignavibacterium album	591197	S	5	0	5	0.00001
ERR6913180	Gemmatirosa kalamazoonensis	861299	S	11	0	11	0.00002
ERR6913180	Fibrobacter succinogenes	833	S	14	0	14	0.00002
ERR6913180	Haemophilus parainfluenzae	729	S	23597	1063	24660	0.03607
ERR6913180	Haemophilus haemolyticus	726	S	1492	185	1677	0.00245
ERR6913180	Haemophilus influenzae	727	S	868	415	1283	0.00188
ERR6913180	Haemophilus sp. oral taxon 036	712310	S	418	65	483	0.00071
ERR6913180	Haemophilus parahaemolyticus	735	S	81	2	83	0.00012
ERR6913180	Haemophilus pittmaniae	249188	S	44	1	45	0.00007
ERR6913180	[Haemophilus] ducreyi	730	S	12	0	12	0.00002
ERR6913180	Aggregatibacter aphrophilus	732	S	1283	90	1373	0.00201
ERR6913180	Aggregatibacter sp. Marseille-P9115	2866570	S	204	40	244	0.00036
ERR6913180	Aggregatibacter sp. oral taxon 513	712150	S	133	27	160	0.00023
ERR6913180	Aggregatibacter sp. 2125159857	2820817	S	95	8	103	0.00015
ERR6913180	Aggregatibacter segnis	739	S	81	13	94	0.00014
ERR6913180	Aggregatibacter actinomycetemcomitans	714	S	35	1	36	0.00005
ERR6913180	Mannheimia varigena	85404	S	18	5	23	0.00003
ERR6913180	Mannheimia granulomatis	85402	S	13	0	13	0.00002
ERR6913180	Mannheimia haemolytica	75985	S	10	0	10	0.00001
ERR6913180	Mannheimia ovis	2679994	S	7	13	20	0.00003
ERR6913180	Actinobacillus suis	716	S	15	2	17	0.00002
ERR6913180	Actinobacillus pleuropneumoniae	715	S	14	11	25	0.00004
ERR6913180	Actinobacillus porcitonsillarum	189834	S	11	0	11	0.00002
ERR6913180	Actinobacillus equuli	718	S	5	0	5	0.00001
ERR6913180	Actinobacillus indolicus	51049	S	5	0	5	0.00001
ERR6913180	Actinobacillus sp. GY-402	2774188	S	5	0	5	0.00001
ERR6913180	Pasteurella multocida	747	S	22	9	31	0.00005
ERR6913180	Pasteurella dagmatis	754	S	10	0	10	0.00001
ERR6913180	Pasteurella canis	753	S	9	0	9	0.00001
ERR6913180	Rodentibacter haemolyticus	2778911	S	12	0	12	0.00002
ERR6913180	Rodentibacter heylii	1906744	S	7	0	7	0.00001
ERR6913180	Avibacterium paragallinarum	728	S	8	0	8	0.00001
ERR6913180	Glaesserella parasuis	738	S	9	3	12	0.00002
ERR6913180	Mergibacter septicus	221402	S	10	0	10	0.00001
ERR6913180	Bibersteinia trehalosi	47735	S	6	26	32	0.00005
ERR6913180	Otariodibacter oris	1032623	S	6	0	6	0.00001
ERR6913180	Bisgaardia hudsonensis	109472	S	6	0	6	0.00001
ERR6913180	Frederiksenia canicola	123824	S	5	0	5	0.00001
ERR6913180	Enterobacter cloacae	550	S	11	10	21	0.00003
ERR6913180	Enterobacter ludwigii	299767	S	8	13	21	0.00003
ERR6913180	Enterobacter hormaechei	158836	S	5	29	34	0.00005
ERR6913180	Citrobacter sp. R56	1573676	S	5	4	9	0.00001
ERR6913180	Citrobacter farmeri	67824	S	6	9	15	0.00002
ERR6913180	Klebsiella pneumoniae	573	S	8	34	42	0.00006
ERR6913180	Klebsiella oxytoca	571	S	6	2	8	0.00001
ERR6913180	Klebsiella variicola	244366	S	6	6	12	0.00002
ERR6913180	Escherichia coli	562	S	22	66	88	0.00013
ERR6913180	Kosakonia radicincitans	283686	S	6	5	11	0.00002
ERR6913180	Salmonella enterica	28901	S	18	103	121	0.00018
ERR6913180	Jejubacter calystegiae	2579935	S	16	0	16	0.00002
ERR6913180	Kluyvera ascorbata	51288	S	9	0	9	0.00001
ERR6913180	Kluyvera intermedia	61648	S	5	0	5	0.00001
ERR6913180	Phytobacter ursingii	1972431	S	12	3	15	0.00002
ERR6913180	Plesiomonas shigelloides	703	S	6	0	6	0.00001
ERR6913180	Yokenella regensburgei	158877	S	6	0	6	0.00001
ERR6913180	Serratia rubidaea	61652	S	10	6	16	0.00002
ERR6913180	Serratia marcescens	615	S	7	7	14	0.00002
ERR6913180	Serratia sp. ATCC 39006	104623	S	6	0	6	0.00001
ERR6913180	Yersinia enterocolitica	630	S	7	4	11	0.00002
ERR6913180	Yersinia hibernica	2339259	S	6	3	9	0.00001
ERR6913180	Rahnella aquatilis	34038	S	12	6	18	0.00003
ERR6913180	Ewingella americana	41202	S	6	0	6	0.00001
ERR6913180	Pantoea sp. SO10	2575375	S	12	2	14	0.00002
ERR6913180	Pantoea agglomerans	549	S	13	7	20	0.00003
ERR6913180	Pantoea ananatis	553	S	8	1	9	0.00001
ERR6913180	Buchnera aphidicola	9	S	19	0	19	0.00003
ERR6913180	Mixta gaviniae	665914	S	6	2	8	0.00001
ERR6913180	Providencia alcalifaciens	126385	S	6	12	18	0.00003
ERR6913180	Proteus terrae	1574161	S	8	21	29	0.00004
ERR6913180	Xenorhabdus hominickii	351679	S	6	1	7	0.00001
ERR6913180	Morganella morganii	582	S	5	0	5	0.00001
ERR6913180	Pectobacterium carotovorum	554	S	6	5	11	0.00002
ERR6913180	Dickeya zeae	204042	S	6	4	10	0.00001
ERR6913180	Edwardsiella piscicida	1263550	S	8	11	19	0.00003
ERR6913180	Sodalis praecaptivus	1239307	S	9	4	13	0.00002
ERR6913180	Pseudomonas sp. JBR1	3020907	S	11	12	23	0.00003
ERR6913180	Pseudomonas sp. DTU12.3	2073078	S	10	3	13	0.00002
ERR6913180	Pseudomonas sp. Ost2	2678260	S	8	1	9	0.00001
ERR6913180	Pseudomonas sp. N3-W	2975049	S	7	1	8	0.00001
ERR6913180	Pseudomonas sp. B21-056	2895495	S	7	2	9	0.00001
ERR6913180	Pseudomonas sp. YeP6b	2861775	S	6	32	38	0.00006
ERR6913180	Pseudomonas sp. PIA16	2931382	S	6	0	6	0.00001
ERR6913180	Pseudomonas sp. PDNC002	2811422	S	6	1	7	0.00001
ERR6913180	Pseudomonas sp. Marseille-Q3773	2866592	S	5	2	7	0.00001
ERR6913180	Pseudomonas sp. IT P374	2964670	S	5	2	7	0.00001
ERR6913180	Pseudomonas sp. B21-053	2895493	S	5	2	7	0.00001
ERR6913180	Pseudomonas sp. LS44	1357074	S	5	0	5	0.00001
ERR6913180	Pseudomonas fluorescens	294	S	32	29	61	0.00009
ERR6913180	Pseudomonas protegens	380021	S	7	11	18	0.00003
ERR6913180	Pseudomonas putida	303	S	38	48	86	0.00013
ERR6913180	Pseudomonas oryzihabitans	47885	S	10	5	15	0.00002
ERR6913180	Pseudomonas aeruginosa	287	S	13	82	95	0.00014
ERR6913180	Pseudomonas viridiflava	33069	S	9	1	10	0.00001
ERR6913180	Pseudomonas syringae	317	S	6	9	15	0.00002
ERR6913180	Pseudomonas fragi	296	S	8	5	13	0.00002
ERR6913180	Pseudomonas brassicacearum	930166	S	9	27	36	0.00005
ERR6913180	Pseudomonas cremoricolorata	157783	S	7	0	7	0.00001
ERR6913180	Pseudomonas otitidis	319939	S	7	1	8	0.00001
ERR6913180	Pseudomonas entomophila	312306	S	5	2	7	0.00001
ERR6913180	Stutzerimonas stutzeri	316	S	5	4	9	0.00001
ERR6913180	Halopseudomonas xinjiangensis	487184	S	8	0	8	0.00001
ERR6913180	Denitrificimonas caeni	521720	S	9	0	9	0.00001
ERR6913180	Marinobacter sp. CA1	2817656	S	5	4	9	0.00001
ERR6913180	Marinobacter salinus	1874317	S	10	2	12	0.00002
ERR6913180	Pseudoalteromonas prydzensis	182141	S	47	31	78	0.00011
ERR6913180	Pseudoalteromonas rhizosphaerae	2518973	S	26	18	44	0.00006
ERR6913180	Pseudoalteromonas phenolica	161398	S	9	1	10	0.00001
ERR6913180	Pseudoalteromonas viridis	339617	S	7	4	11	0.00002
ERR6913180	Pseudoalteromonas luteoviolacea	43657	S	7	0	7	0.00001
ERR6913180	Pseudoalteromonas xiamenensis	882626	S	5	0	5	0.00001
ERR6913180	Shewanella sp. FJAT-54031	2864209	S	7	12	19	0.00003
ERR6913180	Shewanella donghaensis	238836	S	12	0	12	0.00002
ERR6913180	Shewanella avicenniae	2814294	S	12	0	12	0.00002
ERR6913180	Shewanella psychromarinicola	2487742	S	11	1	12	0.00002
ERR6913180	Shewanella litorisediminis	1173586	S	9	2	11	0.00002
ERR6913180	Shewanella putrefaciens	24	S	8	35	43	0.00006
ERR6913180	Shewanella denitrificans	192073	S	7	0	7	0.00001
ERR6913180	Shewanella maritima	2520507	S	7	0	7	0.00001
ERR6913180	Alteromonas macleodii	28108	S	13	6	19	0.00003
ERR6913180	Alteromonas pelagimontana	1858656	S	9	0	9	0.00001
ERR6913180	Glaciecola nitratireducens	300231	S	8	0	8	0.00001
ERR6913180	Hydrocarboniclastica marina	2259620	S	7	0	7	0.00001
ERR6913180	Thalassomonas viridans	137584	S	5	0	5	0.00001
ERR6913180	Thalassomonas haliotis	485448	S	5	0	5	0.00001
ERR6913180	Ferrimonas balearica	44012	S	6	0	6	0.00001
ERR6913180	Psychromonas ingrahamii	357794	S	5	0	5	0.00001
ERR6913180	Vibrio kanaloae	170673	S	73	61	134	0.00020
ERR6913180	Vibrio plantisponsor	664643	S	31	3	34	0.00005
ERR6913180	Vibrio parahaemolyticus	670	S	6	5	11	0.00002
ERR6913180	Vibrio aquimaris	2587862	S	11	0	11	0.00002
ERR6913180	Vibrio cholerae	666	S	6	7	13	0.00002
ERR6913180	Vibrio mimicus	674	S	6	1	7	0.00001
ERR6913180	Vibrio penaeicida	104609	S	6	0	6	0.00001
ERR6913180	Vibrio vulnificus	672	S	5	0	5	0.00001
ERR6913180	Vibrio toranzoniae	1194427	S	5	5	10	0.00001
ERR6913180	Vibrio mangrovi	474394	S	5	0	5	0.00001
ERR6913180	Vibrio scophthalmi	45658	S	5	0	5	0.00001
ERR6913180	Photobacterium damselae	38293	S	6	0	6	0.00001
ERR6913180	Grimontia hollisae	673	S	6	0	6	0.00001
ERR6913180	Paraphotobacterium marinum	1755811	S	7	0	7	0.00001
ERR6913180	Stenotrophomonas maltophilia	40324	S	28	22	50	0.00007
ERR6913180	Stenotrophomonas acidaminiphila	128780	S	11	12	23	0.00003
ERR6913180	Xanthomonas campestris	339	S	13	2	15	0.00002
ERR6913180	Xanthomonas fragariae	48664	S	6	0	6	0.00001
ERR6913180	Xanthomonas citri	346	S	5	36	41	0.00006
ERR6913180	Xanthomonas vasicola	56459	S	5	0	5	0.00001
ERR6913180	Lysobacter sp. TY2-98	2290922	S	5	3	8	0.00001
ERR6913180	Lysobacter sp. KIS68-7	2904252	S	5	3	8	0.00001
ERR6913180	Lysobacter enzymogenes	69	S	12	3	15	0.00002
ERR6913180	Lysobacter capsici	435897	S	5	3	8	0.00001
ERR6913180	Luteimonas sp. JM171	1896164	S	6	10	16	0.00002
ERR6913180	Thermomonas sp. XSG	2771436	S	10	2	12	0.00002
ERR6913180	Pseudolysobacter antarcticus	2511995	S	11	0	11	0.00002
ERR6913180	Luteibacter sp. 353	2911539	S	6	0	6	0.00001
ERR6913180	Luteibacter flocculans	2780091	S	6	0	6	0.00001
ERR6913180	Dyella japonica	231455	S	5	0	5	0.00001
ERR6913180	Rhodanobacter glycinis	582702	S	5	0	5	0.00001
ERR6913180	Halomonas sp. 3H	2952527	S	14	18	32	0.00005
ERR6913180	Halomonas sp. YLGW01	2773308	S	8	2	10	0.00001
ERR6913180	Halomonas sp. KO116	1504981	S	5	8	13	0.00002
ERR6913180	Halomonas elongata	2746	S	9	3	12	0.00002
ERR6913180	Halomonas sulfidivorans	2733488	S	7	9	16	0.00002
ERR6913180	Cobetia sp. cqz5-12	2609415	S	5	1	6	0.00001
ERR6913180	Cobetia sp. L2A1	2686360	S	5	0	5	0.00001
ERR6913180	Cobetia pacifica	1055101	S	5	4	9	0.00001
ERR6913180	Kushneria konosiri	698828	S	5	0	5	0.00001
ERR6913180	Chromohalobacter salexigens	158080	S	6	0	6	0.00001
ERR6913180	Marinomonas mediterranea	119864	S	6	13	19	0.00003
ERR6913180	Marinobacterium aestuarii	1821621	S	16	0	16	0.00002
ERR6913180	Thalassolituus oleivorans	187493	S	6	0	6	0.00001
ERR6913180	Neptunomonas japonica	417574	S	5	0	5	0.00001
ERR6913180	Nitrincola iocasae	2614693	S	5	0	5	0.00001
ERR6913180	Endozoicomonas sp. 4G	2872754	S	14	7	21	0.00003
ERR6913180	Endozoicomonas montiporae	1027273	S	7	0	7	0.00001
ERR6913180	Endozoicomonas euniceicola	1234143	S	6	0	6	0.00001
ERR6913180	Alloalcanivorax dieselolei	285091	S	6	3	9	0.00001
ERR6913180	Acinetobacter sp. CS-2	2798861	S	8	5	13	0.00002
ERR6913180	Acinetobacter sp. MYb10	1827285	S	6	25	31	0.00005
ERR6913180	Acinetobacter indicus	756892	S	5	2	7	0.00001
ERR6913180	Acinetobacter ursingii	108980	S	5	17	22	0.00003
ERR6913180	Psychrobacter sp. P11F6	1699621	S	6	7	13	0.00002
ERR6913180	Psychrobacter sanguinis	861445	S	7	4	11	0.00002
ERR6913180	Aeromonas sp. FDAARGOS 1415	2778064	S	7	3	10	0.00001
ERR6913180	Aeromonas veronii	654	S	14	33	47	0.00007
ERR6913180	Aeromonas salmonicida	645	S	10	5	15	0.00002
ERR6913180	Aeromonas simiae	218936	S	10	1	11	0.00002
ERR6913180	Succinivibrio dextrinosolvens	83771	S	9	0	9	0.00001
ERR6913180	Marinimicrobium sp. C6131	3022676	S	11	0	11	0.00002
ERR6913180	Marinagarivorans cellulosilyticus	2721545	S	10	0	10	0.00001
ERR6913180	Saccharophagus degradans	86304	S	9	0	9	0.00001
ERR6913180	Microbulbifer sp. YPW1	2745199	S	7	1	8	0.00001
ERR6913180	Microbulbifer celer	435905	S	11	1	12	0.00002
ERR6913180	Microbulbifer aggregans	1769779	S	6	0	6	0.00001
ERR6913180	Microbulbifer thermotolerans	252514	S	5	0	5	0.00001
ERR6913180	Aequoribacter fuscus	2518989	S	7	0	7	0.00001
ERR6913180	Thiomicrospira cyclica	147268	S	13	0	13	0.00002
ERR6913180	Thiomicrorhabdus sediminis	2580412	S	8	0	8	0.00001
ERR6913180	Cycloclasticus zancles	1329899	S	6	0	6	0.00001
ERR6913180	Allochromatium vinosum	1049	S	7	1	8	0.00001
ERR6913180	Thioflavicoccus mobilis	80679	S	9	0	9	0.00001
ERR6913180	Thiocapsa bogorovii	521689	S	6	0	6	0.00001
ERR6913180	Acidihalobacter ferrooxydans	1765967	S	7	0	7	0.00001
ERR6913180	Halorhodospira halochloris	1052	S	6	0	6	0.00001
ERR6913180	Cardiobacterium sp. Marseille-Q4385	2866573	S	39	2	41	0.00006
ERR6913180	Cardiobacterium hominis	2718	S	15	0	15	0.00002
ERR6913180	Methylomonas sp. LW13	107637	S	9	0	9	0.00001
ERR6913180	Methylomonas koyamae	702114	S	10	9	19	0.00003
ERR6913180	Methylobacter sp. S3L5C	2839024	S	5	0	5	0.00001
ERR6913180	Legionella cherrii	28084	S	5	4	9	0.00001
ERR6913180	Aquicella lusitana	254246	S	9	0	9	0.00001
ERR6913180	Gallaecimonas mangrovi	2291597	S	9	0	9	0.00001
ERR6913180	Thiolapillus brandeum	1076588	S	5	0	5	0.00001
ERR6913180	Gilliamella sp. ESL0405	2704653	S	5	0	5	0.00001
ERR6913180	Flagellatimonas centrodinii	2806210	S	5	0	5	0.00001
ERR6913180	Sulfurifustis variabilis	1675686	S	5	0	5	0.00001
ERR6913180	endosymbiont of Euscepes postfasciatus	650377	S	5	0	5	0.00001
ERR6913180	Neisseria mucosa	488	S	2434	428	2862	0.00419
ERR6913180	Neisseria sp. oral taxon 014	641148	S	1127	54	1181	0.00173
ERR6913180	Neisseria sp. KEM232	655307	S	19	0	19	0.00003
ERR6913180	Neisseria sicca	490	S	1138	182	1320	0.00193
ERR6913180	Neisseria subflava	28449	S	478	72	550	0.00080
ERR6913180	Neisseria flavescens	484	S	332	56	388	0.00057
ERR6913180	Neisseria meningitidis	487	S	218	148	366	0.00054
ERR6913180	Neisseria elongata	495	S	208	11	219	0.00032
ERR6913180	Neisseria macacae	496	S	177	41	218	0.00032
ERR6913180	Neisseria cinerea	483	S	166	17	183	0.00027
ERR6913180	Neisseria lactamica	486	S	141	62	203	0.00030
ERR6913180	Neisseria gonorrhoeae	485	S	57	11	68	0.00010
ERR6913180	Neisseria brasiliensis	2666100	S	17	1	18	0.00003
ERR6913180	Neisseria zoodegmatis	326523	S	15	2	17	0.00002
ERR6913180	Neisseria weaveri	28091	S	11	0	11	0.00002
ERR6913180	Neisseria chenwenguii	1853278	S	10	0	10	0.00001
ERR6913180	Neisseria dentiae	194197	S	9	0	9	0.00001
ERR6913180	Neisseria bacilliformis	267212	S	8	0	8	0.00001
ERR6913180	Neisseria animaloris	326522	S	7	0	7	0.00001
ERR6913180	Neisseria musculi	1815583	S	7	0	7	0.00001
ERR6913180	Neisseria zalophi	640030	S	6	0	6	0.00001
ERR6913180	Neisseria shayeganii	607712	S	5	0	5	0.00001
ERR6913180	Neisseria animalis	492	S	5	0	5	0.00001
ERR6913180	Eikenella corrodens	539	S	1379	71	1450	0.00212
ERR6913180	Eikenella exigua	2528037	S	189	10	199	0.00029
ERR6913180	Kingella denitrificans	502	S	43	1	44	0.00006
ERR6913180	Kingella oralis	505	S	23	0	23	0.00003
ERR6913180	Morococcus cerebrosus	1056807	S	19	4	23	0.00003
ERR6913180	Conchiformibius steedae	153493	S	16	0	16	0.00002
ERR6913180	Simonsiella muelleri	72	S	10	0	10	0.00001
ERR6913180	Paralysiella testudinis	2809020	S	8	0	8	0.00001
ERR6913180	Aquella oligotrophica	2067065	S	5	0	5	0.00001
ERR6913180	Iodobacter ciconiae	2496266	S	7	0	7	0.00001
ERR6913180	Paludibacterium paludis	1225769	S	7	0	7	0.00001
ERR6913180	Burkholderia multivorans	87883	S	25	14	39	0.00006
ERR6913180	Burkholderia territorii	1503055	S	8	8	16	0.00002
ERR6913180	Burkholderia cepacia	292	S	5	6	11	0.00002
ERR6913180	Burkholderia gladioli	28095	S	22	5	27	0.00004
ERR6913180	Burkholderia sp. Bp7605	1740163	S	6	2	8	0.00001
ERR6913180	Lautropia mirabilis	47671	S	75	8	83	0.00012
ERR6913180	Paraburkholderia acidiphila	2571747	S	23	5	28	0.00004
ERR6913180	Paraburkholderia edwinii	2861782	S	6	1	7	0.00001
ERR6913180	Paraburkholderia phytofirmans	261302	S	5	2	7	0.00001
ERR6913180	Polynucleobacter asymbioticus	576611	S	16	6	22	0.00003
ERR6913180	Polynucleobacter acidiphobus	556053	S	6	0	6	0.00001
ERR6913180	Cupriavidus taiwanensis	164546	S	20	14	34	0.00005
ERR6913180	Cupriavidus pauculus	82633	S	11	3	14	0.00002
ERR6913180	Cupriavidus metallidurans	119219	S	7	1	8	0.00001
ERR6913180	Ralstonia solanacearum	305	S	19	28	47	0.00007
ERR6913180	Caballeronia sp. Sq4a	2878152	S	6	1	7	0.00001
ERR6913180	Caballeronia insecticola	758793	S	8	1	9	0.00001
ERR6913180	Variovorax sp. WDL1	207745	S	9	5	14	0.00002
ERR6913180	Variovorax sp. RA8	662548	S	9	4	13	0.00002
ERR6913180	Variovorax sp. PBS-H4	434008	S	5	1	6	0.00001
ERR6913180	Variovorax paradoxus	34073	S	17	11	28	0.00004
ERR6913180	Comamonas aquatica	225991	S	7	4	11	0.00002
ERR6913180	Comamonas kerstersii	225992	S	7	2	9	0.00001
ERR6913180	Comamonas odontotermitis	379895	S	7	1	8	0.00001
ERR6913180	Comamonas piscis	1562974	S	7	5	12	0.00002
ERR6913180	Ottowia sp. oral taxon 894	1658672	S	36	4	40	0.00006
ERR6913180	Acidovorax antarcticus	2743470	S	5	5	10	0.00001
ERR6913180	Rhodoferax sp. BAB1	2741720	S	7	2	9	0.00001
ERR6913180	Rhodoferax sp. PAMC 29310	2822760	S	5	0	5	0.00001
ERR6913180	Rhodoferax sediminis	2509614	S	8	2	10	0.00001
ERR6913180	Diaphorobacter sp. HDW4A	2714924	S	10	10	20	0.00003
ERR6913180	Delftia acidovorans	80866	S	13	21	34	0.00005
ERR6913180	Serpentinimonas raichei	1458425	S	13	2	15	0.00002
ERR6913180	Ramlibacter tataouinensis	94132	S	8	2	10	0.00001
ERR6913180	Curvibacter sp. AEP1-3	1844971	S	6	0	6	0.00001
ERR6913180	Achromobacter xylosoxidans	85698	S	7	10	17	0.00002
ERR6913180	Achromobacter deleyi	1353891	S	7	6	13	0.00002
ERR6913180	Achromobacter insolitus	217204	S	5	2	7	0.00001
ERR6913180	Achromobacter mucicolens	1389922	S	5	14	19	0.00003
ERR6913180	Bordetella sp. H567	1697043	S	7	0	7	0.00001
ERR6913180	Bordetella flabilis	463014	S	6	0	6	0.00001
ERR6913180	Bordetella genomosp. 6	463024	S	5	4	9	0.00001
ERR6913180	Alcaligenes faecalis	511	S	11	9	20	0.00003
ERR6913180	Orrella marina	2163011	S	12	0	12	0.00002
ERR6913180	Orrella dioscoreae	1851544	S	7	1	8	0.00001
ERR6913180	Castellaniella defragrans	75697	S	15	3	18	0.00003
ERR6913180	Pigmentiphaga aceris	1940612	S	8	0	8	0.00001
ERR6913180	Massilia sp. H6	2970464	S	6	6	12	0.00002
ERR6913180	Massilia sp. DM-R-R2A-13	2899220	S	5	5	10	0.00001
ERR6913180	Janthinobacterium sp. 1_2014MBL_MicDiv	1644131	S	5	6	11	0.00002
ERR6913180	Collimonas arenae	279058	S	10	4	14	0.00002
ERR6913180	Oxalobacter aliiformigenes	2946593	S	5	0	5	0.00001
ERR6913180	Undibacterium sp. YM2	2058625	S	7	0	7	0.00001
ERR6913180	Roseateles sp. BIM B-1768	2978473	S	5	0	5	0.00001
ERR6913180	Tepidimonas taiwanensis	307486	S	6	2	8	0.00001
ERR6913180	Turicimonas muris	1796652	S	5	0	5	0.00001
ERR6913180	Candidatus Methylopumilus universalis	2588536	S	12	15	27	0.00004
ERR6913180	Methylotenera mobilis	359408	S	10	0	10	0.00001
ERR6913180	Nitrosomonas ureae	44577	S	5	0	5	0.00001
ERR6913180	Nitrosomonas stercoris	1444684	S	5	1	6	0.00001
ERR6913180	Sulfurimicrobium lacus	2715678	S	8	0	8	0.00001
ERR6913180	Sterolibacterium denitrificans	157592	S	6	0	6	0.00001
ERR6913180	Azoarcus sp. KH32C	748247	S	17	0	17	0.00002
ERR6913180	Azoarcus olearius	418699	S	6	1	7	0.00001
ERR6913180	Thauera humireducens	1134435	S	8	0	8	0.00001
ERR6913180	Azospira restricta	404405	S	7	2	9	0.00001
ERR6913180	Niveibacterium microcysteis	2811415	S	8	0	8	0.00001
ERR6913180	Aromatoleum petrolei	76116	S	6	0	6	0.00001
ERR6913180	Rhizobium sp. SL42	2806346	S	6	7	13	0.00002
ERR6913180	Rhizobium leguminosarum	384	S	8	21	29	0.00004
ERR6913180	Rhizobium daejeonense	240521	S	6	3	9	0.00001
ERR6913180	Rhizobium etli	29449	S	5	6	11	0.00002
ERR6913180	Agrobacterium larrymoorei	160699	S	16	2	18	0.00003
ERR6913180	Agrobacterium tumefaciens	358	S	13	5	18	0.00003
ERR6913180	Agrobacterium sp. CGMCC 11546	2579248	S	5	6	11	0.00002
ERR6913180	Agrobacterium vaccinii	2735528	S	6	0	6	0.00001
ERR6913180	Sinorhizobium americanum	194963	S	6	6	12	0.00002
ERR6913180	Sinorhizobium fredii	380	S	6	6	12	0.00002
ERR6913180	Ensifer mexicanus	375549	S	9	12	21	0.00003
ERR6913180	Shinella sp. XGS7	2877941	S	8	2	10	0.00001
ERR6913180	Shinella zoogloeoides	352475	S	7	10	17	0.00002
ERR6913180	Ciceribacter thiooxidans	1969821	S	12	4	16	0.00002
ERR6913180	Bradyrhizobium sp. 195	2782662	S	9	8	17	0.00002
ERR6913180	Bradyrhizobium sp. A19	2898149	S	9	3	12	0.00002
ERR6913180	Bradyrhizobium sp. 200	2782665	S	6	3	9	0.00001
ERR6913180	Bradyrhizobium sp. CCBAU 53340	1325112	S	6	6	12	0.00002
ERR6913180	Bradyrhizobium sp. BTAi1	288000	S	5	2	7	0.00001
ERR6913180	Bradyrhizobium diazoefficiens	1355477	S	13	35	48	0.00007
ERR6913180	Bradyrhizobium erythrophlei	1437360	S	12	2	14	0.00002
ERR6913180	Bradyrhizobium sediminis	2840469	S	7	2	9	0.00001
ERR6913180	Bradyrhizobium vignae	1549949	S	5	3	8	0.00001
ERR6913180	Rhodopseudomonas palustris	1076	S	9	3	12	0.00002
ERR6913180	Rhodopseudomonas boonkerdii	475937	S	8	2	10	0.00001
ERR6913180	Mesorhizobium sp. INR15	2654248	S	11	10	21	0.00003
ERR6913180	Mesorhizobium ciceri	39645	S	5	15	20	0.00003
ERR6913180	Mesorhizobium terrae	2725666	S	5	2	7	0.00001
ERR6913180	Phyllobacterium sp. T1018	555316	S	15	3	18	0.00003
ERR6913180	Phyllobacterium zundukense	1867719	S	6	1	7	0.00001
ERR6913180	Aminobacter sp. MSH1	374606	S	9	11	20	0.00003
ERR6913180	Methylobacterium indicum	1775910	S	21	19	40	0.00006
ERR6913180	Methylorubrum populi	223967	S	5	9	14	0.00002
ERR6913180	Brucella pseudintermedia	370111	S	7	17	24	0.00004
ERR6913180	Hyphomicrobium sp. DMF-1	3019544	S	9	1	10	0.00001
ERR6913180	Hyphomicrobium denitrificans	53399	S	8	1	9	0.00001
ERR6913180	Ancylobacter polymorphus	223390	S	8	4	12	0.00002
ERR6913180	Ancylobacter sp. SL191	2995166	S	5	2	7	0.00001
ERR6913180	Xanthobacter dioxanivorans	2528964	S	5	1	6	0.00001
ERR6913180	Roseibium aggregatum	187304	S	13	3	16	0.00002
ERR6913180	Devosia sp. I507	2083786	S	10	1	11	0.00002
ERR6913180	Devosia sp. SL43	2806348	S	5	0	5	0.00001
ERR6913180	Bosea sp. F3-2	2599640	S	6	9	15	0.00002
ERR6913180	Methylocystis heyeri	391905	S	8	1	9	0.00001
ERR6913180	Methylocystis sp. MJC1	2654282	S	8	1	9	0.00001
ERR6913180	Phreatobacter stygius	1940610	S	9	2	11	0.00002
ERR6913180	Sphingomonas sp. RMG20	2949093	S	7	2	9	0.00001
ERR6913180	Sphingomonas bisphenolicum	296544	S	25	18	43	0.00006
ERR6913180	Sphingomonas melonis	152682	S	10	6	16	0.00002
ERR6913180	Sphingomonas daechungensis	1176646	S	9	1	10	0.00001
ERR6913180	Sphingomonas morindae	1541170	S	8	1	9	0.00001
ERR6913180	Sphingomonas alpina	653931	S	7	1	8	0.00001
ERR6913180	Sphingomonas hankookensis	563996	S	6	3	9	0.00001
ERR6913180	Novosphingobium sp. PP1Y	702113	S	5	4	9	0.00001
ERR6913180	Sphingobium sp. TKS	1315974	S	6	11	17	0.00002
ERR6913180	Sphingopyxis sp. YF1	2482763	S	5	1	6	0.00001
ERR6913180	Sphingomicrobium aestuariivivum	1582356	S	6	1	7	0.00001
ERR6913180	Altererythrobacter sp. ZODW24	2185142	S	18	8	26	0.00004
ERR6913180	Erythrobacter mangrovi	2739433	S	15	9	24	0.00004
ERR6913180	Qipengyuania psychrotolerans	2867238	S	7	2	9	0.00001
ERR6913180	Zymomonas mobilis	542	S	22	1	23	0.00003
ERR6913180	Sphingosinicella microcystinivorans	335406	S	9	5	14	0.00002
ERR6913180	Roseivivax sp. THAF30	2587852	S	20	10	30	0.00004
ERR6913180	Roseivivax marinus	1379903	S	8	4	12	0.00002
ERR6913180	Sulfitobacter sp. S190	2867022	S	7	1	8	0.00001
ERR6913180	Jannaschia sp. CCS1	290400	S	12	1	13	0.00002
ERR6913180	Jannaschia sp. W003	2867012	S	8	2	10	0.00001
ERR6913180	Phaeobacter inhibens	221822	S	11	9	20	0.00003
ERR6913180	Roseobacter ponti	1891787	S	9	0	9	0.00001
ERR6913180	Roseobacter litoralis	42443	S	7	1	8	0.00001
ERR6913180	Celeribacter marinus	1397108	S	9	0	9	0.00001
ERR6913180	Celeribacter baekdonensis	875171	S	6	3	9	0.00001
ERR6913180	Roseovarius sp. THAF9	2587847	S	6	4	10	0.00001
ERR6913180	Mameliella alba	561184	S	12	7	19	0.00003
ERR6913180	Ruegeria pomeroyi	89184	S	7	3	10	0.00001
ERR6913180	Cognatishimia activa	1715691	S	10	1	11	0.00002
ERR6913180	Cereibacter sphaeroides	1063	S	9	8	17	0.00002
ERR6913180	Pseudooceanicola atlanticus	1461694	S	7	4	11	0.00002
ERR6913180	Neotabrizicola shimadae	2807096	S	5	2	7	0.00001
ERR6913180	Fuscovulum blasticum	1075	S	5	3	8	0.00001
ERR6913180	Roseomonas sp. S08	1750527	S	21	3	24	0.00004
ERR6913180	Oecophyllibacter saccharovorans	2558360	S	5	0	5	0.00001
ERR6913180	Asaia bogorensis	91915	S	5	0	5	0.00001
ERR6913180	Azospirillum humicireducens	1226968	S	11	8	19	0.00003
ERR6913180	Azospirillum brasilense	192	S	5	7	12	0.00002
ERR6913180	Nitrospirillum amazonense	28077	S	7	1	8	0.00001
ERR6913180	Magnetospirillum gryphiswaldense	55518	S	7	6	13	0.00002
ERR6913180	Haematospirillum jordaniae	1549855	S	11	0	11	0.00002
ERR6913180	Tistrella mobilis	171437	S	9	2	11	0.00002
ERR6913180	Brevundimonas sp. AJA228-03	2752515	S	14	5	19	0.00003
ERR6913180	Brevundimonas nasdae	172043	S	16	7	23	0.00003
ERR6913180	Brevundimonas diminuta	293	S	7	10	17	0.00002
ERR6913180	Caulobacter sp. S6	2823693	S	12	2	14	0.00002
ERR6913180	Caulobacter segnis	88688	S	5	2	7	0.00001
ERR6913180	Phenylobacterium zucineum	284016	S	9	3	12	0.00002
ERR6913180	Asticcacaulis sp. AND118	2840468	S	7	1	8	0.00001
ERR6913180	Ehrlichia sp. HF	391036	S	6	0	6	0.00001
ERR6913180	Rickettsia endosymbiont of Ceutorhynchus assimilis	2884482	S	6	0	6	0.00001
ERR6913180	Hyphomonas sp. Mor2	1906738	S	6	0	6	0.00001
ERR6913180	Hyphomonas neptunium	81032	S	8	0	8	0.00001
ERR6913180	Hyphomonas atlantica	1280948	S	6	1	7	0.00001
ERR6913180	Luteithermobacter gelatinilyticus	2582913	S	6	0	6	0.00001
ERR6913180	Parvularcula bermudensis	208216	S	6	1	7	0.00001
ERR6913180	Kordiimonas sp. SCSIO 12603	2829596	S	5	0	5	0.00001
ERR6913180	Hydrogenophilus thermoluteolus	297	S	9	0	9	0.00001
ERR6913180	Fusobacterium pseudoperiodonticum	2663009	S	6288	1193	7481	0.01094
ERR6913180	Fusobacterium nucleatum	851	S	1673	402	2075	0.00304
ERR6913180	Fusobacterium periodonticum	860	S	506	364	870	0.00127
ERR6913180	Fusobacterium hwasookii	1583098	S	138	77	215	0.00031
ERR6913180	Fusobacterium canifelinum	285729	S	34	8	42	0.00006
ERR6913180	Fusobacterium necrophorum	859	S	21	0	21	0.00003
ERR6913180	Fusobacterium hominis	2764326	S	19	0	19	0.00003
ERR6913180	Fusobacterium gastrosuis	1755100	S	18	0	18	0.00003
ERR6913180	Fusobacterium sp. oral taxon 203	671211	S	18	7	25	0.00004
ERR6913180	Fusobacterium ulcerans	861	S	11	0	11	0.00002
ERR6913180	Fusobacterium gonidiaformans	849	S	10	0	10	0.00001
ERR6913180	Fusobacterium varium	856	S	7	0	7	0.00001
ERR6913180	Fusobacterium mortiferum	850	S	5	0	5	0.00001
ERR6913180	Cetobacterium somerae	188913	S	5	0	5	0.00001
ERR6913180	Leptotrichia wadei	157687	S	2609	273	2882	0.00422
ERR6913180	Leptotrichia sp. oral taxon 212	712357	S	1414	26	1440	0.00211
ERR6913180	Leptotrichia sp. oral taxon 221	712362	S	154	14	168	0.00025
ERR6913180	Leptotrichia sp. oral taxon 218	712361	S	111	29	140	0.00020
ERR6913180	Leptotrichia sp. oral taxon 847	1785996	S	49	7	56	0.00008
ERR6913180	Leptotrichia sp. oral taxon 498	712368	S	43	12	55	0.00008
ERR6913180	Leptotrichia trevisanii	109328	S	290	20	310	0.00045
ERR6913180	Leptotrichia shahii	157691	S	91	11	102	0.00015
ERR6913180	Leptotrichia hofstadii	157688	S	72	8	80	0.00012
ERR6913180	Leptotrichia buccalis	40542	S	71	6	77	0.00011
ERR6913180	Leptotrichia hongkongensis	554406	S	38	4	42	0.00006
ERR6913180	Pseudoleptotrichia goodfellowii	157692	S	67	0	67	0.00010
ERR6913180	Streptobacillus moniliformis	34105	S	25	0	25	0.00004
ERR6913180	Candidatus Nanosynbacter sp. HMT-352	2899133	S	13724	504	14228	0.02081
ERR6913180	Candidatus Nanosynbacter featherlites	2572088	S	323	4	327	0.00048
ERR6913180	Candidatus Nanosynbacter lyticus	2093824	S	210	10	220	0.00032
ERR6913180	Candidatus Saccharimonas aalborgensis	1332188	S	39	0	39	0.00006
ERR6913180	Candidatus Minimicrobia vallesae	2841264	S	1006	136	1142	0.00167
ERR6913180	Candidatus Mycosynbacter amalyticus	2665156	S	26	1	27	0.00004
ERR6913180	Candidatus Absconditicoccus praedator	2735562	S	16	0	16	0.00002
ERR6913180	Campylobacter concisus	199	S	4321	44	4365	0.00638
ERR6913180	Campylobacter showae	204	S	345	15	360	0.00053
ERR6913180	Campylobacter sp. RM6914	1032243	S	18	0	18	0.00003
ERR6913180	Campylobacter sp. RM12651	1660079	S	8	0	8	0.00001
ERR6913180	Campylobacter sp. RM12175	1660076	S	6	0	6	0.00001
ERR6913180	Campylobacter sp. RM16187	1660063	S	5	0	5	0.00001
ERR6913180	Campylobacter sp. RM6137	1660073	S	5	0	5	0.00001
ERR6913180	Campylobacter sp. CCUG 57310	2517362	S	5	0	5	0.00001
ERR6913180	Campylobacter rectus	203	S	41	2	43	0.00006
ERR6913180	Campylobacter gracilis	824	S	28	0	28	0.00004
ERR6913180	Campylobacter curvus	200	S	8	0	8	0.00001
ERR6913180	Campylobacter iguaniorum	1244531	S	6	0	6	0.00001
ERR6913180	Aliarcobacter butzleri	28197	S	11	3	14	0.00002
ERR6913180	Aliarcobacter cryaerophilus	28198	S	8	1	9	0.00001
ERR6913180	Helicobacter pylori	210	S	6	1	7	0.00001
ERR6913180	Helicobacter pullorum	35818	S	5	0	5	0.00001
ERR6913180	Sulfurimonas sp. H1576	2672570	S	5	1	6	0.00001
ERR6913180	Sulfuricurvum kujiense	148813	S	5	0	5	0.00001
ERR6913180	Sulfurovum lithotrophicum	206403	S	5	0	5	0.00001
ERR6913180	Hydrogenimonas urashimensis	2740515	S	5	0	5	0.00001
ERR6913180	Treponema denticola	158	S	443	154	597	0.00087
ERR6913180	Treponema sp. OMZ 906	2563662	S	105	82	187	0.00027
ERR6913180	Treponema sp. OMZ 305	1659192	S	20	10	30	0.00004
ERR6913180	Treponema sp. OMZ 857	1643513	S	18	10	28	0.00004
ERR6913180	Treponema sp. OMZ 803	120682	S	17	13	30	0.00004
ERR6913180	Treponema sp. OMZ 838	1539298	S	8	9	17	0.00002
ERR6913180	Treponema sp. OMZ 855	1643512	S	8	9	17	0.00002
ERR6913180	Treponema sp. Marseille-Q4132	2766701	S	6	0	6	0.00001
ERR6913180	Treponema socranskii	53419	S	80	2	82	0.00012
ERR6913180	Treponema vincentii	69710	S	55	6	61	0.00009
ERR6913180	Treponema medium	58231	S	38	3	41	0.00006
ERR6913180	Treponema pedis	409322	S	37	0	37	0.00005
ERR6913180	Treponema brennaborense	81028	S	11	0	11	0.00002
ERR6913180	Treponema putidum	221027	S	8	0	8	0.00001
ERR6913180	Treponema peruense	2787628	S	7	0	7	0.00001
ERR6913180	Treponema parvum	138851	S	6	0	6	0.00001
ERR6913180	Treponema succinifaciens	167	S	5	0	5	0.00001
ERR6913180	Brucepastera parasyntrophica	2880008	S	12	0	12	0.00002
ERR6913180	Thiospirochaeta perfilievii	252967	S	7	0	7	0.00001
ERR6913180	Sediminispirochaeta smaragdinae	55206	S	5	0	5	0.00001
ERR6913180	Entomospira culicis	2719989	S	5	0	5	0.00001
ERR6913180	Sphaerochaeta coccoides	273376	S	11	0	11	0.00002
ERR6913180	Sphaerochaeta globosa	1131703	S	5	0	5	0.00001
ERR6913180	Leptospira kmetyi	408139	S	8	5	13	0.00002
ERR6913180	Brachyspira pilosicoli	52584	S	9	-9	0	0.00000
ERR6913180	Thermospira aquatica	2828656	S	5	0	5	0.00001
ERR6913180	Rhodopirellula sp. P2	2127060	S	7	1	8	0.00001
ERR6913180	Stieleria maiorica	2795974	S	7	0	7	0.00001
ERR6913180	Aureliella helgolandensis	2527968	S	9	0	9	0.00001
ERR6913180	Roseimaritima ulvae	980254	S	5	0	5	0.00001
ERR6913180	Lacipirellula parvula	2650471	S	10	0	10	0.00001
ERR6913180	Adhaeretor mobilis	1930276	S	7	0	7	0.00001
ERR6913180	Gimesia aquarii	2527964	S	9	0	9	0.00001
ERR6913180	Gimesia algae	2527971	S	7	1	8	0.00001
ERR6913180	Gimesia alba	2527973	S	6	0	6	0.00001
ERR6913180	Caulifigura coniformis	2527983	S	8	1	9	0.00001
ERR6913180	Calycomorphotria hydatis	2528027	S	7	0	7	0.00001
ERR6913180	Gemmata obscuriglobus	114	S	10	4	14	0.00002
ERR6913180	Singulisphaera acidiphila	466153	S	10	0	10	0.00001
ERR6913180	Aquisphaera giovannonii	406548	S	5	0	5	0.00001
ERR6913180	Mucisphaera calidilacus	2527982	S	6	1	7	0.00001
ERR6913180	Candidatus Uabimicrobium amorphum	2596890	S	11	0	11	0.00002
ERR6913180	Sulfuriroseicoccus oceanibius	2707525	S	29	0	29	0.00004
ERR6913180	Luteolibacter ambystomatis	2824561	S	16	0	16	0.00002
ERR6913180	Luteolibacter sp. SL250	2995170	S	6	0	6	0.00001
ERR6913180	Verrucomicrobium spinosum	2736	S	8	0	8	0.00001
ERR6913180	Verrucomicrobium sp. GAS474	1882831	S	8	0	8	0.00001
ERR6913180	Roseimicrobium sp. ORNL1	2711231	S	11	0	11	0.00002
ERR6913180	Akkermansia muciniphila	239935	S	39	14	53	0.00008
ERR6913180	Ereboglobus luteus	1796921	S	18	0	18	0.00003
ERR6913180	Opitutus terrae	107709	S	5	0	5	0.00001
ERR6913180	Lacunisphaera limnophila	1838286	S	5	0	5	0.00001
ERR6913180	Ruficoccus sp. ZRK36	2866311	S	12	0	12	0.00002
ERR6913180	Candidatus Xiphinematobacter sp. Idaho Grape	1704307	S	5	0	5	0.00001
ERR6913180	Chlamydiifrater phoenicopteri	2681469	S	5	0	5	0.00001
ERR6913180	Candidatus Velamenicoccus archaeovorus	1930593	S	7	0	7	0.00001
ERR6913180	Geobacter sp. DSM 9736	1277350	S	16	1	17	0.00002
ERR6913180	Geobacter sp. FeAm09	2597769	S	6	0	6	0.00001
ERR6913180	Geobacter pickeringii	345632	S	12	2	14	0.00002
ERR6913180	Geobacter metallireducens	28232	S	11	1	12	0.00002
ERR6913180	Geobacter sulfurreducens	35554	S	6	0	6	0.00001
ERR6913180	Geotalea daltonii	1203471	S	23	1	24	0.00004
ERR6913180	Geotalea uraniireducens	351604	S	9	1	10	0.00001
ERR6913180	Geomonas sp. RF6	2897342	S	6	0	6	0.00001
ERR6913180	Geomonas oryzisoli	2847992	S	5	6	11	0.00002
ERR6913180	Trichlorobacter lovleyi	313985	S	5	1	6	0.00001
ERR6913180	Syntrophotalea acetylenivorans	1842532	S	8	0	8	0.00001
ERR6913180	Pseudodesulfovibrio mercurii	641491	S	11	2	13	0.00002
ERR6913180	Pseudodesulfovibrio piezophilus	879567	S	6	0	6	0.00001
ERR6913180	Pseudodesulfovibrio indicus	1716143	S	6	1	7	0.00001
ERR6913180	Desulfovibrio sp. G11	631220	S	6	1	7	0.00001
ERR6913180	Desulfovibrio piger	901	S	5	0	5	0.00001
ERR6913180	Maridesulfovibrio salexigens	880	S	24	1	25	0.00004
ERR6913180	Solidesulfovibrio magneticus	184917	S	8	1	9	0.00001
ERR6913180	Solidesulfovibrio carbinoliphilus	345370	S	7	1	8	0.00001
ERR6913180	Desulfocurvibacter africanus	873	S	6	0	6	0.00001
ERR6913180	Salidesulfovibrio onnuriiensis	2583823	S	6	2	8	0.00001
ERR6913180	Desulfomicrobium sp. ZS1	2952228	S	8	0	8	0.00001
ERR6913180	Desulfosarcina alkanivorans	571177	S	22	3	25	0.00004
ERR6913180	Desulfosarcina sp. BuS5	933262	S	15	0	15	0.00002
ERR6913180	Desulfosarcina widdelii	947919	S	11	0	11	0.00002
ERR6913180	Desulfosarcina ovata	83564	S	8	0	8	0.00001
ERR6913180	Desulfobacter hydrogenophilus	2291	S	6	2	8	0.00001
ERR6913180	Desulforapulum autotrophicum	2296	S	8	0	8	0.00001
ERR6913180	Desulfococcus multivorans	897	S	13	1	14	0.00002
ERR6913180	Desulfoluna sp. ASN36	2810562	S	5	0	5	0.00001
ERR6913180	Desulfobulbus oligotrophicus	1909699	S	6	0	6	0.00001
ERR6913180	Desulfotalea psychrophila	84980	S	6	0	6	0.00001
ERR6913180	Syntrophobacter fumaroxidans	119484	S	11	0	11	0.00002
ERR6913180	Desulfarculus baarsii	453230	S	5	0	5	0.00001
ERR6913180	Myxococcus sp. SCHIC003	2813577	S	7	21	28	0.00004
ERR6913180	Corallococcus sp. EGB	1521117	S	13	11	24	0.00004
ERR6913180	Archangium violaceum	83451	S	22	4	26	0.00004
ERR6913180	Cystobacter fuscus	43	S	12	3	15	0.00002
ERR6913180	Stigmatella aurantiaca	41	S	11	2	13	0.00002
ERR6913180	Anaeromyxobacter oryzae	2918170	S	7	6	13	0.00002
ERR6913180	Polyangium aurulentum	2567896	S	13	0	13	0.00002
ERR6913180	Sandaracinus amylolyticus	927083	S	10	0	10	0.00001
ERR6913180	Haliangium ochraceum	80816	S	10	0	10	0.00001
ERR6913180	Nannocystis sp. fl3	2995304	S	6	0	6	0.00001
ERR6913180	Granulicella sp. 5B5	1617967	S	19	5	24	0.00004
ERR6913180	Granulicella sp. WH15	2602070	S	6	2	8	0.00001
ERR6913180	Edaphobacter sp. 12200R-103	2703788	S	12	0	12	0.00002
ERR6913180	Edaphobacter sp. 4G125	2763071	S	9	0	9	0.00001
ERR6913180	Terriglobus albidus	1592106	S	13	0	13	0.00002
ERR6913180	Terriglobus roseus	392734	S	5	0	5	0.00001
ERR6913180	Chloracidobacterium aggregatum	2851959	S	29	3	32	0.00005
ERR6913180	Luteitalea pratensis	1855912	S	8	2	10	0.00001
ERR6913180	Sulfidibacter corallicola	2818388	S	6	0	6	0.00001
ERR6913180	Mesotoga infera	1236046	S	9	0	9	0.00001
ERR6913180	Oceanotoga sp. DSM 15011	2984951	S	8	0	8	0.00001
ERR6913180	Bdellovibrio sp. NC01	2220073	S	7	0	7	0.00001
ERR6913180	Bdellovibrio bacteriovorus	959	S	9	1	10	0.00001
ERR6913180	Micavibrio aeruginosavorus	349221	S	6	0	6	0.00001
ERR6913180	Fluviispira sanaruensis	2493639	S	5	0	5	0.00001
ERR6913180	Pyramidobacter piscolens	638849	S	7	0	7	0.00001
ERR6913180	Thermosulfidibacter takaii	412593	S	5	0	5	0.00001
ERR6913180	Thermovibrio ammonificans	228745	S	6	0	6	0.00001
ERR6913180	Persicimonas caeni	2292766	S	7	0	7	0.00001
ERR6913180	Microvenator marinus	2600177	S	5	0	5	0.00001
ERR6913180	Thermodesulfovibrio yellowstonii	28262	S	6	0	6	0.00001
ERR6913180	Homo sapiens	9606	S	624	1	625	0.00091
ERR6913180	Fusarium poae	36050	S	8	9	17	0.00002
ERR6913180	Purpureocillium takamizusanense	2060973	S	8	1	9	0.00001
ERR6913180	Drechmeria coniospora	98403	S	5	0	5	0.00001
ERR6913180	Pochonia chlamydosporia	280754	S	10	0	10	0.00001
ERR6913180	Colletotrichum lupini	145971	S	7	1	8	0.00001
ERR6913180	Pyricularia grisea	148305	S	12	2	14	0.00002
ERR6913180	Pyricularia pennisetigena	1578925	S	5	0	5	0.00001
ERR6913180	Fulvia fulva	5499	S	7	0	7	0.00001
ERR6913180	Naumovozyma castellii	27288	S	6	0	6	0.00001
ERR6913180	Psilocybe cubensis	181762	S	8	0	8	0.00001
ERR6913180	Cryptococcus neoformans	5207	S	6	-4	2	0.00000
ERR6913180	Puccinia striiformis	27350	S	7	0	7	0.00001
ERR6913180	Plasmodium yoelii	5861	S	6	2	8	0.00001
ERR6913180	Plasmodium cynomolgi	5827	S	5	0	5	0.00001
ERR6913180	Plasmodium coatneyi	208452	S	9	0	9	0.00001
ERR6913180	Theileria orientalis	68886	S	7	0	7	0.00001
ERR6913180	Besnoitia besnoiti	94643	S	6	0	6	0.00001
ERR6913180	Trypanosoma brucei	5691	S	8	0	8	0.00001
ERR6913180	Trichomonas vaginalis	5722	S	9	0	9	0.00001
ERR6913180	Dictyostelium discoideum	44689	S	8	2	10	0.00001
ERR6913180	Halapricum salinum	1457250	S	8	2	10	0.00001
ERR6913180	Halapricum desulfuricans	2841257	S	7	1	8	0.00001
ERR6913180	Halosegnis sp. ZY10	2962671	S	10	15	25	0.00004
ERR6913180	Halorientalis litorea	2931977	S	5	4	9	0.00001
ERR6913180	Halanaeroarchaeum sp. HSR-CO	2866382	S	6	0	6	0.00001
ERR6913180	Haloferax volcanii	2246	S	6	3	9	0.00001
ERR6913180	Haloplanus rubicundus	1547898	S	8	1	9	0.00001
ERR6913180	Halorubrum sp. CBA1229	1853699	S	5	2	7	0.00001
ERR6913180	Natronococcus occultus	29288	S	7	2	9	0.00001
ERR6913180	Methanofollis aquaemaris	126734	S	6	0	6	0.00001
ERR6913180	Streptococcus phage YMC-2011	1051631	S	51	1	52	0.00008
ERR6913180	Streptococcus phage PH10	644007	S	15	0	15	0.00002
ERR6913180	Streptococcus phage SpSL1	1566990	S	9	0	9	0.00001
ERR6913180	Streptococcus phage 5093	646413	S	7	1	8	0.00001
ERR6913180	Streptococcus phage phiARI0131-2	1701814	S	5	3	8	0.00001
ERR6913180	Streptococcus phage vB_SthS_VA214	2069608	S	5	25	30	0.00004
ERR6913180	Streptococcus phage TP-778L	1385385	S	13	14	27	0.00004
ERR6913180	Brussowvirus bvO1205	85154	S	7	3	10	0.00001
ERR6913181	Streptococcus salivarius	1304	S	393069	68362	461431	0.47683
ERR6913181	Streptococcus sp. HSISM1	1316408	S	27327	4549	31876	0.03294
ERR6913181	Streptococcus sp. LPB0220	2610896	S	27188	4703	31891	0.03296
ERR6913181	Streptococcus sp. FDAARGOS_192	1839799	S	7037	3367	10404	0.01075
ERR6913181	Streptococcus sp. HSISS2	1316411	S	2785	1858	4643	0.00480
ERR6913181	Streptococcus sp. A12	1759399	S	2036	189	2225	0.00230
ERR6913181	Streptococcus sp. HSISS3	1316412	S	1360	854	2214	0.00229
ERR6913181	Streptococcus sp. HSISS1	1316410	S	760	5943	6703	0.00693
ERR6913181	Streptococcus sp. oral taxon 431	712633	S	714	38	752	0.00078
ERR6913181	Streptococcus sp. oral taxon 061	712623	S	672	82	754	0.00078
ERR6913181	Streptococcus sp. Marseille-Q6470	2972784	S	476	53	529	0.00055
ERR6913181	Streptococcus sp. Marseille-Q3533	2759692	S	351	25	376	0.00039
ERR6913181	Streptococcus sp. 116-D4	2598453	S	333	27	360	0.00037
ERR6913181	Streptococcus sp. NPS 308	1902136	S	235	30	265	0.00027
ERR6913181	Streptococcus sp. 1643	2576376	S	143	44	187	0.00019
ERR6913181	Streptococcus sp. NSJ-72	2763068	S	87	66	153	0.00016
ERR6913181	Streptococcus sp. oral taxon 064	712624	S	55	34	89	0.00009
ERR6913181	Streptococcus sp. KS 6	2598457	S	23	5	28	0.00003
ERR6913181	Streptococcus sp. zg-86	2664091	S	14	0	14	0.00001
ERR6913181	Streptococcus sp. CNU 77-61	2684658	S	8	6	14	0.00001
ERR6913181	Streptococcus parasanguinis	1318	S	37496	3252	40748	0.04211
ERR6913181	Streptococcus oralis	1303	S	10651	1169	11820	0.01221
ERR6913181	Streptococcus thermophilus	1308	S	7177	4736	11913	0.01231
ERR6913181	Streptococcus gordonii	1302	S	6931	273	7204	0.00744
ERR6913181	Streptococcus lactarius	684066	S	4359	98	4457	0.00461
ERR6913181	Streptococcus mitis	28037	S	3872	406	4278	0.00442
ERR6913181	Streptococcus vestibularis	1343	S	3305	282	3587	0.00371
ERR6913181	Streptococcus cristatus	45634	S	2990	66	3056	0.00316
ERR6913181	Streptococcus sanguinis	1305	S	1917	40	1957	0.00202
ERR6913181	Streptococcus australis	113107	S	1505	320	1825	0.00189
ERR6913181	Streptococcus pneumoniae	1313	S	1282	572	1854	0.00192
ERR6913181	Streptococcus ilei	1156431	S	902	206	1108	0.00114
ERR6913181	Streptococcus anginosus	1328	S	318	111	429	0.00044
ERR6913181	Streptococcus constellatus	76860	S	222	103	325	0.00034
ERR6913181	Streptococcus intermedius	1338	S	178	28	206	0.00021
ERR6913181	Streptococcus rubneri	1234680	S	545	90	635	0.00066
ERR6913181	Streptococcus koreensis	2382163	S	399	109	508	0.00052
ERR6913181	Streptococcus infantis	68892	S	379	17	396	0.00041
ERR6913181	Streptococcus equi	1336	S	340	2	342	0.00035
ERR6913181	Streptococcus dysgalactiae	1334	S	25	2	27	0.00003
ERR6913181	Streptococcus mutans	1309	S	356	40	396	0.00041
ERR6913181	Streptococcus suis	1307	S	343	39	382	0.00039
ERR6913181	Streptococcus gwangjuense	1433513	S	256	36	292	0.00030
ERR6913181	Streptococcus milleri	33040	S	243	136	379	0.00039
ERR6913181	Streptococcus toyakuensis	2819619	S	214	39	253	0.00026
ERR6913181	Streptococcus pseudopneumoniae	257758	S	201	28	229	0.00024
ERR6913181	Streptococcus equinus	1335	S	142	8	150	0.00016
ERR6913181	Streptococcus uberis	1349	S	136	1	137	0.00014
ERR6913181	Streptococcus pluranimalium	82348	S	133	1	134	0.00014
ERR6913181	Streptococcus canis	1329	S	132	2	134	0.00014
ERR6913181	Streptococcus pyogenes	1314	S	126	18	144	0.00015
ERR6913181	Streptococcus pseudoporcinus	361101	S	109	1	110	0.00011
ERR6913181	Streptococcus halotolerans	1814128	S	108	0	108	0.00011
ERR6913181	Streptococcus parasuis	1501662	S	90	16	106	0.00011
ERR6913181	Streptococcus sobrinus	1310	S	86	0	86	0.00009
ERR6913181	Streptococcus ferus	1345	S	80	0	80	0.00008
ERR6913181	Streptococcus pantholopis	1811193	S	73	0	73	0.00008
ERR6913181	Streptococcus agalactiae	1311	S	72	1920	1992	0.00206
ERR6913181	Streptococcus acidominimus	1326	S	69	1	70	0.00007
ERR6913181	Streptococcus porcinus	1340	S	66	0	66	0.00007
ERR6913181	Streptococcus oriscaviae	2781599	S	60	0	60	0.00006
ERR6913181	Streptococcus alactolyticus	29389	S	54	1	55	0.00006
ERR6913181	Streptococcus halichoeri	254785	S	51	0	51	0.00005
ERR6913181	Streptococcus himalayensis	1888195	S	51	0	51	0.00005
ERR6913181	Streptococcus gallolyticus	315405	S	47	13	60	0.00006
ERR6913181	Streptococcus urinalis	149016	S	38	0	38	0.00004
ERR6913181	Streptococcus iniae	1346	S	36	0	36	0.00004
ERR6913181	Streptococcus ratti	1341	S	30	0	30	0.00003
ERR6913181	Streptococcus infantarius	102684	S	28	6	34	0.00004
ERR6913181	Streptococcus merionis	400065	S	28	0	28	0.00003
ERR6913181	Streptococcus parauberis	1348	S	26	0	26	0.00003
ERR6913181	Streptococcus troglodytae	1111760	S	22	1	23	0.00002
ERR6913181	Streptococcus marmotae	1825069	S	20	0	20	0.00002
ERR6913181	Streptococcus respiraculi	2021971	S	18	0	18	0.00002
ERR6913181	Streptococcus periodonticum	2490633	S	17	5	22	0.00002
ERR6913181	Streptococcus lutetiensis	150055	S	17	2	19	0.00002
ERR6913181	Streptococcus ruminantium	1917441	S	12	3	15	0.00002
ERR6913181	Streptococcus pasteurianus	197614	S	9	8	17	0.00002
ERR6913181	Streptococcus macedonicus	59310	S	8	6	14	0.00001
ERR6913181	Streptococcus chenjunshii	2173853	S	7	0	7	0.00001
ERR6913181	Lactococcus lactis	1358	S	111	40	151	0.00016
ERR6913181	Lactococcus cremoris	1359	S	22	13	35	0.00004
ERR6913181	Lactobacillus iners	147802	S	43	0	43	0.00004
ERR6913181	Lactobacillus crispatus	47770	S	14	1	15	0.00002
ERR6913181	Lactobacillus paragasseri	2107999	S	11	26	37	0.00004
ERR6913181	Lactobacillus apis	303541	S	10	0	10	0.00001
ERR6913181	Lactobacillus taiwanensis	508451	S	6	0	6	0.00001
ERR6913181	Lactobacillus acidophilus	1579	S	5	0	5	0.00001
ERR6913181	Lactobacillus helveticus	1587	S	5	1	6	0.00001
ERR6913181	Ligilactobacillus salivarius	1624	S	40	35	75	0.00008
ERR6913181	Ligilactobacillus ruminis	1623	S	6	0	6	0.00001
ERR6913181	Limosilactobacillus fermentum	1613	S	19	2	21	0.00002
ERR6913181	Limosilactobacillus reuteri	1598	S	17	1	18	0.00002
ERR6913181	Lacticaseibacillus rhamnosus	47715	S	29	0	29	0.00003
ERR6913181	Lacticaseibacillus paracasei	1597	S	5	1	6	0.00001
ERR6913181	Lacticaseibacillus manihotivorans	88233	S	5	0	5	0.00001
ERR6913181	Pediococcus acidilactici	1254	S	10	0	10	0.00001
ERR6913181	Lentilactobacillus buchneri	1581	S	8	0	8	0.00001
ERR6913181	Weissella cibaria	137591	S	5	0	5	0.00001
ERR6913181	Weissella coleopterorum	2714949	S	5	0	5	0.00001
ERR6913181	Lactiplantibacillus plantarum	1590	S	10	2	12	0.00001
ERR6913181	Levilactobacillus brevis	1580	S	5	0	5	0.00001
ERR6913181	Loigolactobacillus backii	375175	S	5	1	6	0.00001
ERR6913181	Granulicatella adiacens	46124	S	336	0	336	0.00035
ERR6913181	Granulicatella elegans	137732	S	40	0	40	0.00004
ERR6913181	Dolosigranulum pigrum	29394	S	9	0	9	0.00001
ERR6913181	Abiotrophia defectiva	46125	S	212	0	212	0.00022
ERR6913181	Suicoccus acidiformans	2036206	S	7	0	7	0.00001
ERR6913181	Enterococcus faecium	1352	S	15	14	29	0.00003
ERR6913181	Enterococcus cecorum	44008	S	10	0	10	0.00001
ERR6913181	Enterococcus faecalis	1351	S	8	2	10	0.00001
ERR6913181	Enterococcus hirae	1354	S	5	0	5	0.00001
ERR6913181	Enterococcus thailandicus	417368	S	5	0	5	0.00001
ERR6913181	Vagococcus carniphilus	218144	S	6	0	6	0.00001
ERR6913181	Tetragenococcus koreensis	290335	S	8	0	8	0.00001
ERR6913181	Gemella haemolysans	1379	S	501	14	515	0.00053
ERR6913181	Gemella morbillorum	29391	S	188	7	195	0.00020
ERR6913181	Gemella sanguinis	84135	S	43	1	44	0.00005
ERR6913181	Exiguobacterium sp. N4-1P	2051906	S	12	1	13	0.00001
ERR6913181	Bacillus cereus	1396	S	9	3	12	0.00001
ERR6913181	Bacillus mycoides	1405	S	7	0	7	0.00001
ERR6913181	Bacillus anthracis	1392	S	5	79	84	0.00009
ERR6913181	Bacillus sp. Y1	352858	S	7	2	9	0.00001
ERR6913181	Bacillus pumilus	1408	S	7	0	7	0.00001
ERR6913181	Bacillus shivajii	1983719	S	5	0	5	0.00001
ERR6913181	Virgibacillus sp. Bac332	2419842	S	5	3	8	0.00001
ERR6913181	Niallia sp. RD1	2962858	S	8	0	8	0.00001
ERR6913181	Niallia circulans	1397	S	5	0	5	0.00001
ERR6913181	Anoxybacillus flavithermus	33934	S	11	3	14	0.00001
ERR6913181	Geobacillus stearothermophilus	1422	S	7	6	13	0.00001
ERR6913181	Oceanobacillus iheyensis	182710	S	5	0	5	0.00001
ERR6913181	Weizmannia coagulans	1398	S	5	0	5	0.00001
ERR6913181	Parageobacillus toebii	153151	S	5	1	6	0.00001
ERR6913181	Priestia megaterium	1404	S	5	5	10	0.00001
ERR6913181	Staphylococcus lugdunensis	28035	S	25	0	25	0.00003
ERR6913181	Staphylococcus capitis	29388	S	16	1	17	0.00002
ERR6913181	Staphylococcus epidermidis	1282	S	11	0	11	0.00001
ERR6913181	Staphylococcus auricularis	29379	S	8	0	8	0.00001
ERR6913181	Staphylococcus aureus	1280	S	7	30	37	0.00004
ERR6913181	Staphylococcus simulans	1286	S	6	0	6	0.00001
ERR6913181	Staphylococcus saprophyticus	29385	S	5	0	5	0.00001
ERR6913181	Staphylococcus arlettae	29378	S	5	0	5	0.00001
ERR6913181	Macrococcus armenti	2875764	S	7	5	12	0.00001
ERR6913181	Paenibacillus sp. JDR-2	324057	S	10	0	10	0.00001
ERR6913181	Paenibacillus sp. URB8-2	2741301	S	6	0	6	0.00001
ERR6913181	Paenibacillus xylanilyticus	248903	S	11	0	11	0.00001
ERR6913181	Paenibacillus polymyxa	1406	S	7	10	17	0.00002
ERR6913181	Paenibacillus uliginis	683737	S	5	2	7	0.00001
ERR6913181	Paenibacillus sophorae	1333845	S	5	0	5	0.00001
ERR6913181	Kurthia sp. 11kri321	1750719	S	9	0	9	0.00001
ERR6913181	Ureibacillus thermosphaericus	51173	S	5	1	6	0.00001
ERR6913181	Laceyella sacchari	37482	S	7	0	7	0.00001
ERR6913181	Veillonella atypica	39777	S	143364	2126	145490	0.15035
ERR6913181	Veillonella parvula	29466	S	9747	1019	10766	0.01113
ERR6913181	Veillonella nakazawae	2682456	S	6254	1402	7656	0.00791
ERR6913181	Veillonella rogosae	423477	S	6134	295	6429	0.00664
ERR6913181	Veillonella sp. S12025-13	2682455	S	4193	848	5041	0.00521
ERR6913181	Veillonella dispar	39778	S	2863	298	3161	0.00327
ERR6913181	Veillonella rodentium	248315	S	541	4	545	0.00056
ERR6913181	Megasphaera stantonii	2144175	S	119	12	131	0.00014
ERR6913181	Megasphaera hexanoica	1675036	S	73	18	91	0.00009
ERR6913181	Megasphaera elsdenii	907	S	65	30	95	0.00010
ERR6913181	Megasphaera massiliensis	1232428	S	64	10	74	0.00008
ERR6913181	Dialister pneumosintes	39950	S	82	3	85	0.00009
ERR6913181	Dialister succinatiphilus	487173	S	21	1	22	0.00002
ERR6913181	Selenomonas sputigena	69823	S	573	3	576	0.00060
ERR6913181	Selenomonas sp. oral taxon 126	712528	S	88	4	92	0.00010
ERR6913181	Selenomonas sp. oral taxon 920	1884263	S	80	3	83	0.00009
ERR6913181	Selenomonas sp. oral taxon 136	713030	S	51	14	65	0.00007
ERR6913181	Selenomonas sp. oral taxon 478	712538	S	47	15	62	0.00006
ERR6913181	Selenomonas timonae	2754044	S	45	3	48	0.00005
ERR6913181	Megamonas funiformis	437897	S	8	0	8	0.00001
ERR6913181	Pelosinus sp. UFO1	484770	S	5	0	5	0.00001
ERR6913181	Sporomusa termitida	2377	S	5	0	5	0.00001
ERR6913181	Phascolarctobacterium faecium	33025	S	12	0	12	0.00001
ERR6913181	Phascolarctobacterium sp. Marseille-Q4147	2823317	S	8	2	10	0.00001
ERR6913181	Acidaminococcus intestini	187327	S	6	1	7	0.00001
ERR6913181	Blautia argi	1912897	S	11	4	15	0.00002
ERR6913181	Blautia wexlerae	418240	S	7	7	14	0.00001
ERR6913181	Blautia obeum	40520	S	5	3	8	0.00001
ERR6913181	Lachnoanaerobaculum umeaense	617123	S	35	0	35	0.00004
ERR6913181	Butyrivibrio fibrisolvens	831	S	20	0	20	0.00002
ERR6913181	Butyrivibrio proteoclasticus	43305	S	5	0	5	0.00001
ERR6913181	Butyrivibrio crossotus	45851	S	5	2	7	0.00001
ERR6913181	Enterocloster asparagiformis	333367	S	7	0	7	0.00001
ERR6913181	Enterocloster bolteae	208479	S	5	2	7	0.00001
ERR6913181	[Ruminococcus] gnavus	33038	S	7	4	11	0.00001
ERR6913181	Lacrimispora sphenoides	29370	S	6	0	6	0.00001
ERR6913181	Anaerobutyricum hallii	39488	S	10	4	14	0.00001
ERR6913181	[Clostridium] scindens	29347	S	7	0	7	0.00001
ERR6913181	Pseudobutyrivibrio xylanivorans	185007	S	9	0	9	0.00001
ERR6913181	Novisyntrophococcus fermenticellae	2068655	S	5	0	5	0.00001
ERR6913181	Anaerotignum propionicum	28446	S	5	0	5	0.00001
ERR6913181	Marvinbryantia formatexigens	168384	S	5	0	5	0.00001
ERR6913181	Fastidiosipila sanguinis	236753	S	71	1	72	0.00007
ERR6913181	Faecalibacterium prausnitzii	853	S	12	20	32	0.00003
ERR6913181	Acutalibacter muris	1796620	S	33	2	35	0.00004
ERR6913181	Ruminococcus bicirculans	1160721	S	5	1	6	0.00001
ERR6913181	Ruminococcus bovis	2564099	S	5	0	5	0.00001
ERR6913181	Caproicibacterium amylolyticum	2766537	S	5	0	5	0.00001
ERR6913181	Mageeibacillus indolicus	884684	S	8	0	8	0.00001
ERR6913181	Ruminiclostridium herbifermentans	2488810	S	6	1	7	0.00001
ERR6913181	Anaerotruncus colihominis	169435	S	7	3	10	0.00001
ERR6913181	Clostridium sp. MD294	97138	S	26	0	26	0.00003
ERR6913181	Clostridium sp. M62/1	411486	S	9	5	14	0.00001
ERR6913181	Clostridium perfringens	1502	S	21	11	32	0.00003
ERR6913181	Clostridium botulinum	1491	S	15	2	17	0.00002
ERR6913181	Clostridium pasteurianum	1501	S	10	0	10	0.00001
ERR6913181	Clostridium butyricum	1492	S	8	4	12	0.00001
ERR6913181	Hungatella hathewayi	154046	S	9	1	10	0.00001
ERR6913181	Caloramator sp. Dgby_cultured_2	3029174	S	6	0	6	0.00001
ERR6913181	Mogibacterium pumilum	86332	S	75	2	77	0.00008
ERR6913181	Mogibacterium diversum	114527	S	37	1	38	0.00004
ERR6913181	Aminipila luticellarii	2507160	S	7	1	8	0.00001
ERR6913181	Filifactor alocis	143361	S	107	2	109	0.00011
ERR6913181	Clostridioides difficile	1496	S	10	7	17	0.00002
ERR6913181	Tepidibacter sp. 8C15b	2925782	S	8	0	8	0.00001
ERR6913181	Eubacterium ventriosum	39496	S	17	11	28	0.00003
ERR6913181	Desulfosporosinus meridiei	79209	S	5	0	5	0.00001
ERR6913181	Desulforamulus ferrireducens	1833852	S	5	2	7	0.00001
ERR6913181	Vallitalea guaymasensis	1185412	S	7	0	7	0.00001
ERR6913181	Tepidanaerobacter acetatoxydans	499229	S	5	0	5	0.00001
ERR6913181	Parvimonas micra	33033	S	187	1	188	0.00019
ERR6913181	Anaerococcus mediterraneensis	1870984	S	5	4	9	0.00001
ERR6913181	Finegoldia magna	1260	S	8	0	8	0.00001
ERR6913181	Ezakiella coagulans	46507	S	6	0	6	0.00001
ERR6913181	Bulleidia sp. zg-1006	2806552	S	72	0	72	0.00007
ERR6913181	Longicatena caecimuris	1796635	S	7	0	7	0.00001
ERR6913181	Amedibacterium intestinale	2583452	S	5	0	5	0.00001
ERR6913181	[Clostridium] innocuum	1522	S	9	0	9	0.00001
ERR6913181	Ndongobacter massiliensis	1871025	S	8	0	8	0.00001
ERR6913181	Lancefieldella parvula	1382	S	41344	189	41533	0.04292
ERR6913181	Olsenella uli	133926	S	349	6	355	0.00037
ERR6913181	Olsenella sp. oral taxon 807	712411	S	105	0	105	0.00011
ERR6913181	Olsenella timonensis	1805478	S	29	1	30	0.00003
ERR6913181	Parolsenella massiliensis	1871022	S	22	15	37	0.00004
ERR6913181	Parolsenella catena	2003188	S	16	13	29	0.00003
ERR6913181	Atopobium sp. oral taxon 416	712157	S	61	0	61	0.00006
ERR6913181	Leptogranulimonas caecicola	2894156	S	42	0	42	0.00004
ERR6913181	Thermophilibacter immobilis	2779519	S	30	0	30	0.00003
ERR6913181	Parafannyhessea umbonata	604330	S	30	1	31	0.00003
ERR6913181	Collinsella sp. zg1085	2844380	S	253	1	254	0.00026
ERR6913181	Collinsella aerofaciens	74426	S	102	7	109	0.00011
ERR6913181	Collinsella stercoris	147206	S	15	0	15	0.00002
ERR6913181	Cryptobacterium curtum	84163	S	2250	10	2260	0.00234
ERR6913181	Arabiibacter massiliensis	1870985	S	14	1	15	0.00002
ERR6913181	Gordonibacter pamelaeae	471189	S	10	1	11	0.00001
ERR6913181	Eggerthella lenta	84112	S	5	0	5	0.00001
ERR6913181	Bifidobacterium longum	216816	S	20753	3524	24277	0.02509
ERR6913181	Bifidobacterium breve	1685	S	1312	76	1388	0.00143
ERR6913181	Bifidobacterium dentium	1689	S	207	0	207	0.00021
ERR6913181	Bifidobacterium scardovii	158787	S	86	0	86	0.00009
ERR6913181	Bifidobacterium imperatoris	2020965	S	69	1	70	0.00007
ERR6913181	Bifidobacterium adolescentis	1680	S	27	1	28	0.00003
ERR6913181	Bifidobacterium saguini	762210	S	26	0	26	0.00003
ERR6913181	Bifidobacterium catenulatum	1686	S	25	1	26	0.00003
ERR6913181	Bifidobacterium eulemuris	1765219	S	25	0	25	0.00003
ERR6913181	Bifidobacterium bifidum	1681	S	24	5	29	0.00003
ERR6913181	Bifidobacterium lemurum	1603886	S	24	0	24	0.00002
ERR6913181	Bifidobacterium subtile	77635	S	13	0	13	0.00001
ERR6913181	Bifidobacterium asteroides	1684	S	13	0	13	0.00001
ERR6913181	Bifidobacterium pseudocatenulatum	28026	S	12	0	12	0.00001
ERR6913181	Bifidobacterium pseudolongum	1694	S	12	0	12	0.00001
ERR6913181	Bifidobacterium angulatum	1683	S	12	0	12	0.00001
ERR6913181	Bifidobacterium pullorum	78448	S	11	0	11	0.00001
ERR6913181	Bifidobacterium animalis	28025	S	10	3	13	0.00001
ERR6913181	Bifidobacterium choerinum	35760	S	8	0	8	0.00001
ERR6913181	Bifidobacterium actinocoloniiforme	638619	S	7	0	7	0.00001
ERR6913181	Gardnerella vaginalis	2702	S	46	11	57	0.00006
ERR6913181	Scardovia inopinata	78259	S	24	0	24	0.00002
ERR6913181	Parascardovia denticolens	78258	S	11	0	11	0.00001
ERR6913181	Rothia mucilaginosa	43675	S	3053	75	3128	0.00323
ERR6913181	Rothia dentocariosa	2047	S	686	23	709	0.00073
ERR6913181	Rothia aeria	172042	S	439	10	449	0.00046
ERR6913181	Rothia nasimurium	85336	S	10	0	10	0.00001
ERR6913181	Rothia amarae	169480	S	6	0	6	0.00001
ERR6913181	Arthrobacter sp. DNA4	2963432	S	6	8	14	0.00001
ERR6913181	Arthrobacter sp. zg-Y462	2886936	S	5	0	5	0.00001
ERR6913181	Arthrobacter sp. StoSoilB5	2830992	S	5	2	7	0.00001
ERR6913181	Arthrobacter sp. ERGS1:01	1704044	S	5	0	5	0.00001
ERR6913181	Arthrobacter alpinus	656366	S	14	4	18	0.00002
ERR6913181	Arthrobacter polaris	2813727	S	8	0	8	0.00001
ERR6913181	Arthrobacter woluwensis	156980	S	7	0	7	0.00001
ERR6913181	Kocuria rhizophila	72000	S	52	15	67	0.00007
ERR6913181	Kocuria palustris	71999	S	17	1	18	0.00002
ERR6913181	Glutamicibacter sp. M10	3023076	S	7	3	10	0.00001
ERR6913181	Glutamicibacter protophormiae	37930	S	6	2	8	0.00001
ERR6913181	Pseudarthrobacter sp. BIM B-2242	2772401	S	9	0	9	0.00001
ERR6913181	Pseudarthrobacter sulfonivorans	121292	S	5	4	9	0.00001
ERR6913181	Micrococcus luteus	1270	S	9	6	15	0.00002
ERR6913181	Auritidibacter sp. NML130574	2170745	S	5	0	5	0.00001
ERR6913181	Microbacterium sp. SSW1-51	2851650	S	6	7	13	0.00001
ERR6913181	Microbacterium sp. 10M-3C3	2483401	S	6	8	14	0.00001
ERR6913181	Microbacterium oxydans	82380	S	6	12	18	0.00002
ERR6913181	Microbacterium chocolatum	84292	S	6	3	9	0.00001
ERR6913181	Microbacterium cremeum	2782169	S	5	3	8	0.00001
ERR6913181	Microbacterium esteraromaticum	57043	S	5	3	8	0.00001
ERR6913181	Rathayibacter festucae	110937	S	5	8	13	0.00001
ERR6913181	Gulosibacter molinativorax	256821	S	5	2	7	0.00001
ERR6913181	Gulosibacter sediminis	1729695	S	5	3	8	0.00001
ERR6913181	Subtercola sp. PAMC28395	2846775	S	8	3	11	0.00001
ERR6913181	Mycetocola sp. JXN-3	2116510	S	5	1	6	0.00001
ERR6913181	Microterricola viridarii	412690	S	5	5	10	0.00001
ERR6913181	Glaciihabitans sp. INWT7	2596912	S	5	2	7	0.00001
ERR6913181	Devriesea agamarum	472569	S	10	0	10	0.00001
ERR6913181	Brevibacterium sp. CS2	2575923	S	15	7	22	0.00002
ERR6913181	Brevibacterium luteolum	199591	S	8	5	13	0.00001
ERR6913181	Cellulomonas gilvus	11	S	5	1	6	0.00001
ERR6913181	Cellulomonas palmilytica	2608402	S	5	1	6	0.00001
ERR6913181	Janibacter limosus	53458	S	6	0	6	0.00001
ERR6913181	Janibacter sp. CX7	2963431	S	5	1	6	0.00001
ERR6913181	Janibacter indicus	857417	S	5	6	11	0.00001
ERR6913181	Phycicoccus sp. HDW14	2714941	S	5	0	5	0.00001
ERR6913181	Ornithinimicrobium sp. HY006	2508882	S	5	1	6	0.00001
ERR6913181	Ornithinimicrobium pratense	2593973	S	7	0	7	0.00001
ERR6913181	Georgenia sp. TF02-10	2917725	S	6	3	9	0.00001
ERR6913181	Beutenbergia cavernae	84757	S	9	0	9	0.00001
ERR6913181	Dermacoccus nishinomiyaensis	1274	S	6	0	6	0.00001
ERR6913181	Jonesia denitrificans	43674	S	8	0	8	0.00001
ERR6913181	Demequina sp. TMPB413	2881056	S	8	0	8	0.00001
ERR6913181	Actinomyces pacaensis	1852377	S	956	23	979	0.00101
ERR6913181	Actinomyces sp. oral taxon 169	712116	S	67	51	118	0.00012
ERR6913181	Actinomyces sp. oral taxon 414	712122	S	60	2	62	0.00006
ERR6913181	Actinomyces sp. oral taxon 171	706438	S	41	11	52	0.00005
ERR6913181	Actinomyces sp. HMT 175	2789425	S	39	75	114	0.00012
ERR6913181	Actinomyces sp. Z16	2079536	S	38	4	42	0.00004
ERR6913181	Actinomyces sp. 432	2057798	S	27	2	29	0.00003
ERR6913181	Actinomyces sp. MAS-1	2755559	S	22	1	23	0.00002
ERR6913181	Actinomyces sp. HMT897	2789424	S	20	42	62	0.00006
ERR6913181	Actinomyces sp. Chiba101	1851395	S	18	2	20	0.00002
ERR6913181	Actinomyces sp. oral taxon 897	2081702	S	10	21	31	0.00003
ERR6913181	Actinomyces oris	544580	S	273	231	504	0.00052
ERR6913181	Actinomyces naeslundii	1655	S	109	16	125	0.00013
ERR6913181	Actinomyces trachealis	2763540	S	91	4	95	0.00010
ERR6913181	Actinomyces faecalis	2722820	S	77	2	79	0.00008
ERR6913181	Actinomyces respiraculi	2744574	S	36	2	38	0.00004
ERR6913181	Actinomyces slackii	52774	S	36	1	37	0.00004
ERR6913181	Actinomyces radicidentis	111015	S	30	1	31	0.00003
ERR6913181	Actinomyces wuliandei	2057743	S	26	2	28	0.00003
ERR6913181	Actinomyces qiguomingii	2057800	S	25	1	26	0.00003
ERR6913181	Actinomyces viscosus	1656	S	25	3	28	0.00003
ERR6913181	Actinomyces weissii	675090	S	24	1	25	0.00003
ERR6913181	Actinomyces lilanjuaniae	2321394	S	23	2	25	0.00003
ERR6913181	Actinomyces howellii	52771	S	23	0	23	0.00002
ERR6913181	Actinomyces procaprae	2560010	S	20	2	22	0.00002
ERR6913181	Actinomyces gaoshouyii	1960083	S	10	1	11	0.00001
ERR6913181	Actinomyces marmotae	2737173	S	8	1	9	0.00001
ERR6913181	Schaalia odontolytica	1660	S	1610	79	1689	0.00175
ERR6913181	Schaalia meyeri	52773	S	133	7	140	0.00014
ERR6913181	Schaalia turicensis	131111	S	47	2	49	0.00005
ERR6913181	Schaalia sp. 19OD2882	2794089	S	13	0	13	0.00001
ERR6913181	Schaalia sp. ZJ405	2709403	S	12	0	12	0.00001
ERR6913181	Schaalia radingae	131110	S	20	0	20	0.00002
ERR6913181	Schaalia cardiffensis	181487	S	5	0	5	0.00001
ERR6913181	Trueperella pyogenes	1661	S	57	1	58	0.00006
ERR6913181	Trueperella pecoris	2733571	S	20	0	20	0.00002
ERR6913181	Pauljensenia hongkongensis	178339	S	45	3	48	0.00005
ERR6913181	Arcanobacterium haemolyticum	28264	S	7	12	19	0.00002
ERR6913181	Boudabousia tangfeifanii	1912795	S	26	0	26	0.00003
ERR6913181	Fannyhessea vaginae	82135	S	22	0	22	0.00002
ERR6913181	Flaviflexus ciconiae	2496867	S	12	0	12	0.00001
ERR6913181	Flaviflexus equikiangi	2758573	S	8	0	8	0.00001
ERR6913181	Winkia neuii	33007	S	19	0	19	0.00002
ERR6913181	Varibaculum prostatecancerukia	2811781	S	17	0	17	0.00002
ERR6913181	Mobiluncus curtisii	2051	S	13	0	13	0.00001
ERR6913181	Actinotignum schaalii	59505	S	9	0	9	0.00001
ERR6913181	Changpingibacter yushuensis	2758440	S	8	0	8	0.00001
ERR6913181	Actinobaculum sp. 313	2495645	S	5	0	5	0.00001
ERR6913181	Corynebacterium matruchotii	43768	S	489	7	496	0.00051
ERR6913181	Corynebacterium tuberculostearicum	38304	S	46	5	51	0.00005
ERR6913181	Corynebacterium diphtheriae	1717	S	21	53	74	0.00008
ERR6913181	Corynebacterium kroppenstedtii	161879	S	19	0	19	0.00002
ERR6913181	Corynebacterium kefirresidentii	1979527	S	14	2	16	0.00002
ERR6913181	Corynebacterium vitaeruminis	38305	S	13	1	14	0.00001
ERR6913181	Corynebacterium atypicum	191610	S	11	0	11	0.00001
ERR6913181	Corynebacterium macginleyi	38290	S	8	0	8	0.00001
ERR6913181	Corynebacterium ihumii	1232427	S	7	0	7	0.00001
ERR6913181	Corynebacterium singulare	161899	S	7	0	7	0.00001
ERR6913181	Corynebacterium striatum	43770	S	7	1	8	0.00001
ERR6913181	Corynebacterium massiliense	441501	S	7	0	7	0.00001
ERR6913181	Corynebacterium hindlerae	699041	S	6	0	6	0.00001
ERR6913181	Corynebacterium jeikeium	38289	S	6	3	9	0.00001
ERR6913181	Corynebacterium pseudodiphtheriticum	37637	S	6	0	6	0.00001
ERR6913181	Corynebacterium crudilactis	1652495	S	6	0	6	0.00001
ERR6913181	Corynebacterium endometrii	2488819	S	5	0	5	0.00001
ERR6913181	Corynebacterium cystitidis	35757	S	5	0	5	0.00001
ERR6913181	Mycobacterium gordonae	1778	S	6	20	26	0.00003
ERR6913181	Rhodococcus qingshengii	334542	S	8	35	43	0.00004
ERR6913181	Cutibacterium acnes	1747	S	769	34	803	0.00083
ERR6913181	Cutibacterium avidum	33010	S	30	1	31	0.00003
ERR6913181	Cutibacterium modestum	2559073	S	8	0	8	0.00001
ERR6913181	Arachnia propionica	1750	S	83	1	84	0.00009
ERR6913181	Propionibacterium freudenreichii	1744	S	9	0	9	0.00001
ERR6913181	Propionibacterium acidifaciens	556499	S	7	0	7	0.00001
ERR6913181	Tessaracoccus defluvii	1285901	S	5	0	5	0.00001
ERR6913181	Microlunatus sp. Gsoil 973	2672569	S	5	0	5	0.00001
ERR6913181	Vaginimicrobium propionicum	1871034	S	8	0	8	0.00001
ERR6913181	Nocardioides piscis	2714938	S	6	8	14	0.00001
ERR6913181	Aeromicrobium marinum	219314	S	9	3	12	0.00001
ERR6913181	Streptomyces sp. T12	477697	S	6	19	25	0.00003
ERR6913181	Streptomyces sp. NA02950	2742137	S	5	7	12	0.00001
ERR6913181	Streptomyces paludis	2282738	S	15	10	25	0.00003
ERR6913181	Streptomyces liliifuscus	2797636	S	10	16	26	0.00003
ERR6913181	Streptomyces griseus	1911	S	8	28	36	0.00004
ERR6913181	Streptomyces collinus	42684	S	7	17	24	0.00002
ERR6913181	Streptomyces xanthii	2768069	S	5	5	10	0.00001
ERR6913181	Streptacidiphilus sp. P02-A3a	2704468	S	5	0	5	0.00001
ERR6913181	Amycolatopsis sp. Hca4	2742131	S	5	4	9	0.00001
ERR6913181	Saccharopolyspora erythraea	1836	S	5	4	9	0.00001
ERR6913181	Verrucosispora sp. NA02020	2742132	S	5	8	13	0.00001
ERR6913181	Candidatus Planktophila sulfonica	1884904	S	10	2	12	0.00001
ERR6913181	Modestobacter marinus	477641	S	5	1	6	0.00001
ERR6913181	Baekduia sp. 0141_2	2997333	S	5	0	5	0.00001
ERR6913181	Anabaenopsis circularis	109266	S	8	14	22	0.00002
ERR6913181	Prochlorococcus marinus	1219	S	11	2	13	0.00001
ERR6913181	Mesomycoplasma ovipneumoniae	29562	S	21	0	21	0.00002
ERR6913181	Mycoplasmopsis bovigenitalium	2112	S	9	3	12	0.00001
ERR6913181	Deinococcus sp. AJ005	2652443	S	5	1	6	0.00001
ERR6913181	Deinococcus peraridilitoris	432329	S	5	0	5	0.00001
ERR6913181	Caldilinea aerophila	133453	S	6	0	6	0.00001
ERR6913181	Prevotella histicola	470565	S	14652	392	15044	0.01555
ERR6913181	Prevotella jejuni	1177574	S	2938	233	3171	0.00328
ERR6913181	Prevotella melaninogenica	28132	S	2092	146	2238	0.00231
ERR6913181	Prevotella denticola	28129	S	1692	123	1815	0.00188
ERR6913181	Prevotella oris	28135	S	978	20	998	0.00103
ERR6913181	Prevotella nigrescens	28133	S	885	117	1002	0.00104
ERR6913181	Prevotella intermedia	28131	S	501	45	546	0.00056
ERR6913181	Prevotella sp. oral taxon 299	652716	S	100	2	102	0.00011
ERR6913181	Prevotella sp. oral taxon 475	712471	S	52	0	52	0.00005
ERR6913181	Prevotella sp. E2-28	2913620	S	7	2	9	0.00001
ERR6913181	Prevotella sp. E9-3	2913621	S	6	1	7	0.00001
ERR6913181	Prevotella sp. E13-17	2913616	S	5	1	6	0.00001
ERR6913181	Prevotella veroralis	28137	S	172	7	179	0.00018
ERR6913181	Prevotella multiformis	282402	S	113	10	123	0.00013
ERR6913181	Prevotella scopos	589437	S	112	11	123	0.00013
ERR6913181	Prevotella fusca	589436	S	68	3	71	0.00007
ERR6913181	Prevotella dentalis	52227	S	34	0	34	0.00004
ERR6913181	Prevotella corporis	28128	S	29	1	30	0.00003
ERR6913181	Prevotella bryantii	77095	S	28	0	28	0.00003
ERR6913181	Prevotella herbatica	2801997	S	18	0	18	0.00002
ERR6913181	Prevotella copri	165179	S	10	0	10	0.00001
ERR6913181	Prevotella ruminicola	839	S	6	0	6	0.00001
ERR6913181	Hoylesella enoeca	76123	S	125	4	129	0.00013
ERR6913181	Hoylesella buccalis	28127	S	20	1	21	0.00002
ERR6913181	Paraprevotella xylaniphila	454155	S	6	0	6	0.00001
ERR6913181	Porphyromonas gingivalis	837	S	1906	97	2003	0.00207
ERR6913181	Porphyromonas endodontalis	28124	S	1412	27	1439	0.00149
ERR6913181	Porphyromonas sp. oral taxon 275	712435	S	33	0	33	0.00003
ERR6913181	Porphyromonas crevioricanis	393921	S	6	0	6	0.00001
ERR6913181	Porphyromonas cangingivalis	36874	S	5	0	5	0.00001
ERR6913181	Tannerella forsythia	28112	S	384	35	419	0.00043
ERR6913181	Tannerella serpentiformis	712710	S	163	0	163	0.00017
ERR6913181	Parabacteroides distasonis	823	S	6	1	7	0.00001
ERR6913181	Parabacteroides merdae	46503	S	6	0	6	0.00001
ERR6913181	Bacteroides zhangwenhongii	2650157	S	9	1	10	0.00001
ERR6913181	Bacteroides fragilis	817	S	6	4	10	0.00001
ERR6913181	Bacteroides heparinolyticus	28113	S	6	0	6	0.00001
ERR6913181	Bacteroides zoogleoformans	28119	S	6	1	7	0.00001
ERR6913181	Bacteroides stercoris	46506	S	6	1	7	0.00001
ERR6913181	Bacteroides uniformis	820	S	5	17	22	0.00002
ERR6913181	Bacteroides faecium	2715212	S	5	0	5	0.00001
ERR6913181	Bacteroides intestinalis	329854	S	5	0	5	0.00001
ERR6913181	Alistipes onderdonkii	328813	S	6	0	6	0.00001
ERR6913181	Candidatus Azobacteroides pseudotrichonymphae	511435	S	5	0	5	0.00001
ERR6913181	Capnocytophaga sp. FDAARGOS_737	2545799	S	130	18	148	0.00015
ERR6913181	Capnocytophaga sp. oral taxon 902	2748316	S	10	12	22	0.00002
ERR6913181	Capnocytophaga sp. oral taxon 323	1705617	S	9	7	16	0.00002
ERR6913181	Capnocytophaga sp. oral taxon 864	1316593	S	7	4	11	0.00001
ERR6913181	Capnocytophaga sp. oral taxon 878	1316596	S	7	0	7	0.00001
ERR6913181	Capnocytophaga leadbetteri	327575	S	118	16	134	0.00014
ERR6913181	Capnocytophaga gingivalis	1017	S	88	2	90	0.00009
ERR6913181	Capnocytophaga ochracea	1018	S	75	34	109	0.00011
ERR6913181	Capnocytophaga sputigena	1019	S	71	6	77	0.00008
ERR6913181	Capnocytophaga endodontalis	2708117	S	28	3	31	0.00003
ERR6913181	Flavobacterium sp. N2013	2986828	S	8	4	12	0.00001
ERR6913181	Flavobacterium sp. IMCC36792	3016339	S	5	5	10	0.00001
ERR6913181	Flavobacterium nitrogenifigens	1617283	S	8	9	17	0.00002
ERR6913181	Flavobacterium crassostreae	1763534	S	5	0	5	0.00001
ERR6913181	Maribacter sp. Hal144	2980554	S	7	0	7	0.00001
ERR6913181	Tenacibaculum finnmarkense	2781243	S	5	2	7	0.00001
ERR6913181	Zhouia spongiae	2202721	S	7	0	7	0.00001
ERR6913181	Amniculibacterium sp. G2-70	2767188	S	5	0	5	0.00001
ERR6913181	Sabulilitoribacter sp. BrNp1-15	2916754	S	5	1	6	0.00001
ERR6913181	Chryseobacterium sp. SNU WT5	2594269	S	11	1	12	0.00001
ERR6913181	Chryseobacterium sp. StRB126	878220	S	5	8	13	0.00001
ERR6913181	Chryseobacterium daecheongense	192389	S	7	4	11	0.00001
ERR6913181	Chryseobacterium faecale	2852098	S	5	0	5	0.00001
ERR6913181	Elizabethkingia anophelis	1117645	S	9	5	14	0.00001
ERR6913181	Cloacibacterium sp. TD35	2976818	S	5	2	7	0.00001
ERR6913181	Hymenobacter nivis	1850093	S	5	12	17	0.00002
ERR6913181	Chitinophaga filiformis	104663	S	5	0	5	0.00001
ERR6913181	Fibrobacter succinogenes	833	S	6	0	6	0.00001
ERR6913181	Aggregatibacter sp. oral taxon 513	712150	S	264	43	307	0.00032
ERR6913181	Aggregatibacter sp. 2125159857	2820817	S	187	15	202	0.00021
ERR6913181	Aggregatibacter sp. Marseille-P9115	2866570	S	153	22	175	0.00018
ERR6913181	Aggregatibacter segnis	739	S	82	12	94	0.00010
ERR6913181	Aggregatibacter aphrophilus	732	S	71	4	75	0.00008
ERR6913181	Aggregatibacter actinomycetemcomitans	714	S	15	0	15	0.00002
ERR6913181	Haemophilus parainfluenzae	729	S	431	17	448	0.00046
ERR6913181	Haemophilus influenzae	727	S	18	7	25	0.00003
ERR6913181	Haemophilus haemolyticus	726	S	15	1	16	0.00002
ERR6913181	Haemophilus sp. oral taxon 036	712310	S	9	1	10	0.00001
ERR6913181	Pasteurella multocida	747	S	18	3	21	0.00002
ERR6913181	Pasteurella atlantica	2827233	S	6	0	6	0.00001
ERR6913181	Pasteurella dagmatis	754	S	5	0	5	0.00001
ERR6913181	Rodentibacter haemolyticus	2778911	S	10	0	10	0.00001
ERR6913181	Vibrio kanaloae	170673	S	482	169	651	0.00067
ERR6913181	Vibrio plantisponsor	664643	S	259	14	273	0.00028
ERR6913181	Vibrio parahaemolyticus	670	S	8	2	10	0.00001
ERR6913181	Vibrio alginolyticus	663	S	5	14	19	0.00002
ERR6913181	Vibrio natriegens	691	S	5	3	8	0.00001
ERR6913181	Vibrio toranzoniae	1194427	S	28	10	38	0.00004
ERR6913181	Vibrio cholerae	666	S	16	8	24	0.00002
ERR6913181	Vibrio sp. ED004	2785124	S	5	1	6	0.00001
ERR6913181	Vibrio ziniensis	2711221	S	11	0	11	0.00001
ERR6913181	Vibrio splendidus	29497	S	6	3	9	0.00001
ERR6913181	Vibrio tasmaniensis	212663	S	5	1	6	0.00001
ERR6913181	Pseudoalteromonas prydzensis	182141	S	315	17	332	0.00034
ERR6913181	Pseudoalteromonas rhizosphaerae	2518973	S	79	5	84	0.00009
ERR6913181	Pseudoalteromonas sp. KAN5	2916633	S	11	22	33	0.00003
ERR6913181	Pseudoalteromonas sp. SiA1	2839744	S	6	20	26	0.00003
ERR6913181	Pseudoalteromonas sp. SCSIO 43095	2894202	S	5	3	8	0.00001
ERR6913181	Pseudoalteromonas mariniglutinosa	206042	S	14	13	27	0.00003
ERR6913181	Idiomarina loihiensis	135577	S	11	2	13	0.00001
ERR6913181	Cognaticolwellia beringensis	1967665	S	8	0	8	0.00001
ERR6913181	Klebsiella pneumoniae	573	S	15	123	138	0.00014
ERR6913181	Pluralibacter gergoviae	61647	S	20	1	21	0.00002
ERR6913181	Escherichia coli	562	S	6	55	61	0.00006
ERR6913181	Salmonella enterica	28901	S	8	20	28	0.00003
ERR6913181	Pantoea agglomerans	549	S	16	5	21	0.00002
ERR6913181	Buchnera aphidicola	9	S	8	-1	7	0.00001
ERR6913181	Yersinia ruckeri	29486	S	7	5	12	0.00001
ERR6913181	Nissabacter sp. SGAir0207	2126321	S	6	0	6	0.00001
ERR6913181	Sodalis praecaptivus	1239307	S	5	0	5	0.00001
ERR6913181	Pseudomonas fluorescens	294	S	22	24	46	0.00005
ERR6913181	Pseudomonas putida	303	S	20	28	48	0.00005
ERR6913181	Pseudomonas aeruginosa	287	S	6	44	50	0.00005
ERR6913181	Pseudomonas lundensis	86185	S	6	0	6	0.00001
ERR6913181	Stutzerimonas stutzeri	316	S	5	3	8	0.00001
ERR6913181	Stutzerimonas frequens	2968969	S	5	3	8	0.00001
ERR6913181	Acinetobacter sp. ASP199	2773709	S	6	11	17	0.00002
ERR6913181	Acinetobacter johnsonii	40214	S	17	19	36	0.00004
ERR6913181	Acinetobacter junii	40215	S	14	2	16	0.00002
ERR6913181	Acinetobacter wanghuae	2662362	S	7	0	7	0.00001
ERR6913181	Acinetobacter lwoffii	28090	S	6	7	13	0.00001
ERR6913181	Acinetobacter dispersus	70348	S	5	0	5	0.00001
ERR6913181	Moraxella osloensis	34062	S	30	1	31	0.00003
ERR6913181	Xanthomonas campestris	339	S	42	11	53	0.00005
ERR6913181	Stenotrophomonas maltophilia	40324	S	22	15	37	0.00004
ERR6913181	Lysobacter capsici	435897	S	5	1	6	0.00001
ERR6913181	Tahibacter sp. W38	2976241	S	8	0	8	0.00001
ERR6913181	Cardiobacterium hominis	2718	S	20	0	20	0.00002
ERR6913181	Cardiobacterium sp. Marseille-Q4385	2866573	S	7	0	7	0.00001
ERR6913181	Aeromonas salmonicida	645	S	6	3	9	0.00001
ERR6913181	Candidatus Coxiella mudrowiae	2054173	S	5	0	5	0.00001
ERR6913181	Kangiella sediminilitoris	1144748	S	10	0	10	0.00001
ERR6913181	Gallaecimonas mangrovi	2291597	S	5	0	5	0.00001
ERR6913181	Neisseria sicca	490	S	442	109	551	0.00057
ERR6913181	Neisseria macacae	496	S	148	49	197	0.00020
ERR6913181	Neisseria sp. oral taxon 014	641148	S	123	9	132	0.00014
ERR6913181	Neisseria sp. KEM232	655307	S	11	0	11	0.00001
ERR6913181	Neisseria elongata	495	S	92	7	99	0.00010
ERR6913181	Neisseria mucosa	488	S	84	21	105	0.00011
ERR6913181	Neisseria meningitidis	487	S	44	41	85	0.00009
ERR6913181	Neisseria subflava	28449	S	37	7	44	0.00005
ERR6913181	Neisseria flavescens	484	S	16	3	19	0.00002
ERR6913181	Neisseria cinerea	483	S	14	2	16	0.00002
ERR6913181	Neisseria gonorrhoeae	485	S	11	3	14	0.00001
ERR6913181	Neisseria lactamica	486	S	10	4	14	0.00001
ERR6913181	Kingella oralis	505	S	135	2	137	0.00014
ERR6913181	Kingella denitrificans	502	S	50	2	52	0.00005
ERR6913181	Eikenella corrodens	539	S	53	3	56	0.00006
ERR6913181	Eikenella exigua	2528037	S	7	0	7	0.00001
ERR6913181	Morococcus cerebrosus	1056807	S	24	8	32	0.00003
ERR6913181	Lautropia mirabilis	47671	S	226	17	243	0.00025
ERR6913181	Burkholderia multivorans	87883	S	14	11	25	0.00003
ERR6913181	Burkholderia pseudomallei	28450	S	7	9	16	0.00002
ERR6913181	Cupriavidus pauculus	82633	S	15	5	20	0.00002
ERR6913181	Cupriavidus taiwanensis	164546	S	9	12	21	0.00002
ERR6913181	Ottowia sp. oral taxon 894	1658672	S	56	6	62	0.00006
ERR6913181	Variovorax paradoxus	34073	S	13	13	26	0.00003
ERR6913181	Acidovorax temperans	80878	S	11	8	19	0.00002
ERR6913181	Acidovorax radicis	758826	S	8	2	10	0.00001
ERR6913181	Comamonas aquatica	225991	S	9	10	19	0.00002
ERR6913181	Rhodoferax aquaticus	2527691	S	5	1	6	0.00001
ERR6913181	Limnohabitans sp. 63ED37-2	1678128	S	10	1	11	0.00001
ERR6913181	Limnohabitans sp. 103DPR2	1678129	S	8	0	8	0.00001
ERR6913181	Polaromonas sp. JS666	296591	S	6	4	10	0.00001
ERR6913181	Diaphorobacter sp. HDW4B	2714925	S	6	2	8	0.00001
ERR6913181	Ramlibacter tataouinensis	94132	S	11	3	14	0.00001
ERR6913181	Collimonas fungivorans	158899	S	13	6	19	0.00002
ERR6913181	Collimonas arenae	279058	S	6	1	7	0.00001
ERR6913181	Bordetella hinzii	103855	S	5	1	6	0.00001
ERR6913181	Paenalcaligenes faecalis	2980099	S	8	0	8	0.00001
ERR6913181	Schlegelella aquatica	376175	S	22	4	26	0.00003
ERR6913181	Aquincola tertiaricarbonis	391953	S	5	1	6	0.00001
ERR6913181	Paucibacter sp. KCTC 42545	1768242	S	5	2	7	0.00001
ERR6913181	Ferribacterium limneticum	76259	S	10	2	12	0.00001
ERR6913181	Rhizobium leguminosarum	384	S	6	35	41	0.00004
ERR6913181	Agrobacterium tumefaciens	358	S	7	11	18	0.00002
ERR6913181	Bradyrhizobium sp. 200	2782665	S	5	12	17	0.00002
ERR6913181	Bradyrhizobium sediminis	2840469	S	6	11	17	0.00002
ERR6913181	Mesorhizobium ciceri	39645	S	10	20	30	0.00003
ERR6913181	Methylorubrum extorquens	408	S	5	10	15	0.00002
ERR6913181	Maritalea myrionectae	454601	S	28	0	28	0.00003
ERR6913181	Pannonibacter phragmitetus	121719	S	5	4	9	0.00001
ERR6913181	Sphingomonas sp. R1	399176	S	6	4	10	0.00001
ERR6913181	Sphingomonas lutea	1045317	S	8	4	12	0.00001
ERR6913181	Sphingomonas radiodurans	2890321	S	5	3	8	0.00001
ERR6913181	Sphingobium sp. RAC03	1843368	S	7	8	15	0.00002
ERR6913181	Croceibacterium atlanticum	1267766	S	5	1	6	0.00001
ERR6913181	Paracoccus yeei	147645	S	9	14	23	0.00002
ERR6913181	Cognatishimia activa	1715691	S	6	0	6	0.00001
ERR6913181	Sulfitobacter sp. SK025	1389011	S	6	10	16	0.00002
ERR6913181	Brevundimonas nasdae	172043	S	5	8	13	0.00001
ERR6913181	Ehrlichia ruminantium	779	S	6	0	6	0.00001
ERR6913181	Hydrogenophilus thermoluteolus	297	S	17	0	17	0.00002
ERR6913181	Leptotrichia wadei	157687	S	550	58	608	0.00063
ERR6913181	Leptotrichia sp. oral taxon 212	712357	S	55	0	55	0.00006
ERR6913181	Leptotrichia sp. oral taxon 498	712368	S	46	7	53	0.00005
ERR6913181	Leptotrichia sp. oral taxon 218	712361	S	23	3	26	0.00003
ERR6913181	Leptotrichia sp. oral taxon 221	712362	S	21	1	22	0.00002
ERR6913181	Leptotrichia sp. oral taxon 847	1785996	S	10	0	10	0.00001
ERR6913181	Leptotrichia buccalis	40542	S	108	9	117	0.00012
ERR6913181	Leptotrichia trevisanii	109328	S	90	5	95	0.00010
ERR6913181	Leptotrichia hofstadii	157688	S	31	3	34	0.00004
ERR6913181	Leptotrichia hongkongensis	554406	S	29	3	32	0.00003
ERR6913181	Leptotrichia shahii	157691	S	25	3	28	0.00003
ERR6913181	Fusobacterium nucleatum	851	S	220	22	242	0.00025
ERR6913181	Fusobacterium hwasookii	1583098	S	14	3	17	0.00002
ERR6913181	Fusobacterium pseudoperiodonticum	2663009	S	12	1	13	0.00001
ERR6913181	Fusobacterium necrophorum	859	S	5	0	5	0.00001
ERR6913181	Candidatus Nanosynbacter sp. HMT-352	2899133	S	410	23	433	0.00045
ERR6913181	Candidatus Nanosynbacter featherlites	2572088	S	175	3	178	0.00018
ERR6913181	Candidatus Nanosynbacter lyticus	2093824	S	60	4	64	0.00007
ERR6913181	Candidatus Saccharimonas aalborgensis	1332188	S	10	0	10	0.00001
ERR6913181	Candidatus Minimicrobia vallesae	2841264	S	58	12	70	0.00007
ERR6913181	Candidatus Mycosynbacter amalyticus	2665156	S	8	0	8	0.00001
ERR6913181	Treponema denticola	158	S	205	37	242	0.00025
ERR6913181	Treponema sp. OMZ 305	1659192	S	27	9	36	0.00004
ERR6913181	Treponema sp. OMZ 857	1643513	S	21	16	37	0.00004
ERR6913181	Treponema sp. OMZ 906	2563662	S	15	9	24	0.00002
ERR6913181	Treponema sp. OMZ 803	120682	S	14	9	23	0.00002
ERR6913181	Treponema sp. OMZ 838	1539298	S	8	14	22	0.00002
ERR6913181	Treponema sp. Marseille-Q4132	2766701	S	8	0	8	0.00001
ERR6913181	Treponema sp. OMZ 855	1643512	S	6	10	16	0.00002
ERR6913181	Treponema vincentii	69710	S	81	6	87	0.00009
ERR6913181	Treponema medium	58231	S	79	4	83	0.00009
ERR6913181	Treponema socranskii	53419	S	36	0	36	0.00004
ERR6913181	Treponema putidum	221027	S	9	0	9	0.00001
ERR6913181	Treponema phagedenis	162	S	7	0	7	0.00001
ERR6913181	Treponema parvum	138851	S	5	0	5	0.00001
ERR6913181	Leptospira tipperaryensis	2564040	S	9	5	14	0.00001
ERR6913181	Campylobacter rectus	203	S	126	6	132	0.00014
ERR6913181	Campylobacter concisus	199	S	52	0	52	0.00005
ERR6913181	Campylobacter gracilis	824	S	49	0	49	0.00005
ERR6913181	Campylobacter showae	204	S	30	1	31	0.00003
ERR6913181	Campylobacter sp. RM6914	1032243	S	19	1	20	0.00002
ERR6913181	Campylobacter lari	201	S	8	2	10	0.00001
ERR6913181	Campylobacter iguaniorum	1244531	S	5	0	5	0.00001
ERR6913181	Campylobacter curvus	200	S	5	0	5	0.00001
ERR6913181	Arcobacter ellisii	913109	S	7	1	8	0.00001
ERR6913181	Arcobacter venerupis	1054033	S	5	0	5	0.00001
ERR6913181	Candidatus Sulfurimonas marisnigri	2740405	S	11	1	12	0.00001
ERR6913181	Fretibacterium fastidiosum	651822	S	112	0	112	0.00012
ERR6913181	Pseudodesulfovibrio profundus	57320	S	5	1	6	0.00001
ERR6913181	Pseudodesulfovibrio aespoeensis	182210	S	5	1	6	0.00001
ERR6913181	Oleidesulfovibrio alaskensis	58180	S	7	0	7	0.00001
ERR6913181	Salidesulfovibrio onnuriiensis	2583823	S	6	0	6	0.00001
ERR6913181	Desulfonema magnum	45655	S	8	0	8	0.00001
ERR6913181	Rosistilla oblonga	2527990	S	5	1	6	0.00001
ERR6913181	Limnoglobus roseus	2598579	S	6	1	7	0.00001
ERR6913181	Occallatibacter riparius	1002689	S	5	3	8	0.00001
ERR6913181	Sulfurihydrogenibium azorense	309806	S	6	0	6	0.00001
ERR6913181	Homo sapiens	9606	S	277	0	277	0.00029
ERR6913181	Colletotrichum lupini	145971	S	6	0	6	0.00001
ERR6913181	Botrytis cinerea	40559	S	5	0	5	0.00001
ERR6913181	Cercospora beticola	122368	S	19	0	19	0.00002
ERR6913181	Malassezia restricta	76775	S	45	0	45	0.00005
ERR6913181	Puccinia striiformis	27350	S	5	0	5	0.00001
ERR6913181	Plasmodium chabaudi	5825	S	9	0	9	0.00001
ERR6913181	Plasmodium malariae	5858	S	6	0	6	0.00001
ERR6913181	Babesia bigemina	5866	S	16	0	16	0.00002
ERR6913181	Leishmania mexicana	5665	S	31	1	32	0.00003
ERR6913181	Trichomonas vaginalis	5722	S	5	0	5	0.00001
ERR6913181	Halocatena salina	2934340	S	5	0	5	0.00001
ERR6913181	Halococcus qingdaonensis	224402	S	5	2	7	0.00001
ERR6913181	Methanosarcina barkeri	2208	S	7	0	7	0.00001
ERR6913181	Methanosarcina acetivorans	2214	S	5	0	5	0.00001
ERR6913181	Thermococcus barophilus	55802	S	5	0	5	0.00001
ERR6913181	Streptococcus phage YMC-2011	1051631	S	831	13	844	0.00087
ERR6913181	Streptococcus phage 5093	646413	S	68	7	75	0.00008
ERR6913181	Streptococcus phage PH10	644007	S	9	0	9	0.00001
ERR6913181	Streptococcus phage vB_SthS_VA214	2069608	S	64	127	191	0.00020
ERR6913181	Streptococcus phage CHPC950	2365054	S	62	97	159	0.00016
ERR6913181	Streptococcus phage CHPC663	2365039	S	41	18	59	0.00006
ERR6913181	Streptococcus phage P7133	1971422	S	19	98	117	0.00012
ERR6913181	Streptococcus phage SW6	2419655	S	13	17	30	0.00003
ERR6913181	Streptococcus phage P0091	1971410	S	12	12	24	0.00002
ERR6913181	Streptococcus phage vB_SthS_VA460	2069609	S	8	2	10	0.00001
ERR6913181	Streptococcus phage CHPC979	2365058	S	8	12	20	0.00002
ERR6913181	Streptococcus phage TP-778L	1385385	S	171	165	336	0.00035
ERR6913181	Brussowvirus bvO1205	85154	S	75	27	102	0.00011
ERR6913181	Brussowvirus ALQ132	682370	S	43	37	80	0.00008
ERR6913181	Skunavirus sv96603	2845187	S	9	14	23	0.00002
ERR6913181	Vhmlvirus VP585	1922213	S	11	7	18	0.00002
ERR6913182	Streptococcus sp. oral taxon 431	712633	S	38939	2388	41327	0.06012
ERR6913182	Streptococcus sp. LPB0220	2610896	S	22187	4136	26323	0.03829
ERR6913182	Streptococcus sp. HSISM1	1316408	S	20104	3555	23659	0.03442
ERR6913182	Streptococcus sp. oral taxon 061	712623	S	13612	1771	15383	0.02238
ERR6913182	Streptococcus sp. Marseille-Q6470	2972784	S	11975	1416	13391	0.01948
ERR6913182	Streptococcus sp. Marseille-Q3533	2759692	S	11294	878	12172	0.01771
ERR6913182	Streptococcus sp. A12	1759399	S	7472	886	8358	0.01216
ERR6913182	Streptococcus sp. 116-D4	2598453	S	1866	199	2065	0.00300
ERR6913182	Streptococcus sp. NPS 308	1902136	S	753	122	875	0.00127
ERR6913182	Streptococcus sp. FDAARGOS_192	1839799	S	722	436	1158	0.00168
ERR6913182	Streptococcus sp. 1643	2576376	S	336	132	468	0.00068
ERR6913182	Streptococcus sp. HSISS2	1316411	S	304	196	500	0.00073
ERR6913182	Streptococcus sp. HSISS3	1316412	S	205	125	330	0.00048
ERR6913182	Streptococcus sp. oral taxon 064	712624	S	182	147	329	0.00048
ERR6913182	Streptococcus sp. HSISS1	1316410	S	53	524	577	0.00084
ERR6913182	Streptococcus sp. NSJ-72	2763068	S	47	52	99	0.00014
ERR6913182	Streptococcus sp. KS 6	2598457	S	45	13	58	0.00008
ERR6913182	Streptococcus sp. zg-86	2664091	S	31	1	32	0.00005
ERR6913182	Streptococcus sp. FDAARGOS_522	2420310	S	11	226	237	0.00034
ERR6913182	Streptococcus sp. HN38	3020829	S	9	4	13	0.00002
ERR6913182	Streptococcus sp. CNU G2	2686210	S	7	6	13	0.00002
ERR6913182	Streptococcus sp. DAT741	1940319	S	7	6	13	0.00002
ERR6913182	Streptococcus parasanguinis	1318	S	35887	4114	40001	0.05819
ERR6913182	Streptococcus salivarius	1304	S	25960	5568	31528	0.04587
ERR6913182	Streptococcus infantis	68892	S	15002	935	15937	0.02318
ERR6913182	Streptococcus oralis	1303	S	10998	2312	13310	0.01936
ERR6913182	Streptococcus mitis	28037	S	6771	887	7658	0.01114
ERR6913182	Streptococcus australis	113107	S	5091	1409	6500	0.00946
ERR6913182	Streptococcus ilei	1156431	S	4392	1296	5688	0.00827
ERR6913182	Streptococcus pneumoniae	1313	S	3579	2215	5794	0.00843
ERR6913182	Streptococcus sanguinis	1305	S	3336	104	3440	0.00500
ERR6913182	Streptococcus lactarius	684066	S	3323	114	3437	0.00500
ERR6913182	Streptococcus koreensis	2382163	S	1692	598	2290	0.00333
ERR6913182	Streptococcus rubneri	1234680	S	1660	376	2036	0.00296
ERR6913182	Streptococcus gordonii	1302	S	1510	140	1650	0.00240
ERR6913182	Streptococcus cristatus	45634	S	1288	54	1342	0.00195
ERR6913182	Streptococcus thermophilus	1308	S	785	287	1072	0.00156
ERR6913182	Streptococcus intermedius	1338	S	285	59	344	0.00050
ERR6913182	Streptococcus anginosus	1328	S	216	140	356	0.00052
ERR6913182	Streptococcus constellatus	76860	S	103	369	472	0.00069
ERR6913182	Streptococcus pseudopneumoniae	257758	S	502	94	596	0.00087
ERR6913182	Streptococcus toyakuensis	2819619	S	486	123	609	0.00089
ERR6913182	Streptococcus gwangjuense	1433513	S	451	88	539	0.00078
ERR6913182	Streptococcus suis	1307	S	323	54	377	0.00055
ERR6913182	Streptococcus vestibularis	1343	S	301	34	335	0.00049
ERR6913182	Streptococcus pyogenes	1314	S	170	66	236	0.00034
ERR6913182	Streptococcus equi	1336	S	119	2	121	0.00018
ERR6913182	Streptococcus dysgalactiae	1334	S	18	1	19	0.00003
ERR6913182	Streptococcus agalactiae	1311	S	100	791	891	0.00130
ERR6913182	Streptococcus mutans	1309	S	94	8	102	0.00015
ERR6913182	Streptococcus merionis	400065	S	67	0	67	0.00010
ERR6913182	Streptococcus oriscaviae	2781599	S	66	0	66	0.00010
ERR6913182	Streptococcus sobrinus	1310	S	65	0	65	0.00009
ERR6913182	Streptococcus pluranimalium	82348	S	61	1	62	0.00009
ERR6913182	Streptococcus equinus	1335	S	60	4	64	0.00009
ERR6913182	Streptococcus parasuis	1501662	S	58	15	73	0.00011
ERR6913182	Streptococcus pseudoporcinus	361101	S	55	2	57	0.00008
ERR6913182	Streptococcus alactolyticus	29389	S	53	2	55	0.00008
ERR6913182	Streptococcus porcinus	1340	S	52	1	53	0.00008
ERR6913182	Streptococcus himalayensis	1888195	S	49	1	50	0.00007
ERR6913182	Streptococcus canis	1329	S	49	1	50	0.00007
ERR6913182	Streptococcus acidominimus	1326	S	48	1	49	0.00007
ERR6913182	Streptococcus uberis	1349	S	44	0	44	0.00006
ERR6913182	Streptococcus respiraculi	2021971	S	38	0	38	0.00006
ERR6913182	Streptococcus marmotae	1825069	S	32	1	33	0.00005
ERR6913182	Streptococcus parauberis	1348	S	31	0	31	0.00005
ERR6913182	Streptococcus iniae	1346	S	30	0	30	0.00004
ERR6913182	Streptococcus ferus	1345	S	28	0	28	0.00004
ERR6913182	Streptococcus halotolerans	1814128	S	28	0	28	0.00004
ERR6913182	Streptococcus halichoeri	254785	S	24	0	24	0.00003
ERR6913182	Streptococcus ruminantium	1917441	S	22	9	31	0.00005
ERR6913182	Streptococcus pantholopis	1811193	S	21	0	21	0.00003
ERR6913182	Streptococcus ratti	1341	S	20	0	20	0.00003
ERR6913182	Streptococcus gallolyticus	315405	S	20	6	26	0.00004
ERR6913182	Streptococcus troglodytae	1111760	S	15	0	15	0.00002
ERR6913182	Streptococcus milleri	33040	S	15	11	26	0.00004
ERR6913182	Streptococcus periodonticum	2490633	S	14	6	20	0.00003
ERR6913182	Streptococcus lutetiensis	150055	S	14	2	16	0.00002
ERR6913182	Streptococcus urinalis	149016	S	14	0	14	0.00002
ERR6913182	Streptococcus macedonicus	59310	S	12	14	26	0.00004
ERR6913182	Streptococcus chenjunshii	2173853	S	11	0	11	0.00002
ERR6913182	Lactococcus cremoris	1359	S	69	37	106	0.00015
ERR6913182	Lactococcus lactis	1358	S	35	26	61	0.00009
ERR6913182	Lactococcus raffinolactis	1366	S	6	0	6	0.00001
ERR6913182	Lactococcus garvieae	1363	S	5	0	5	0.00001
ERR6913182	Floricoccus penangensis	1859475	S	5	0	5	0.00001
ERR6913182	Granulicatella adiacens	46124	S	5888	123	6011	0.00874
ERR6913182	Granulicatella elegans	137732	S	123	10	133	0.00019
ERR6913182	Carnobacterium divergens	2748	S	10	4	14	0.00002
ERR6913182	Dolosigranulum pigrum	29394	S	21	0	21	0.00003
ERR6913182	Lactobacillus sp. IBH004	2879107	S	6	2	8	0.00001
ERR6913182	Lactobacillus iners	147802	S	8	0	8	0.00001
ERR6913182	Lactobacillus delbrueckii	1584	S	7	1	8	0.00001
ERR6913182	Lactobacillus johnsonii	33959	S	6	1	7	0.00001
ERR6913182	Lactobacillus helveticus	1587	S	6	2	8	0.00001
ERR6913182	Lactobacillus acidophilus	1579	S	5	0	5	0.00001
ERR6913182	Lactobacillus jensenii	109790	S	5	0	5	0.00001
ERR6913182	Weissella cibaria	137591	S	7	3	10	0.00001
ERR6913182	Limosilactobacillus fermentum	1613	S	12	8	20	0.00003
ERR6913182	Ligilactobacillus salivarius	1624	S	12	4	16	0.00002
ERR6913182	Ligilactobacillus ruminis	1623	S	5	0	5	0.00001
ERR6913182	Lacticaseibacillus rhamnosus	47715	S	7	9	16	0.00002
ERR6913182	Latilactobacillus curvatus	28038	S	7	4	11	0.00002
ERR6913182	Companilactobacillus ginsenosidimutans	1007676	S	6	3	9	0.00001
ERR6913182	Lactiplantibacillus plantarum	1590	S	7	13	20	0.00003
ERR6913182	Pediococcus damnosus	51663	S	5	2	7	0.00001
ERR6913182	Liquorilactobacillus hordei	468911	S	5	1	6	0.00001
ERR6913182	Amylolactobacillus amylophilus	1603	S	7	0	7	0.00001
ERR6913182	Acetilactobacillus jinshanensis	1720083	S	6	0	6	0.00001
ERR6913182	Schleiferilactobacillus harbinensis	304207	S	5	0	5	0.00001
ERR6913182	Enterococcus faecalis	1351	S	28	25	53	0.00008
ERR6913182	Enterococcus rotai	118060	S	18	0	18	0.00003
ERR6913182	Enterococcus cecorum	44008	S	14	0	14	0.00002
ERR6913182	Enterococcus faecium	1352	S	13	6	19	0.00003
ERR6913182	Enterococcus hirae	1354	S	8	0	8	0.00001
ERR6913182	Enterococcus dispar	44009	S	8	0	8	0.00001
ERR6913182	Enterococcus durans	53345	S	8	0	8	0.00001
ERR6913182	Enterococcus mundtii	53346	S	8	0	8	0.00001
ERR6913182	Enterococcus gilvus	160453	S	8	0	8	0.00001
ERR6913182	Enterococcus wangshanyuanii	2005703	S	6	0	6	0.00001
ERR6913182	Enterococcus avium	33945	S	5	0	5	0.00001
ERR6913182	Vagococcus lutrae	81947	S	7	0	7	0.00001
ERR6913182	Vagococcus xieshaowenii	2562451	S	7	0	7	0.00001
ERR6913182	Vagococcus hydrophili	2714947	S	7	0	7	0.00001
ERR6913182	Vagococcus fluvialis	2738	S	6	0	6	0.00001
ERR6913182	Vagococcus sp. G314FT	2920380	S	6	0	6	0.00001
ERR6913182	Vagococcus penaei	633807	S	5	0	5	0.00001
ERR6913182	Aerococcus sanguinicola	119206	S	6	0	6	0.00001
ERR6913182	Aerococcus urinaeequi	51665	S	5	1	6	0.00001
ERR6913182	Abiotrophia defectiva	46125	S	10	0	10	0.00001
ERR6913182	Gemella sanguinis	84135	S	2248	132	2380	0.00346
ERR6913182	Gemella haemolysans	1379	S	455	20	475	0.00069
ERR6913182	Gemella morbillorum	29391	S	102	7	109	0.00016
ERR6913182	Gemella sp. oral taxon 928	1785995	S	8	15	23	0.00003
ERR6913182	Exiguobacterium sp. N4-1P	2051906	S	16	7	23	0.00003
ERR6913182	Bacillus mycoides	1405	S	20	18	38	0.00006
ERR6913182	Bacillus cereus	1396	S	13	23	36	0.00005
ERR6913182	Bacillus thuringiensis	1428	S	5	6	11	0.00002
ERR6913182	Bacillus toyonensis	155322	S	5	13	18	0.00003
ERR6913182	Bacillus pumilus	1408	S	6	1	7	0.00001
ERR6913182	Bacillus fonticola	2728853	S	6	0	6	0.00001
ERR6913182	Bacillus shivajii	1983719	S	6	0	6	0.00001
ERR6913182	Lysinibacillus sp. SGAir0095	2070463	S	5	1	6	0.00001
ERR6913182	Lysinibacillus timonensis	2086577	S	7	2	9	0.00001
ERR6913182	Lysinibacillus agricola	2590012	S	7	10	17	0.00002
ERR6913182	Priestia megaterium	1404	S	17	40	57	0.00008
ERR6913182	Priestia filamentosa	1402861	S	7	0	7	0.00001
ERR6913182	Anoxybacillus flavithermus	33934	S	8	6	14	0.00002
ERR6913182	Anoxybacillus amylolyticus	294699	S	6	1	7	0.00001
ERR6913182	Parageobacillus toebii	153151	S	5	2	7	0.00001
ERR6913182	Halobacillus sp. SSBR10-3	2932257	S	6	0	6	0.00001
ERR6913182	Niallia circulans	1397	S	6	0	6	0.00001
ERR6913182	Terribacillus goriensis	386490	S	6	0	6	0.00001
ERR6913182	Alkalihalophilus pseudofirmus	79885	S	8	0	8	0.00001
ERR6913182	Caldibacillus thermoamylovorans	35841	S	7	1	8	0.00001
ERR6913182	Salipaludibacillus sp. LMS25	2924031	S	6	0	6	0.00001
ERR6913182	Pradoshia sp. D12	2651284	S	6	0	6	0.00001
ERR6913182	Salisediminibacterium selenitireducens	85683	S	5	0	5	0.00001
ERR6913182	Sediminibacillus dalangtanensis	2729421	S	5	0	5	0.00001
ERR6913182	Paenibacillus sp. YPD9-1	2908839	S	5	0	5	0.00001
ERR6913182	Paenibacillus sp. FSL H7-0737	1536775	S	5	5	10	0.00001
ERR6913182	Paenibacillus sp. DCT19	2211212	S	5	0	5	0.00001
ERR6913182	Paenibacillus polymyxa	1406	S	14	45	59	0.00009
ERR6913182	Paenibacillus mucilaginosus	61624	S	5	0	5	0.00001
ERR6913182	Brevibacillus laterosporus	1465	S	7	7	14	0.00002
ERR6913182	Brevibacillus brevis	1393	S	6	1	7	0.00001
ERR6913182	Brevibacillus marinus	2496837	S	5	0	5	0.00001
ERR6913182	Cohnella cholangitidis	2598458	S	6	2	8	0.00001
ERR6913182	Staphylococcus auricularis	29379	S	15	0	15	0.00002
ERR6913182	Staphylococcus lugdunensis	28035	S	11	0	11	0.00002
ERR6913182	Staphylococcus epidermidis	1282	S	10	0	10	0.00001
ERR6913182	Staphylococcus aureus	1280	S	8	30	38	0.00006
ERR6913182	Staphylococcus hominis	1290	S	8	0	8	0.00001
ERR6913182	Staphylococcus haemolyticus	1283	S	6	3	9	0.00001
ERR6913182	Staphylococcus nepalensis	214473	S	6	0	6	0.00001
ERR6913182	Staphylococcus carnosus	1281	S	5	0	5	0.00001
ERR6913182	Staphylococcus saccharolyticus	33028	S	5	0	5	0.00001
ERR6913182	Staphylococcus saprophyticus	29385	S	5	0	5	0.00001
ERR6913182	Staphylococcus arlettae	29378	S	5	0	5	0.00001
ERR6913182	Mammaliicoccus sciuri	1296	S	11	0	11	0.00002
ERR6913182	Planococcus glaciei	459472	S	7	2	9	0.00001
ERR6913182	Solibacillus silvestris	76853	S	13	3	16	0.00002
ERR6913182	Solibacillus sp. R5-41	2048654	S	5	1	6	0.00001
ERR6913182	Kurthia sp. 11kri321	1750719	S	6	0	6	0.00001
ERR6913182	Listeria innocua	1642	S	8	10	18	0.00003
ERR6913182	Listeria weihenstephanensis	1006155	S	7	0	7	0.00001
ERR6913182	Alicyclobacillus acidocaldarius	405212	S	7	2	9	0.00001
ERR6913182	Veillonella atypica	39777	S	16837	338	17175	0.02499
ERR6913182	Veillonella rogosae	423477	S	16512	1000	17512	0.02548
ERR6913182	Veillonella nakazawae	2682456	S	10471	2896	13367	0.01945
ERR6913182	Veillonella sp. S12025-13	2682455	S	5467	1318	6785	0.00987
ERR6913182	Veillonella dispar	39778	S	4105	512	4617	0.00672
ERR6913182	Veillonella parvula	29466	S	3750	114	3864	0.00562
ERR6913182	Veillonella rodentium	248315	S	411	5	416	0.00061
ERR6913182	Megasphaera stantonii	2144175	S	68	7	75	0.00011
ERR6913182	Megasphaera elsdenii	907	S	41	16	57	0.00008
ERR6913182	Megasphaera hexanoica	1675036	S	39	9	48	0.00007
ERR6913182	Megasphaera massiliensis	1232428	S	36	5	41	0.00006
ERR6913182	Dialister pneumosintes	39950	S	31	10	41	0.00006
ERR6913182	Dialister succinatiphilus	487173	S	5	3	8	0.00001
ERR6913182	Selenomonas sp. oral taxon 478	712538	S	1342	316	1658	0.00241
ERR6913182	Selenomonas sp. oral taxon 136	713030	S	942	198	1140	0.00166
ERR6913182	Selenomonas sp. oral taxon 126	712528	S	198	7	205	0.00030
ERR6913182	Selenomonas sp. oral taxon 920	1884263	S	185	5	190	0.00028
ERR6913182	Selenomonas sputigena	69823	S	334	1	335	0.00049
ERR6913182	Selenomonas timonae	2754044	S	119	7	126	0.00018
ERR6913182	Selenomonas ruminantium	971	S	6	0	6	0.00001
ERR6913182	Megamonas funiformis	437897	S	16	0	16	0.00002
ERR6913182	Pelosinus fermentans	365349	S	11	0	11	0.00002
ERR6913182	Pelosinus sp. UFO1	484770	S	7	0	7	0.00001
ERR6913182	Sporomusa termitida	2377	S	7	0	7	0.00001
ERR6913182	Phascolarctobacterium faecium	33025	S	11	2	13	0.00002
ERR6913182	Lachnoanaerobaculum umeaense	617123	S	1955	41	1996	0.00290
ERR6913182	Blautia argi	1912897	S	23	6	29	0.00004
ERR6913182	Blautia producta	33035	S	22	6	28	0.00004
ERR6913182	Blautia hansenii	1322	S	19	10	29	0.00004
ERR6913182	Blautia obeum	40520	S	17	10	27	0.00004
ERR6913182	Blautia pseudococcoides	1796616	S	17	4	21	0.00003
ERR6913182	Blautia sp. NBRC 113351	2877527	S	9	4	13	0.00002
ERR6913182	Blautia sp. SC05B48	2479767	S	7	25	32	0.00005
ERR6913182	Blautia liquoris	2779518	S	14	1	15	0.00002
ERR6913182	Blautia wexlerae	418240	S	11	8	19	0.00003
ERR6913182	Butyrivibrio fibrisolvens	831	S	36	3	39	0.00006
ERR6913182	Butyrivibrio proteoclasticus	43305	S	27	4	31	0.00005
ERR6913182	Butyrivibrio crossotus	45851	S	20	5	25	0.00004
ERR6913182	Butyrivibrio hungatei	185008	S	17	2	19	0.00003
ERR6913182	[Clostridium] scindens	29347	S	25	2	27	0.00004
ERR6913182	Lachnoclostridium phytofermentans	66219	S	22	0	22	0.00003
ERR6913182	Lachnoclostridium sp. YL32	1834196	S	22	51	73	0.00011
ERR6913182	Lachnoclostridium phocaeense	1871021	S	18	4	22	0.00003
ERR6913182	Roseburia hominis	301301	S	31	11	42	0.00006
ERR6913182	Roseburia intestinalis	166486	S	25	23	48	0.00007
ERR6913182	Roseburia sp. NSJ-69	2763062	S	13	5	18	0.00003
ERR6913182	Lacrimispora saccharolytica	84030	S	23	7	30	0.00004
ERR6913182	Lacrimispora sphenoides	29370	S	20	4	24	0.00003
ERR6913182	Lacrimispora xylanolytica	29375	S	20	1	21	0.00003
ERR6913182	Enterocloster asparagiformis	333367	S	28	1	29	0.00004
ERR6913182	Enterocloster bolteae	208479	S	19	6	25	0.00004
ERR6913182	Enterocloster clostridioformis	1531	S	14	53	67	0.00010
ERR6913182	Anaerostipes hadrus	649756	S	25	5	30	0.00004
ERR6913182	Anaerostipes rhamnosivorans	1229621	S	15	2	17	0.00002
ERR6913182	Anaerostipes caccae	105841	S	13	1	14	0.00002
ERR6913182	Anaerocolumna sedimenticola	2696063	S	21	1	22	0.00003
ERR6913182	Anaerocolumna cellulosilytica	433286	S	17	1	18	0.00003
ERR6913182	Anaerocolumna chitinilytica	1727145	S	13	0	13	0.00002
ERR6913182	[Ruminococcus] gnavus	33038	S	17	8	25	0.00004
ERR6913182	[Ruminococcus] lactaris	46228	S	17	6	23	0.00003
ERR6913182	[Ruminococcus] torques	33039	S	14	10	24	0.00003
ERR6913182	Dorea longicatena	88431	S	26	13	39	0.00006
ERR6913182	Dorea formicigenerans	39486	S	16	9	25	0.00004
ERR6913182	Coprococcus eutactus	33043	S	11	3	14	0.00002
ERR6913182	Coprococcus comes	410072	S	11	6	17	0.00002
ERR6913182	Coprococcus catus	116085	S	10	3	13	0.00002
ERR6913182	Coprococcus sp. ART55/1	751585	S	8	2	10	0.00001
ERR6913182	Simiaoa sunii	2763672	S	32	11	43	0.00006
ERR6913182	Marvinbryantia formatexigens	168384	S	31	1	32	0.00005
ERR6913182	Pseudobutyrivibrio xylanivorans	185007	S	31	0	31	0.00005
ERR6913182	Lachnospira eligens	39485	S	29	6	35	0.00005
ERR6913182	Anaerobutyricum hallii	39488	S	25	6	31	0.00005
ERR6913182	[Clostridium] colinum	36835	S	18	0	18	0.00003
ERR6913182	Herbinix luporum	1679721	S	17	3	20	0.00003
ERR6913182	Faecalicatena sp. Marseille-Q4148	2823316	S	15	5	20	0.00003
ERR6913182	Qiania dongpingensis	2763669	S	15	1	16	0.00002
ERR6913182	Anaeromicropila herbilytica	2785025	S	12	0	12	0.00002
ERR6913182	Novisyntrophococcus fermenticellae	2068655	S	10	1	11	0.00002
ERR6913182	Sellimonas intestinalis	1653434	S	9	0	9	0.00001
ERR6913182	Wujia chipingensis	2763670	S	9	6	15	0.00002
ERR6913182	Anaerotignum propionicum	28446	S	7	0	7	0.00001
ERR6913182	Anaeropeptidivorans aminofermentans	2934315	S	5	0	5	0.00001
ERR6913182	Mogibacterium diversum	114527	S	919	40	959	0.00140
ERR6913182	Mogibacterium pumilum	86332	S	105	4	109	0.00016
ERR6913182	Aminipila terrae	2697030	S	13	5	18	0.00003
ERR6913182	Aminipila butyrica	433296	S	9	2	11	0.00002
ERR6913182	Aminipila luticellarii	2507160	S	5	2	7	0.00001
ERR6913182	Emergencia timonensis	1776384	S	28	0	28	0.00004
ERR6913182	Fenollaria sporofastidiosus	2811778	S	6	0	6	0.00001
ERR6913182	Massilistercora timonensis	2086584	S	9	3	12	0.00002
ERR6913182	Intestinimonas butyriciproducens	1297617	S	7	0	7	0.00001
ERR6913182	Carboxydocella thermautotrophica	178899	S	5	0	5	0.00001
ERR6913182	Flintibacter sp. KGMB00164	2610895	S	5	0	5	0.00001
ERR6913182	Clostridium sp. M62/1	411486	S	33	17	50	0.00007
ERR6913182	Clostridium sp. SY8519	1042156	S	27	1	28	0.00004
ERR6913182	Clostridium sp. MD294	97138	S	10	0	10	0.00001
ERR6913182	Clostridium sp. JN-1	2483110	S	8	0	8	0.00001
ERR6913182	Clostridium sp. DL-VIII	641107	S	7	0	7	0.00001
ERR6913182	Clostridium sp. AWRP	2212991	S	7	5	12	0.00002
ERR6913182	Clostridium sp. BNL1100	755731	S	6	0	6	0.00001
ERR6913182	Clostridium sp. BJN0001	2930219	S	6	0	6	0.00001
ERR6913182	Clostridium botulinum	1491	S	26	6	32	0.00005
ERR6913182	Clostridium perfringens	1502	S	22	65	87	0.00013
ERR6913182	Clostridium pasteurianum	1501	S	16	0	16	0.00002
ERR6913182	Clostridium estertheticum	238834	S	13	0	13	0.00002
ERR6913182	Clostridium tetani	1513	S	13	0	13	0.00002
ERR6913182	Clostridium kluyveri	1534	S	13	0	13	0.00002
ERR6913182	Clostridium novyi	1542	S	11	0	11	0.00002
ERR6913182	Clostridium taeniosporum	394958	S	9	0	9	0.00001
ERR6913182	Clostridium isatidis	182773	S	8	0	8	0.00001
ERR6913182	Clostridium saccharobutylicum	169679	S	8	0	8	0.00001
ERR6913182	Clostridium baratii	1561	S	8	0	8	0.00001
ERR6913182	Clostridium manihotivorum	2320868	S	8	0	8	0.00001
ERR6913182	Clostridium beijerinckii	1520	S	7	2	9	0.00001
ERR6913182	Clostridium chauvoei	46867	S	7	0	7	0.00001
ERR6913182	Clostridium intestinale	36845	S	7	0	7	0.00001
ERR6913182	Clostridium felsineum	36839	S	7	0	7	0.00001
ERR6913182	Clostridium argentinense	29341	S	7	0	7	0.00001
ERR6913182	Clostridium saccharoperbutylacetonicum	36745	S	7	0	7	0.00001
ERR6913182	Clostridium cadaveris	1529	S	6	0	6	0.00001
ERR6913182	Clostridium gasigenes	94869	S	6	0	6	0.00001
ERR6913182	Clostridium thermarum	1716543	S	6	0	6	0.00001
ERR6913182	Clostridium sporogenes	1509	S	6	9	15	0.00002
ERR6913182	Clostridium bornimense	1216932	S	6	0	6	0.00001
ERR6913182	Clostridium aceticum	84022	S	5	0	5	0.00001
ERR6913182	Clostridium butyricum	1492	S	5	4	9	0.00001
ERR6913182	Hungatella hathewayi	154046	S	53	5	58	0.00008
ERR6913182	Crassaminicella profunda	1286698	S	11	0	11	0.00002
ERR6913182	Crassaminicella thermophila	2599308	S	9	0	9	0.00001
ERR6913182	Caloramator sp. mosi_1	3023090	S	10	3	13	0.00002
ERR6913182	Oceanirhabdus sp. W0125-5	2999116	S	8	0	8	0.00001
ERR6913182	Paraclostridium bifermentans	1490	S	8	1	9	0.00001
ERR6913182	Hathewaya histolytica	1498	S	5	0	5	0.00001
ERR6913182	Serpentinicella alkaliphila	1734049	S	5	0	5	0.00001
ERR6913182	Faecalibacterium prausnitzii	853	S	51	37	88	0.00013
ERR6913182	Faecalibacterium sp. IP-1-18	2929488	S	6	26	32	0.00005
ERR6913182	Faecalibacterium sp. I3-3-89	2929493	S	5	1	6	0.00001
ERR6913182	Faecalibacterium sp. I4-1-79	2929494	S	5	3	8	0.00001
ERR6913182	Ruminococcus bovis	2564099	S	11	0	11	0.00002
ERR6913182	Ruminococcus bicirculans	1160721	S	8	0	8	0.00001
ERR6913182	Ruminococcus champanellensis	1161942	S	6	0	6	0.00001
ERR6913182	Acetivibrio thermocellus	1515	S	8	0	8	0.00001
ERR6913182	Acetivibrio clariflavus	288965	S	7	2	9	0.00001
ERR6913182	Acetivibrio saccincola	1677857	S	6	1	7	0.00001
ERR6913182	Caproicibacterium amylolyticum	2766537	S	7	0	7	0.00001
ERR6913182	Subdoligranulum variabile	214851	S	12	3	15	0.00002
ERR6913182	Mageeibacillus indolicus	884684	S	11	0	11	0.00002
ERR6913182	Dysosmobacter welbionis	2093857	S	6	5	11	0.00002
ERR6913182	Acutalibacter muris	1796620	S	10	0	10	0.00001
ERR6913182	Ruminiclostridium herbifermentans	2488810	S	8	1	9	0.00001
ERR6913182	Ruthenibacterium lactatiformans	1550024	S	10	1	11	0.00002
ERR6913182	Caproicibacter fermentans	2576756	S	7	0	7	0.00001
ERR6913182	Caproiciproducens sp. NJN-50	2507162	S	6	0	6	0.00001
ERR6913182	Oscillibacter hominis	2763056	S	6	1	7	0.00001
ERR6913182	Fastidiosipila sanguinis	236753	S	6	0	6	0.00001
ERR6913182	Ethanoligenens harbinense	253239	S	5	0	5	0.00001
ERR6913182	Filifactor alocis	143361	S	114	7	121	0.00018
ERR6913182	Peptostreptococcus sp. CBA3647	3003601	S	38	1	39	0.00006
ERR6913182	Clostridioides difficile	1496	S	13	11	24	0.00003
ERR6913182	Tepidibacter sp. 8C15b	2925782	S	7	0	7	0.00001
ERR6913182	Paeniclostridium sordellii	1505	S	7	1	8	0.00001
ERR6913182	Peptoclostridium acidaminophilum	1731	S	6	0	6	0.00001
ERR6913182	Peptacetobacter hiranonis	89152	S	6	0	6	0.00001
ERR6913182	Eubacterium sp. c-25	2841037	S	20	2	22	0.00003
ERR6913182	Eubacterium sp. MSJ-33	2841528	S	8	4	12	0.00002
ERR6913182	Eubacterium ventriosum	39496	S	12	4	16	0.00002
ERR6913182	Eubacterium maltosivorans	2041044	S	10	6	16	0.00002
ERR6913182	Eubacterium limosum	1736	S	9	1	10	0.00001
ERR6913182	Acetobacterium wieringae	52694	S	5	1	6	0.00001
ERR6913182	Alkalibacter rhizosphaerae	2815577	S	6	0	6	0.00001
ERR6913182	Desulfitobacterium dichloroeliminans	233055	S	8	14	22	0.00003
ERR6913182	Desulfofarcimen acetoxidans	58138	S	8	0	8	0.00001
ERR6913182	Candidatus Formimonas warabiya	1761012	S	7	0	7	0.00001
ERR6913182	Cellulosilyticum sp. WCF-2	2497860	S	6	8	14	0.00002
ERR6913182	Christensenella minuta	626937	S	9	1	10	0.00001
ERR6913182	Christensenella sp. Marseille-P3954	2086585	S	8	0	8	0.00001
ERR6913182	Vallitalea guaymasensis	1185412	S	5	3	8	0.00001
ERR6913182	Heliomicrobium modesticaldum	35701	S	5	1	6	0.00001
ERR6913182	Alkalicella caledoniensis	2731377	S	5	0	5	0.00001
ERR6913182	Thermoanaerobacterium thermosaccharolyticum	1517	S	5	4	9	0.00001
ERR6913182	Halanaerobium praevalens	2331	S	7	1	8	0.00001
ERR6913182	Halanaerobium hydrogeniformans	656519	S	5	0	5	0.00001
ERR6913182	Parvimonas micra	33033	S	252	13	265	0.00039
ERR6913182	Anaerococcus prevotii	33034	S	7	0	7	0.00001
ERR6913182	Anaerococcus vaginalis	33037	S	6	4	10	0.00001
ERR6913182	Anaerococcus mediterraneensis	1870984	S	5	0	5	0.00001
ERR6913182	Finegoldia magna	1260	S	14	0	14	0.00002
ERR6913182	Peptoniphilus harei	54005	S	5	2	7	0.00001
ERR6913182	Helcococcus kunzii	40091	S	10	0	10	0.00001
ERR6913182	Murdochiella vaginalis	1852373	S	10	0	10	0.00001
ERR6913182	Miniphocaeibacter halophilus	2931922	S	9	0	9	0.00001
ERR6913182	Keratinibaculum paraultunense	1278232	S	8	0	8	0.00001
ERR6913182	Gottschalkia acidurici	1556	S	8	0	8	0.00001
ERR6913182	Acidilutibacter cellobiosedens	2507161	S	8	0	8	0.00001
ERR6913182	Ezakiella coagulans	46507	S	16	1	17	0.00002
ERR6913182	Bulleidia sp. zg-1006	2806552	S	73	1	74	0.00011
ERR6913182	Erysipelothrix sp. A18Y020d	2929157	S	7	6	13	0.00002
ERR6913182	Longicatena caecimuris	1796635	S	12	0	12	0.00002
ERR6913182	Intestinibaculum porci	2487118	S	10	0	10	0.00001
ERR6913182	Amedibacterium intestinale	2583452	S	8	0	8	0.00001
ERR6913182	[Clostridium] innocuum	1522	S	26	1	27	0.00004
ERR6913182	Thomasclavelia spiroformis	29348	S	10	0	10	0.00001
ERR6913182	Thomasclavelia ramosa	1547	S	7	0	7	0.00001
ERR6913182	Catenibacterium mitsuokai	100886	S	9	0	9	0.00001
ERR6913182	Turicibacter sanguinis	154288	S	8	4	12	0.00002
ERR6913182	Rothia mucilaginosa	43675	S	33003	633	33636	0.04893
ERR6913182	Rothia dentocariosa	2047	S	974	34	1008	0.00147
ERR6913182	Rothia aeria	172042	S	474	11	485	0.00071
ERR6913182	Rothia nasimurium	85336	S	14	0	14	0.00002
ERR6913182	Rothia amarae	169480	S	5	0	5	0.00001
ERR6913182	Arthrobacter sp. ERGS1:01	1704044	S	10	1	11	0.00002
ERR6913182	Arthrobacter sp. zg-Y815	2964616	S	7	6	13	0.00002
ERR6913182	Arthrobacter sp. NicSoilC5	2831000	S	6	15	21	0.00003
ERR6913182	Arthrobacter sp. FB24	290399	S	5	2	7	0.00001
ERR6913182	Arthrobacter sp. Helios	2828862	S	5	0	5	0.00001
ERR6913182	Arthrobacter sp. UKPF54-2	2600159	S	5	5	10	0.00001
ERR6913182	Arthrobacter sp. zg-Y462	2886936	S	5	1	6	0.00001
ERR6913182	Arthrobacter alpinus	656366	S	12	11	23	0.00003
ERR6913182	Arthrobacter jiangjiafuii	2817475	S	5	0	5	0.00001
ERR6913182	Kocuria rhizophila	72000	S	49	13	62	0.00009
ERR6913182	Kocuria varians	1272	S	7	0	7	0.00001
ERR6913182	Glutamicibacter protophormiae	37930	S	12	1	13	0.00002
ERR6913182	Glutamicibacter sp. M10	3023076	S	7	0	7	0.00001
ERR6913182	Glutamicibacter mishrai	1775880	S	5	2	7	0.00001
ERR6913182	Pseudarthrobacter sp. L1SW	2851598	S	9	3	12	0.00002
ERR6913182	Pseudarthrobacter sp. NS4	2973976	S	6	1	7	0.00001
ERR6913182	Pseudarthrobacter phenanthrenivorans	361575	S	5	1	6	0.00001
ERR6913182	Micrococcus luteus	1270	S	16	11	27	0.00004
ERR6913182	Auritidibacter sp. NML130574	2170745	S	17	0	17	0.00002
ERR6913182	Paeniglutamicibacter sp. ZC-3	2986919	S	7	0	7	0.00001
ERR6913182	Psychromicrobium lacuslunae	1618207	S	9	0	9	0.00001
ERR6913182	Microbacterium sp. cx-55	2875948	S	8	7	15	0.00002
ERR6913182	Microbacterium sp. PAMC21962	2861280	S	5	56	61	0.00009
ERR6913182	Microbacterium sp. BH-3-3-3	1906742	S	5	10	15	0.00002
ERR6913182	Leucobacter aridicollis	283878	S	6	5	11	0.00002
ERR6913182	Leifsonia xyli	1575	S	10	2	12	0.00002
ERR6913182	Gulosibacter molinativorax	256821	S	13	2	15	0.00002
ERR6913182	Gulosibacter sediminis	1729695	S	7	1	8	0.00001
ERR6913182	Mycetocola sp. JXN-3	2116510	S	8	1	9	0.00001
ERR6913182	Clavibacter michiganensis	28447	S	5	8	13	0.00002
ERR6913182	Microterricola viridarii	412690	S	5	1	6	0.00001
ERR6913182	Brevibacterium sp. CS2	2575923	S	8	1	9	0.00001
ERR6913182	Brevibacterium sp. BRM-1	2999062	S	6	0	6	0.00001
ERR6913182	Brevibacterium aurantiacum	273384	S	10	11	21	0.00003
ERR6913182	Brevibacterium siliguriense	1136497	S	7	1	8	0.00001
ERR6913182	Brevibacterium pigmentatum	1496080	S	6	2	8	0.00001
ERR6913182	Cellulomonas sp. zg.Y338	2968084	S	5	4	9	0.00001
ERR6913182	Cellulomonas taurus	2729175	S	8	4	12	0.00002
ERR6913182	Brachybacterium sp. P6-10-X1	1903186	S	7	5	12	0.00002
ERR6913182	Brachybacterium saurashtrense	556288	S	5	1	6	0.00001
ERR6913182	Brachybacterium huguangmaarense	1652028	S	5	0	5	0.00001
ERR6913182	Brachybacterium halotolerans	2795215	S	5	7	12	0.00002
ERR6913182	Dermabacter vaginalis	1630135	S	9	2	11	0.00002
ERR6913182	Dermabacter jinjuensis	1667168	S	7	1	8	0.00001
ERR6913182	Ornithinimicrobium sp. HY006	2508882	S	5	3	8	0.00001
ERR6913182	Ornithinimicrobium sp. INDO-MA30-4	2908651	S	5	0	5	0.00001
ERR6913182	Janibacter limosus	53458	S	7	4	11	0.00002
ERR6913182	Arsenicicoccus sp. oral taxon 190	1658671	S	6	0	6	0.00001
ERR6913182	Xylanimonas allomyrinae	2509459	S	8	2	10	0.00001
ERR6913182	Georgenia sp. TF02-10	2917725	S	9	3	12	0.00002
ERR6913182	Georgenia faecalis	2483799	S	7	2	9	0.00001
ERR6913182	Georgenia yuyongxinii	2589797	S	6	1	7	0.00001
ERR6913182	Ruania alkalisoli	2779775	S	6	0	6	0.00001
ERR6913182	Ruania halotolerans	2897773	S	5	0	5	0.00001
ERR6913182	Ruania suaedae	2897774	S	5	0	5	0.00001
ERR6913182	Demequina sp. TMPB413	2881056	S	16	0	16	0.00002
ERR6913182	Dermacoccus nishinomiyaensis	1274	S	8	0	8	0.00001
ERR6913182	Dermatophilus congolensis	1863	S	5	0	5	0.00001
ERR6913182	Luteimicrobium xylanilyticum	1133546	S	9	0	9	0.00001
ERR6913182	Beutenbergia cavernae	84757	S	7	0	7	0.00001
ERR6913182	Sanguibacter keddieii	60920	S	5	0	5	0.00001
ERR6913182	Sanguibacter sp. HDW7	2714931	S	5	0	5	0.00001
ERR6913182	Kytococcus sedentarius	1276	S	8	0	8	0.00001
ERR6913182	Schaalia odontolytica	1660	S	20317	891	21208	0.03085
ERR6913182	Schaalia meyeri	52773	S	905	38	943	0.00137
ERR6913182	Schaalia sp. 19OD2882	2794089	S	82	2	84	0.00012
ERR6913182	Schaalia sp. ZJ405	2709403	S	64	0	64	0.00009
ERR6913182	Schaalia sp. JY-X169	2758572	S	10	0	10	0.00001
ERR6913182	Schaalia turicensis	131111	S	85	4	89	0.00013
ERR6913182	Schaalia cardiffensis	181487	S	58	1	59	0.00009
ERR6913182	Schaalia radingae	131110	S	24	0	24	0.00003
ERR6913182	Actinomyces pacaensis	1852377	S	3785	69	3854	0.00561
ERR6913182	Actinomyces sp. oral taxon 169	712116	S	87	60	147	0.00021
ERR6913182	Actinomyces sp. oral taxon 414	712122	S	86	4	90	0.00013
ERR6913182	Actinomyces sp. oral taxon 171	706438	S	63	16	79	0.00011
ERR6913182	Actinomyces sp. Z16	2079536	S	52	6	58	0.00008
ERR6913182	Actinomyces sp. 432	2057798	S	41	3	44	0.00006
ERR6913182	Actinomyces sp. HMT 175	2789425	S	35	60	95	0.00014
ERR6913182	Actinomyces sp. MAS-1	2755559	S	33	1	34	0.00005
ERR6913182	Actinomyces sp. Chiba101	1851395	S	19	3	22	0.00003
ERR6913182	Actinomyces sp. HMT897	2789424	S	18	39	57	0.00008
ERR6913182	Actinomyces sp. oral taxon 897	2081702	S	9	20	29	0.00004
ERR6913182	Actinomyces oris	544580	S	278	216	494	0.00072
ERR6913182	Actinomyces naeslundii	1655	S	168	25	193	0.00028
ERR6913182	Actinomyces faecalis	2722820	S	69	2	71	0.00010
ERR6913182	Actinomyces trachealis	2763540	S	67	3	70	0.00010
ERR6913182	Actinomyces respiraculi	2744574	S	47	3	50	0.00007
ERR6913182	Actinomyces howellii	52771	S	38	1	39	0.00006
ERR6913182	Actinomyces slackii	52774	S	38	1	39	0.00006
ERR6913182	Actinomyces viscosus	1656	S	31	4	35	0.00005
ERR6913182	Actinomyces weissii	675090	S	30	1	31	0.00005
ERR6913182	Actinomyces radicidentis	111015	S	30	2	32	0.00005
ERR6913182	Actinomyces qiguomingii	2057800	S	25	1	26	0.00004
ERR6913182	Actinomyces wuliandei	2057743	S	20	2	22	0.00003
ERR6913182	Actinomyces lilanjuaniae	2321394	S	15	1	16	0.00002
ERR6913182	Actinomyces procaprae	2560010	S	15	1	16	0.00002
ERR6913182	Actinomyces gaoshouyii	1960083	S	15	2	17	0.00002
ERR6913182	Actinomyces marmotae	2737173	S	11	2	13	0.00002
ERR6913182	Pauljensenia hongkongensis	178339	S	229	14	243	0.00035
ERR6913182	Trueperella pyogenes	1661	S	22	0	22	0.00003
ERR6913182	Trueperella pecoris	2733571	S	15	0	15	0.00002
ERR6913182	Trueperella bialowiezensis	312285	S	12	0	12	0.00002
ERR6913182	Arcanobacterium haemolyticum	28264	S	14	2	16	0.00002
ERR6913182	Arcanobacterium phocisimile	1302235	S	5	7	12	0.00002
ERR6913182	Arcanobacterium pinnipediorum	1503041	S	5	4	9	0.00001
ERR6913182	Varibaculum prostatecancerukia	2811781	S	30	0	30	0.00004
ERR6913182	Mobiluncus curtisii	2051	S	25	0	25	0.00004
ERR6913182	Flaviflexus salsibiostraticola	1282737	S	9	2	11	0.00002
ERR6913182	Flaviflexus equikiangi	2758573	S	6	1	7	0.00001
ERR6913182	Boudabousia tangfeifanii	1912795	S	16	0	16	0.00002
ERR6913182	Nanchangia anserum	2692125	S	16	0	16	0.00002
ERR6913182	Changpingibacter yushuensis	2758440	S	16	0	16	0.00002
ERR6913182	Winkia neuii	33007	S	14	0	14	0.00002
ERR6913182	Actinotignum schaalii	59505	S	8	0	8	0.00001
ERR6913182	Corynebacterium matruchotii	43768	S	610	10	620	0.00090
ERR6913182	Corynebacterium vitaeruminis	38305	S	20	3	23	0.00003
ERR6913182	Corynebacterium jeikeium	38289	S	19	13	32	0.00005
ERR6913182	Corynebacterium diphtheriae	1717	S	18	50	68	0.00010
ERR6913182	Corynebacterium resistens	258224	S	10	1	11	0.00002
ERR6913182	Corynebacterium coyleae	53374	S	9	0	9	0.00001
ERR6913182	Corynebacterium tuberculostearicum	38304	S	9	1	10	0.00001
ERR6913182	Corynebacterium ihumii	1232427	S	8	1	9	0.00001
ERR6913182	Corynebacterium kefirresidentii	1979527	S	8	1	9	0.00001
ERR6913182	Corynebacterium macginleyi	38290	S	8	0	8	0.00001
ERR6913182	Corynebacterium kroppenstedtii	161879	S	7	0	7	0.00001
ERR6913182	Corynebacterium singulare	161899	S	7	0	7	0.00001
ERR6913182	Corynebacterium uterequi	1072256	S	6	0	6	0.00001
ERR6913182	Corynebacterium falsenii	108486	S	6	0	6	0.00001
ERR6913182	Corynebacterium riegelii	156976	S	6	0	6	0.00001
ERR6913182	Corynebacterium ureicelerivorans	401472	S	6	0	6	0.00001
ERR6913182	Corynebacterium glaucum	187491	S	6	0	6	0.00001
ERR6913182	Corynebacterium aurimucosum	169292	S	5	0	5	0.00001
ERR6913182	Corynebacterium glucuronolyticum	39791	S	5	0	5	0.00001
ERR6913182	Corynebacterium sanguinis	2594913	S	5	1	6	0.00001
ERR6913182	Corynebacterium atypicum	191610	S	5	0	5	0.00001
ERR6913182	Corynebacterium mustelae	571915	S	5	0	5	0.00001
ERR6913182	Corynebacterium hindlerae	699041	S	5	0	5	0.00001
ERR6913182	Mycobacterium sp. Aquia_216	2991729	S	5	8	13	0.00002
ERR6913182	Mycobacterium florentinum	292462	S	6	10	16	0.00002
ERR6913182	Mycolicibacterium litorale	758802	S	5	13	18	0.00003
ERR6913182	Mycolicibacterium helvum	1534349	S	5	6	11	0.00002
ERR6913182	Mycobacteroides abscessus	36809	S	5	2	7	0.00001
ERR6913182	Mycolicibacillus koreensis	1069220	S	6	7	13	0.00002
ERR6913182	Rhodococcus sp. 75	2987751	S	5	3	8	0.00001
ERR6913182	Rhodococcus opacus	37919	S	12	35	47	0.00007
ERR6913182	Rhodococcus fascians	1828	S	6	1	7	0.00001
ERR6913182	Nocardia asteroides	1824	S	7	5	12	0.00002
ERR6913182	Nocardia brasiliensis	37326	S	5	3	8	0.00001
ERR6913182	Gordonia sp. PP30	2935861	S	7	6	13	0.00002
ERR6913182	Gordonia polyisoprenivorans	84595	S	5	2	7	0.00001
ERR6913182	Skermania piniformis	39122	S	5	1	6	0.00001
ERR6913182	Dietzia sp. oral taxon 368	712270	S	7	4	11	0.00002
ERR6913182	Cutibacterium acnes	1747	S	765	37	802	0.00117
ERR6913182	Cutibacterium avidum	33010	S	16	1	17	0.00002
ERR6913182	Cutibacterium modestum	2559073	S	9	0	9	0.00001
ERR6913182	Arachnia propionica	1750	S	68	3	71	0.00010
ERR6913182	Arachnia rubra	1547448	S	11	0	11	0.00002
ERR6913182	Tessaracoccus flavescens	399497	S	6	7	13	0.00002
ERR6913182	Vaginimicrobium propionicum	1871034	S	15	0	15	0.00002
ERR6913182	Acidipropionibacterium acidipropionici	1748	S	8	1	9	0.00001
ERR6913182	Propionibacterium freudenreichii	1744	S	6	0	6	0.00001
ERR6913182	Nocardioides sp. S5	2017486	S	5	1	6	0.00001
ERR6913182	Nocardioides sp. zg-536	2803858	S	5	1	6	0.00001
ERR6913182	Nocardioides seonyuensis	2518371	S	11	1	12	0.00002
ERR6913182	Nocardioides houyundeii	2045452	S	6	0	6	0.00001
ERR6913182	Pimelobacter simplex	2045	S	7	3	10	0.00001
ERR6913182	Kribbella qitaiheensis	1544730	S	7	0	7	0.00001
ERR6913182	Streptomyces venezuelae	54571	S	11	16	27	0.00004
ERR6913182	Streptomyces lydicus	47763	S	10	38	48	0.00007
ERR6913182	Streptomyces tubbatahanensis	2923272	S	6	2	8	0.00001
ERR6913182	Streptomyces harbinensis	1176198	S	6	3	9	0.00001
ERR6913182	Streptomyces hygroscopicus	1912	S	6	91	97	0.00014
ERR6913182	Streptomyces nigra	1827580	S	5	6	11	0.00002
ERR6913182	Streptomyces buecherae	2763006	S	5	2	7	0.00001
ERR6913182	Streptacidiphilus sp. PB12-B1b	2705012	S	5	2	7	0.00001
ERR6913182	Bifidobacterium longum	216816	S	20	40	60	0.00009
ERR6913182	Bifidobacterium thermophilum	33905	S	11	0	11	0.00002
ERR6913182	Bifidobacterium subtile	77635	S	8	0	8	0.00001
ERR6913182	Bifidobacterium pseudocatenulatum	28026	S	8	1	9	0.00001
ERR6913182	Bifidobacterium pseudolongum	1694	S	7	0	7	0.00001
ERR6913182	Bifidobacterium asteroides	1684	S	6	0	6	0.00001
ERR6913182	Bifidobacterium breve	1685	S	6	0	6	0.00001
ERR6913182	Bifidobacterium adolescentis	1680	S	5	1	6	0.00001
ERR6913182	Bifidobacterium actinocoloniiforme	638619	S	5	0	5	0.00001
ERR6913182	Gardnerella vaginalis	2702	S	11	11	22	0.00003
ERR6913182	Amycolatopsis mediterranei	33910	S	5	5	10	0.00001
ERR6913182	Amycolatopsis pretoriensis	218821	S	5	5	10	0.00001
ERR6913182	Saccharopolyspora erythraea	1836	S	6	3	9	0.00001
ERR6913182	Pseudonocardia sp. HH130630-07	1690815	S	5	2	7	0.00001
ERR6913182	Actinoplanes friuliensis	196914	S	5	2	7	0.00001
ERR6913182	Dactylosporangium roseum	47989	S	5	3	8	0.00001
ERR6913182	Phytohabitans suffuscus	624315	S	6	3	9	0.00001
ERR6913182	Actinocatenispora thailandica	227318	S	5	1	6	0.00001
ERR6913182	Thermomonospora curvata	2020	S	5	0	5	0.00001
ERR6913182	Nonomuraea sp. ATCC 55076	1909395	S	5	0	5	0.00001
ERR6913182	Candidatus Planktophila sulfonica	1884904	S	10	1	11	0.00002
ERR6913182	Candidatus Planktophila dulcis	1884914	S	6	1	7	0.00001
ERR6913182	Blastococcus saxobsidens	138336	S	5	1	6	0.00001
ERR6913182	Lancefieldella parvula	1382	S	2571	19	2590	0.00377
ERR6913182	Olsenella sp. oral taxon 807	712411	S	17	0	17	0.00002
ERR6913182	Olsenella uli	133926	S	13	0	13	0.00002
ERR6913182	Olsenella timonensis	1805478	S	7	0	7	0.00001
ERR6913182	Atopobium sp. oral taxon 416	712157	S	20	0	20	0.00003
ERR6913182	Parolsenella massiliensis	1871022	S	7	3	10	0.00001
ERR6913182	Parafannyhessea umbonata	604330	S	6	0	6	0.00001
ERR6913182	Collinsella aerofaciens	74426	S	11	3	14	0.00002
ERR6913182	Collinsella stercoris	147206	S	5	1	6	0.00001
ERR6913182	Gordonibacter urolithinfaciens	1335613	S	21	4	25	0.00004
ERR6913182	Eggerthella lenta	84112	S	11	3	14	0.00002
ERR6913182	Berryella intestinalis	1531429	S	5	0	5	0.00001
ERR6913182	Phoenicibacter congonensis	1944646	S	6	0	6	0.00001
ERR6913182	Xiamenia xianingshaonis	2682776	S	5	0	5	0.00001
ERR6913182	Conexibacter woesei	191495	S	8	0	8	0.00001
ERR6913182	Prochlorococcus marinus	1219	S	11	2	13	0.00002
ERR6913182	Gloeothece citriformis	2546356	S	6	2	8	0.00001
ERR6913182	Pleurocapsa sp. PCC 7327	118163	S	5	3	8	0.00001
ERR6913182	Haploplasma axanthum	29552	S	6	0	6	0.00001
ERR6913182	Metamycoplasma orale	2121	S	13	4	17	0.00002
ERR6913182	Metamycoplasma salivarium	2124	S	7	1	8	0.00001
ERR6913182	Metamycoplasma hominis	2098	S	5	2	7	0.00001
ERR6913182	Deinococcus aetherius	200252	S	6	0	6	0.00001
ERR6913182	Deinococcus wulumuqiensis	980427	S	5	0	5	0.00001
ERR6913182	Ktedonosporobacter rubrisoli	2509675	S	11	0	11	0.00002
ERR6913182	Phototrophicus methaneseepsis	2710758	S	6	0	6	0.00001
ERR6913182	Neisseria mucosa	488	S	32770	3193	35963	0.05232
ERR6913182	Neisseria sicca	490	S	5812	531	6343	0.00923
ERR6913182	Neisseria subflava	28449	S	3232	287	3519	0.00512
ERR6913182	Neisseria flavescens	484	S	2526	243	2769	0.00403
ERR6913182	Neisseria meningitidis	487	S	1232	563	1795	0.00261
ERR6913182	Neisseria sp. oral taxon 014	641148	S	337	10	347	0.00050
ERR6913182	Neisseria sp. KEM232	655307	S	46	0	46	0.00007
ERR6913182	Neisseria sp. ZJ785	2709396	S	46	3	49	0.00007
ERR6913182	Neisseria sp. Dent CA1/247	2912675	S	36	2	38	0.00006
ERR6913182	Neisseria sp. ZJ106	2912188	S	21	1	22	0.00003
ERR6913182	Neisseria elongata	495	S	476	11	487	0.00071
ERR6913182	Neisseria lactamica	486	S	470	65	535	0.00078
ERR6913182	Neisseria macacae	496	S	337	46	383	0.00056
ERR6913182	Neisseria cinerea	483	S	295	17	312	0.00045
ERR6913182	Neisseria gonorrhoeae	485	S	176	20	196	0.00029
ERR6913182	Neisseria brasiliensis	2666100	S	52	1	53	0.00008
ERR6913182	Neisseria animaloris	326522	S	44	0	44	0.00006
ERR6913182	Neisseria chenwenguii	1853278	S	39	0	39	0.00006
ERR6913182	Neisseria bacilliformis	267212	S	38	0	38	0.00006
ERR6913182	Neisseria weixii	1853276	S	32	0	32	0.00005
ERR6913182	Neisseria musculi	1815583	S	31	0	31	0.00005
ERR6913182	Neisseria zalophi	640030	S	30	0	30	0.00004
ERR6913182	Neisseria animalis	492	S	25	0	25	0.00004
ERR6913182	Neisseria dentiae	194197	S	24	0	24	0.00003
ERR6913182	Neisseria arctica	1470200	S	23	0	23	0.00003
ERR6913182	Neisseria weaveri	28091	S	22	0	22	0.00003
ERR6913182	Neisseria canis	493	S	17	0	17	0.00002
ERR6913182	Neisseria zoodegmatis	326523	S	13	1	14	0.00002
ERR6913182	Neisseria wadsworthii	607711	S	11	0	11	0.00002
ERR6913182	Neisseria dumasiana	1931275	S	10	0	10	0.00001
ERR6913182	Neisseria shayeganii	607712	S	7	0	7	0.00001
ERR6913182	Simonsiella muelleri	72	S	1194	11	1205	0.00175
ERR6913182	Eikenella corrodens	539	S	422	11	433	0.00063
ERR6913182	Eikenella exigua	2528037	S	67	2	69	0.00010
ERR6913182	Kingella kingae	504	S	216	1	217	0.00032
ERR6913182	Kingella oralis	505	S	152	0	152	0.00022
ERR6913182	Kingella denitrificans	502	S	72	1	73	0.00011
ERR6913182	Kingella potus	265175	S	10	0	10	0.00001
ERR6913182	Morococcus cerebrosus	1056807	S	380	45	425	0.00062
ERR6913182	Wielerella bovis	2917790	S	258	1	259	0.00038
ERR6913182	Alysiella crassa	153491	S	81	4	85	0.00012
ERR6913182	Alysiella filiformis	194196	S	67	4	71	0.00010
ERR6913182	Conchiformibius steedae	153493	S	17	0	17	0.00002
ERR6913182	Uruburuella testudinis	1282863	S	9	0	9	0.00001
ERR6913182	Uruburuella suis	252130	S	6	0	6	0.00001
ERR6913182	Vitreoscilla massiliensis	1689272	S	5	6	11	0.00002
ERR6913182	Snodgrassella alvi	1196083	S	10	0	10	0.00001
ERR6913182	Paralysiella testudinis	2809020	S	7	0	7	0.00001
ERR6913182	Chitinolyticbacter meiyuanensis	682798	S	5	0	5	0.00001
ERR6913182	Burkholderia gladioli	28095	S	9	8	17	0.00002
ERR6913182	Burkholderia glumae	337	S	5	8	13	0.00002
ERR6913182	Cupriavidus pauculus	82633	S	37	30	67	0.00010
ERR6913182	Lautropia mirabilis	47671	S	70	5	75	0.00011
ERR6913182	Polynucleobacter necessarius	576610	S	6	6	12	0.00002
ERR6913182	Paraburkholderia graminis	60548	S	5	9	14	0.00002
ERR6913182	Acidovorax sp. KKS102	358220	S	5	3	8	0.00001
ERR6913182	Acidovorax temperans	80878	S	18	9	27	0.00004
ERR6913182	Acidovorax radicis	758826	S	6	1	7	0.00001
ERR6913182	Variovorax sp. PAMC26660	2762322	S	5	8	13	0.00002
ERR6913182	Variovorax paradoxus	34073	S	14	8	22	0.00003
ERR6913182	Comamonas kerstersii	225992	S	7	2	9	0.00001
ERR6913182	Comamonas aquatica	225991	S	5	2	7	0.00001
ERR6913182	Hydrogenophaga sp. NH-16	2184519	S	6	7	13	0.00002
ERR6913182	Ottowia sp. oral taxon 894	1658672	S	11	0	11	0.00002
ERR6913182	Ottowia oryzae	2109914	S	6	1	7	0.00001
ERR6913182	Rhodoferax antarcticus	81479	S	10	0	10	0.00001
ERR6913182	Alicycliphilus denitrificans	179636	S	7	12	19	0.00003
ERR6913182	Ramlibacter tataouinensis	94132	S	6	1	7	0.00001
ERR6913182	Curvibacter sp. AEP1-3	1844971	S	6	0	6	0.00001
ERR6913182	Janthinobacterium sp. HH102	1537274	S	6	6	12	0.00002
ERR6913182	Janthinobacterium sp. 1_2014MBL_MicDiv	1644131	S	6	1	7	0.00001
ERR6913182	Janthinobacterium sp. PAMC25594	2861284	S	6	3	9	0.00001
ERR6913182	Janthinobacterium sp. LM6	1938606	S	5	2	7	0.00001
ERR6913182	Janthinobacterium agaricidamnosum	55508	S	5	2	7	0.00001
ERR6913182	Janthinobacterium svalbardensis	368607	S	5	2	7	0.00001
ERR6913182	Massilia sp. DM-R-R2A-13	2899220	S	7	7	14	0.00002
ERR6913182	Duganella dendranthematis	2728021	S	5	1	6	0.00001
ERR6913182	Collimonas fungivorans	158899	S	26	7	33	0.00005
ERR6913182	Collimonas arenae	279058	S	7	1	8	0.00001
ERR6913182	Undibacterium parvum	401471	S	5	0	5	0.00001
ERR6913182	Achromobacter xylosoxidans	85698	S	6	7	13	0.00002
ERR6913182	Taylorella equigenitalis	29575	S	7	0	7	0.00001
ERR6913182	Schlegelella aquatica	376175	S	34	7	41	0.00006
ERR6913182	Aquincola tertiaricarbonis	391953	S	7	1	8	0.00001
ERR6913182	Caldimonas thermodepolymerans	215580	S	5	1	6	0.00001
ERR6913182	Inhella inkyongensis	392593	S	5	0	5	0.00001
ERR6913182	Paucibacter sp. KCTC 42545	1768242	S	5	0	5	0.00001
ERR6913182	Ferribacterium limneticum	76259	S	7	4	11	0.00002
ERR6913182	Haemophilus parainfluenzae	729	S	30211	1274	31485	0.04580
ERR6913182	Haemophilus haemolyticus	726	S	1440	209	1649	0.00240
ERR6913182	Haemophilus influenzae	727	S	553	279	832	0.00121
ERR6913182	Haemophilus sp. oral taxon 036	712310	S	158	28	186	0.00027
ERR6913182	Haemophilus pittmaniae	249188	S	138	3	141	0.00021
ERR6913182	Haemophilus parahaemolyticus	735	S	40	0	40	0.00006
ERR6913182	Aggregatibacter sp. 2125159857	2820817	S	1280	115	1395	0.00203
ERR6913182	Aggregatibacter sp. oral taxon 513	712150	S	216	50	266	0.00039
ERR6913182	Aggregatibacter sp. Marseille-P9115	2866570	S	180	36	216	0.00031
ERR6913182	Aggregatibacter aphrophilus	732	S	424	37	461	0.00067
ERR6913182	Aggregatibacter actinomycetemcomitans	714	S	174	7	181	0.00026
ERR6913182	Aggregatibacter segnis	739	S	171	31	202	0.00029
ERR6913182	Pasteurella multocida	747	S	45	8	53	0.00008
ERR6913182	Pasteurella canis	753	S	6	0	6	0.00001
ERR6913182	Mannheimia varigena	85404	S	7	4	11	0.00002
ERR6913182	Mannheimia haemolytica	75985	S	6	1	7	0.00001
ERR6913182	Avibacterium sp. 20-132	2911526	S	7	3	10	0.00001
ERR6913182	Avibacterium paragallinarum	728	S	7	1	8	0.00001
ERR6913182	Actinobacillus pleuropneumoniae	715	S	6	2	8	0.00001
ERR6913182	Actinobacillus sp. GY-402	2774188	S	5	0	5	0.00001
ERR6913182	Rodentibacter haemolyticus	2778911	S	10	0	10	0.00001
ERR6913182	Rodentibacter heylii	1906744	S	8	0	8	0.00001
ERR6913182	Vibrio kanaloae	170673	S	811	286	1097	0.00160
ERR6913182	Vibrio plantisponsor	664643	S	436	19	455	0.00066
ERR6913182	Vibrio alginolyticus	663	S	9	25	34	0.00005
ERR6913182	Vibrio parahaemolyticus	670	S	9	1	10	0.00001
ERR6913182	Vibrio diabolicus	50719	S	6	8	14	0.00002
ERR6913182	Vibrio toranzoniae	1194427	S	26	10	36	0.00005
ERR6913182	Vibrio sp. SCSIO 43136	2819101	S	6	1	7	0.00001
ERR6913182	Vibrio ziniensis	2711221	S	23	0	23	0.00003
ERR6913182	Vibrio cholerae	666	S	21	11	32	0.00005
ERR6913182	Vibrio cyclitrophicus	47951	S	10	3	13	0.00002
ERR6913182	Vibrio fluvialis	676	S	8	5	13	0.00002
ERR6913182	Vibrio crassostreae	246167	S	8	3	11	0.00002
ERR6913182	Vibrio furnissii	29494	S	6	0	6	0.00001
ERR6913182	Vibrio gallaecicus	552386	S	5	0	5	0.00001
ERR6913182	Vibrio gigantis	296199	S	5	1	6	0.00001
ERR6913182	Pseudoalteromonas prydzensis	182141	S	527	31	558	0.00081
ERR6913182	Pseudoalteromonas rhizosphaerae	2518973	S	143	12	155	0.00023
ERR6913182	Pseudoalteromonas sp. KAN5	2916633	S	9	20	29	0.00004
ERR6913182	Pseudoalteromonas sp. DL-6	1390185	S	9	10	19	0.00003
ERR6913182	Pseudoalteromonas sp. SCSIO 43088	2822846	S	6	3	9	0.00001
ERR6913182	Pseudoalteromonas mariniglutinosa	206042	S	16	16	32	0.00005
ERR6913182	Pseudoalteromonas tunicata	314281	S	11	0	11	0.00002
ERR6913182	Pseudoalteromonas aliena	247523	S	9	1	10	0.00001
ERR6913182	Pseudoalteromonas xiamenensis	882626	S	7	0	7	0.00001
ERR6913182	Pseudoalteromonas issachenkonii	152297	S	7	24	31	0.00005
ERR6913182	Pseudoalteromonas espejiana	28107	S	5	0	5	0.00001
ERR6913182	Pseudoalteromonas lipolytica	570156	S	5	18	23	0.00003
ERR6913182	Pseudoalteromonas piscicida	43662	S	5	2	7	0.00001
ERR6913182	Pseudoalteromonas phenolica	161398	S	5	0	5	0.00001
ERR6913182	Shewanella baltica	62322	S	5	23	28	0.00004
ERR6913182	Alteromonas macleodii	28108	S	12	1	13	0.00002
ERR6913182	Glaciecola nitratireducens	300231	S	6	0	6	0.00001
ERR6913182	Thalassomonas actiniarum	485447	S	6	2	8	0.00001
ERR6913182	Idiomarina loihiensis	135577	S	15	1	16	0.00002
ERR6913182	Idiomarina sp. OT37-5b	2100422	S	5	0	5	0.00001
ERR6913182	Klebsiella pneumoniae	573	S	18	59	77	0.00011
ERR6913182	Klebsiella aerogenes	548	S	5	0	5	0.00001
ERR6913182	Klebsiella quasipneumoniae	1463165	S	5	2	7	0.00001
ERR6913182	Enterobacter cloacae	550	S	5	19	24	0.00003
ERR6913182	Pluralibacter gergoviae	61647	S	32	1	33	0.00005
ERR6913182	Escherichia coli	562	S	16	39	55	0.00008
ERR6913182	Citrobacter freundii	546	S	5	11	16	0.00002
ERR6913182	Salmonella enterica	28901	S	16	51	67	0.00010
ERR6913182	Lelliottia amnigena	61646	S	8	0	8	0.00001
ERR6913182	Scandinavium goeteborgense	1851514	S	6	0	6	0.00001
ERR6913182	Plesiomonas shigelloides	703	S	5	0	5	0.00001
ERR6913182	Proteus mirabilis	584	S	7	5	12	0.00002
ERR6913182	Proteus hauseri	183417	S	5	4	9	0.00001
ERR6913182	Providencia rettgeri	587	S	8	8	16	0.00002
ERR6913182	Xenorhabdus nematophila	628	S	5	0	5	0.00001
ERR6913182	Xenorhabdus hominickii	351679	S	5	0	5	0.00001
ERR6913182	Morganella morganii	582	S	12	0	12	0.00002
ERR6913182	[Pantoea] beijingensis	1324864	S	6	9	15	0.00002
ERR6913182	Candidatus Erwinia haradaeae	1922217	S	5	0	5	0.00001
ERR6913182	Buchnera aphidicola	9	S	14	0	14	0.00002
ERR6913182	Serratia marcescens	615	S	7	8	15	0.00002
ERR6913182	Serratia fonticola	47917	S	5	3	8	0.00001
ERR6913182	Pectobacterium carotovorum	554	S	5	18	23	0.00003
ERR6913182	Edwardsiella tarda	636	S	6	2	8	0.00001
ERR6913182	Pseudomonas sp. BW7P1	2973088	S	5	30	35	0.00005
ERR6913182	Pseudomonas fluorescens	294	S	27	35	62	0.00009
ERR6913182	Pseudomonas putida	303	S	30	49	79	0.00011
ERR6913182	Pseudomonas viridiflava	33069	S	7	2	9	0.00001
ERR6913182	Pseudomonas aeruginosa	287	S	6	48	54	0.00008
ERR6913182	Pseudomonas furukawaii	1149133	S	5	0	5	0.00001
ERR6913182	Pseudomonas mendocina	300	S	5	4	9	0.00001
ERR6913182	Pseudomonas saudiphocaensis	1499686	S	6	0	6	0.00001
ERR6913182	Pseudomonas psychrotolerans	237610	S	5	1	6	0.00001
ERR6913182	Stutzerimonas stutzeri	316	S	6	2	8	0.00001
ERR6913182	Xanthomonas campestris	339	S	231	81	312	0.00045
ERR6913182	Stenotrophomonas maltophilia	40324	S	25	11	36	0.00005
ERR6913182	Lysobacter enzymogenes	69	S	5	5	10	0.00001
ERR6913182	Acinetobacter nosocomialis	106654	S	9	2	11	0.00002
ERR6913182	Acinetobacter baumannii	470	S	8	34	42	0.00006
ERR6913182	Acinetobacter pittii	48296	S	6	5	11	0.00002
ERR6913182	Acinetobacter junii	40215	S	8	1	9	0.00001
ERR6913182	Acinetobacter indicus	756892	S	7	0	7	0.00001
ERR6913182	Acinetobacter johnsonii	40214	S	6	7	13	0.00002
ERR6913182	Acinetobacter portensis	1839785	S	6	1	7	0.00001
ERR6913182	Acinetobacter piscicola	2006115	S	6	0	6	0.00001
ERR6913182	Psychrobacter sanguinis	861445	S	5	1	6	0.00001
ERR6913182	Moraxella osloensis	34062	S	8	2	10	0.00001
ERR6913182	Halomonas sp. GT	1971364	S	5	7	12	0.00002
ERR6913182	Halomonas campaniensis	213554	S	6	26	32	0.00005
ERR6913182	Marinomonas mediterranea	119864	S	5	2	7	0.00001
ERR6913182	Bermanella marisrubri	207949	S	6	0	6	0.00001
ERR6913182	Aeromonas salmonicida	645	S	10	4	14	0.00002
ERR6913182	Aeromonas veronii	654	S	5	18	23	0.00003
ERR6913182	Thiocapsa bogorovii	521689	S	5	0	5	0.00001
ERR6913182	Halothiobacillus sp. LS2	1860122	S	6	0	6	0.00001
ERR6913182	Saccharophagus degradans	86304	S	6	1	7	0.00001
ERR6913182	Spongiibacter taiwanensis	1748242	S	5	0	5	0.00001
ERR6913182	Legionella hackeliae	449	S	5	0	5	0.00001
ERR6913182	Legionella pneumophila	446	S	5	0	5	0.00001
ERR6913182	Candidatus Azoamicus ciliaticola	2652803	S	10	0	10	0.00001
ERR6913182	Cardiobacterium hominis	2718	S	11	0	11	0.00002
ERR6913182	Cardiobacterium sp. Marseille-Q4385	2866573	S	6	0	6	0.00001
ERR6913182	Frischella perrara	1267021	S	5	1	6	0.00001
ERR6913182	Solimonas sp. K1W22B-7	2303331	S	5	0	5	0.00001
ERR6913182	Bradyrhizobium sp. CCBAU 051011	858422	S	5	5	10	0.00001
ERR6913182	Bradyrhizobium diazoefficiens	1355477	S	5	23	28	0.00004
ERR6913182	Bradyrhizobium quebecense	2748629	S	5	11	16	0.00002
ERR6913182	Rhodopseudomonas palustris	1076	S	6	3	9	0.00001
ERR6913182	Rhodopseudomonas sp. P2A-2r	2991972	S	5	2	7	0.00001
ERR6913182	Rhizobium leguminosarum	384	S	8	21	29	0.00004
ERR6913182	Agrobacterium tumefaciens	358	S	5	7	12	0.00002
ERR6913182	Pararhizobium sp. BT-229	2986923	S	6	2	8	0.00001
ERR6913182	Sinorhizobium fredii	380	S	6	18	24	0.00003
ERR6913182	Mesorhizobium sp. Pch-S	2082387	S	5	19	24	0.00003
ERR6913182	Devosia sp. A16	1736675	S	6	1	7	0.00001
ERR6913182	Candidatus Hodgkinia cicadicola	573658	S	5	0	5	0.00001
ERR6913182	Sphingomonas sp. AAP5	1523415	S	5	5	10	0.00001
ERR6913182	Sphingomonas hengshuiensis	1609977	S	9	4	13	0.00002
ERR6913182	Sphingomonas hankookensis	563996	S	9	13	22	0.00003
ERR6913182	Sphingomonas aerolata	185951	S	5	2	7	0.00001
ERR6913182	Sphingobium sp. YG1	2082188	S	5	9	14	0.00002
ERR6913182	Sphingobium yanoikuyae	13690	S	8	32	40	0.00006
ERR6913182	Pseudosulfitobacter sp. DSM 107133	2883100	S	5	17	22	0.00003
ERR6913182	Thalassobacter stenotrophicus	266809	S	5	1	6	0.00001
ERR6913182	Paracoccus kondratievae	135740	S	5	7	12	0.00002
ERR6913182	Rhodospirillum centenum	34018	S	7	2	9	0.00001
ERR6913182	Caulobacter sp. NIBR1757	3016000	S	5	3	8	0.00001
ERR6913182	Hydrogenophilus thermoluteolus	297	S	16	0	16	0.00002
ERR6913182	Prevotella melaninogenica	28132	S	35664	2673	38337	0.05577
ERR6913182	Prevotella jejuni	1177574	S	6950	625	7575	0.01102
ERR6913182	Prevotella scopos	589437	S	4090	464	4554	0.00663
ERR6913182	Prevotella sp. oral taxon 299	652716	S	3249	85	3334	0.00485
ERR6913182	Prevotella sp. oral taxon 475	712471	S	279	5	284	0.00041
ERR6913182	Prevotella sp. Rep29	2691580	S	72	3	75	0.00011
ERR6913182	Prevotella sp. E13-17	2913616	S	56	10	66	0.00010
ERR6913182	Prevotella sp. E9-3	2913621	S	49	8	57	0.00008
ERR6913182	Prevotella sp. E15-22	2937774	S	28	10	38	0.00006
ERR6913182	Prevotella sp. E2-28	2913620	S	19	5	24	0.00003
ERR6913182	Prevotella veroralis	28137	S	3717	200	3917	0.00570
ERR6913182	Prevotella intermedia	28131	S	1673	170	1843	0.00268
ERR6913182	Prevotella nigrescens	28133	S	1204	208	1412	0.00205
ERR6913182	Prevotella histicola	470565	S	1011	34	1045	0.00152
ERR6913182	Prevotella oris	28135	S	772	23	795	0.00116
ERR6913182	Prevotella denticola	28129	S	441	38	479	0.00070
ERR6913182	Prevotella fusca	589436	S	367	18	385	0.00056
ERR6913182	Prevotella corporis	28128	S	175	9	184	0.00027
ERR6913182	Prevotella dentalis	52227	S	132	4	136	0.00020
ERR6913182	Prevotella multiformis	282402	S	99	9	108	0.00016
ERR6913182	Prevotella copri	165179	S	81	1	82	0.00012
ERR6913182	Prevotella ruminicola	839	S	60	0	60	0.00009
ERR6913182	Prevotella bryantii	77095	S	56	0	56	0.00008
ERR6913182	Prevotella herbatica	2801997	S	43	0	43	0.00006
ERR6913182	Hoylesella buccalis	28127	S	162	108	270	0.00039
ERR6913182	Hoylesella enoeca	76123	S	134	9	143	0.00021
ERR6913182	Pseudoprevotella muciniphila	2133944	S	150	0	150	0.00022
ERR6913182	Paraprevotella xylaniphila	454155	S	49	3	52	0.00008
ERR6913182	Tannerella serpentiformis	712710	S	3794	26	3820	0.00556
ERR6913182	Tannerella forsythia	28112	S	145	14	159	0.00023
ERR6913182	Parabacteroides merdae	46503	S	36	7	43	0.00006
ERR6913182	Parabacteroides distasonis	823	S	21	35	56	0.00008
ERR6913182	Parabacteroides johnsonii	387661	S	17	2	19	0.00003
ERR6913182	Parabacteroides faecis	1217282	S	12	0	12	0.00002
ERR6913182	Parabacteroides goldsteinii	328812	S	10	0	10	0.00001
ERR6913182	Porphyromonas sp. oral taxon 275	712435	S	1998	16	2014	0.00293
ERR6913182	Porphyromonas endodontalis	28124	S	343	14	357	0.00052
ERR6913182	Porphyromonas gingivalis	837	S	281	43	324	0.00047
ERR6913182	Porphyromonas somerae	322095	S	103	5	108	0.00016
ERR6913182	Porphyromonas cangingivalis	36874	S	58	2	60	0.00009
ERR6913182	Porphyromonas asaccharolytica	28123	S	38	1	39	0.00006
ERR6913182	Porphyromonas crevioricanis	393921	S	29	0	29	0.00004
ERR6913182	Bacteroides thetaiotaomicron	818	S	47	13	60	0.00009
ERR6913182	Bacteroides heparinolyticus	28113	S	44	9	53	0.00008
ERR6913182	Bacteroides fragilis	817	S	36	32	68	0.00010
ERR6913182	Bacteroides eggerthii	28111	S	34	7	41	0.00006
ERR6913182	Bacteroides stercoris	46506	S	33	6	39	0.00006
ERR6913182	Bacteroides helcogenes	290053	S	28	0	28	0.00004
ERR6913182	Bacteroides zoogleoformans	28119	S	24	5	29	0.00004
ERR6913182	Bacteroides salyersiae	291644	S	19	1	20	0.00003
ERR6913182	Bacteroides intestinalis	329854	S	19	3	22	0.00003
ERR6913182	Bacteroides uniformis	820	S	19	27	46	0.00007
ERR6913182	Bacteroides zhangwenhongii	2650157	S	18	5	23	0.00003
ERR6913182	Bacteroides faecium	2715212	S	14	1	15	0.00002
ERR6913182	Bacteroides xylanisolvens	371601	S	13	28	41	0.00006
ERR6913182	Bacteroides faecis	674529	S	13	5	18	0.00003
ERR6913182	Bacteroides nordii	291645	S	12	0	12	0.00002
ERR6913182	Bacteroides cellulosilyticus	246787	S	11	9	20	0.00003
ERR6913182	Bacteroides caccae	47678	S	11	4	15	0.00002
ERR6913182	Bacteroides ovatus	28116	S	11	47	58	0.00008
ERR6913182	Bacteroides coprosuis	151276	S	8	0	8	0.00001
ERR6913182	Bacteroides caecimuris	1796613	S	6	3	9	0.00001
ERR6913182	Phocaeicola salanitronis	376805	S	35	1	36	0.00005
ERR6913182	Phocaeicola coprophilus	387090	S	27	5	32	0.00005
ERR6913182	Phocaeicola vulgatus	821	S	22	18	40	0.00006
ERR6913182	Phocaeicola dorei	357276	S	15	11	26	0.00004
ERR6913182	Alistipes communis	2585118	S	27	3	30	0.00004
ERR6913182	Alistipes megaguti	2364787	S	21	1	22	0.00003
ERR6913182	Alistipes dispar	2585119	S	21	2	23	0.00003
ERR6913182	Alistipes onderdonkii	328813	S	20	6	26	0.00004
ERR6913182	Alistipes shahii	328814	S	19	9	28	0.00004
ERR6913182	Alistipes senegalensis	1288121	S	12	2	14	0.00002
ERR6913182	Alistipes indistinctus	626932	S	11	0	11	0.00002
ERR6913182	Alistipes ihumii	1470347	S	9	0	9	0.00001
ERR6913182	Alistipes finegoldii	214856	S	8	4	12	0.00002
ERR6913182	Alistipes sp. dk3624	2662363	S	7	0	7	0.00001
ERR6913182	Duncaniella dubosii	2518971	S	25	9	34	0.00005
ERR6913182	Muribaculum gordoncarteri	2530390	S	22	2	24	0.00003
ERR6913182	Muribaculum intestinale	1796646	S	21	1	22	0.00003
ERR6913182	Sodaliphilus pleomorphus	2606626	S	18	0	18	0.00003
ERR6913182	Proteiniphilum saccharofermentans	1642647	S	18	1	19	0.00003
ERR6913182	Proteiniphilum propionicum	2829812	S	6	0	6	0.00001
ERR6913182	Dysgonomonas sp. HDW5A	2714926	S	5	12	17	0.00002
ERR6913182	Petrimonas mucosa	1642646	S	18	3	21	0.00003
ERR6913182	Barnesiella viscericola	397865	S	41	2	43	0.00006
ERR6913182	Coprobacter secundus	1501392	S	14	0	14	0.00002
ERR6913182	Butyricimonas virosa	544645	S	11	0	11	0.00002
ERR6913182	Odoribacter splanchnicus	28118	S	10	0	10	0.00001
ERR6913182	Paludibacter propionicigenes	185300	S	13	0	13	0.00002
ERR6913182	Draconibacterium halophilum	2706887	S	9	1	10	0.00001
ERR6913182	Maribellus comscasis	2681766	S	6	0	6	0.00001
ERR6913182	Capnocytophaga sp. FDAARGOS_737	2545799	S	2657	338	2995	0.00436
ERR6913182	Capnocytophaga sp. oral taxon 878	1316596	S	214	10	224	0.00033
ERR6913182	Capnocytophaga sp. oral taxon 323	1705617	S	23	17	40	0.00006
ERR6913182	Capnocytophaga sp. oral taxon 864	1316593	S	18	12	30	0.00004
ERR6913182	Capnocytophaga sp. oral taxon 902	2748316	S	15	17	32	0.00005
ERR6913182	Capnocytophaga leadbetteri	327575	S	2502	314	2816	0.00410
ERR6913182	Capnocytophaga gingivalis	1017	S	2382	43	2425	0.00353
ERR6913182	Capnocytophaga sputigena	1019	S	386	26	412	0.00060
ERR6913182	Capnocytophaga ochracea	1018	S	140	59	199	0.00029
ERR6913182	Capnocytophaga endodontalis	2708117	S	83	9	92	0.00013
ERR6913182	Capnocytophaga haemolytica	45243	S	15	0	15	0.00002
ERR6913182	Capnocytophaga stomatis	1848904	S	10	0	10	0.00001
ERR6913182	Capnocytophaga canimorsus	28188	S	8	0	8	0.00001
ERR6913182	Flavobacterium sp. N2013	2986828	S	9	3	12	0.00002
ERR6913182	Flavobacterium sp. Sr18	935222	S	7	4	11	0.00002
ERR6913182	Flavobacterium sp. N3904	2986835	S	7	5	12	0.00002
ERR6913182	Flavobacterium sp. IMCC36792	3016339	S	6	3	9	0.00001
ERR6913182	Flavobacterium sp. MFBS3-15	2989816	S	6	0	6	0.00001
ERR6913182	Flavobacterium sp. KK2020170	2830782	S	5	1	6	0.00001
ERR6913182	Flavobacterium sp. CS20	2775246	S	5	0	5	0.00001
ERR6913182	Flavobacterium sp. I3-2	2748319	S	5	1	6	0.00001
ERR6913182	Flavobacterium sp. IMCC34774	3003257	S	5	1	6	0.00001
ERR6913182	Flavobacterium sp. CJ74	2294119	S	5	0	5	0.00001
ERR6913182	Flavobacterium ammoniigenes	1751095	S	8	2	10	0.00001
ERR6913182	Flavobacterium ammonificans	1751056	S	8	2	10	0.00001
ERR6913182	Flavobacterium crocinum	2183896	S	8	5	13	0.00002
ERR6913182	Flavobacterium arcticum	1784713	S	6	0	6	0.00001
ERR6913182	Flavobacterium crassostreae	1763534	S	5	0	5	0.00001
ERR6913182	Polaribacter sp. MED152	313598	S	7	2	9	0.00001
ERR6913182	Polaribacter sp. Q13	2806551	S	7	9	16	0.00002
ERR6913182	Polaribacter sp. SA4-10	754397	S	5	2	7	0.00001
ERR6913182	Gramella salexigens	1913577	S	7	0	7	0.00001
ERR6913182	Gramella flava	1486245	S	5	0	5	0.00001
ERR6913182	Gramella fulva	2126553	S	5	0	5	0.00001
ERR6913182	Nonlabens marinus	930802	S	5	3	8	0.00001
ERR6913182	Tenacibaculum ovolyticum	104270	S	6	1	7	0.00001
ERR6913182	Cellulophaga lytica	979	S	5	4	9	0.00001
ERR6913182	Muricauda oceani	2698672	S	5	0	5	0.00001
ERR6913182	Aquimarina sp. AD10	1714849	S	5	0	5	0.00001
ERR6913182	Zunongwangia sp. SCSIO 43204	2779359	S	5	2	7	0.00001
ERR6913182	Antarcticibacterium flavum	2058175	S	7	0	7	0.00001
ERR6913182	Zhouia spongiae	2202721	S	8	0	8	0.00001
ERR6913182	Kordia sp. SMS9	2282170	S	5	0	5	0.00001
ERR6913182	Dokdonia sp. MED134	313590	S	5	0	5	0.00001
ERR6913182	Seonamhaeicola sp. ML3	2937786	S	5	0	5	0.00001
ERR6913182	Sabulilitoribacter sp. BrNp1-15	2916754	S	6	0	6	0.00001
ERR6913182	Aequorivita sublithincola	101385	S	5	1	6	0.00001
ERR6913182	Chryseobacterium sp. KACC 21268	3025664	S	6	1	7	0.00001
ERR6913182	Chryseobacterium sp. CY350	2997336	S	5	5	10	0.00001
ERR6913182	Chryseobacterium sp. ZHDP1	2838877	S	5	16	21	0.00003
ERR6913182	Chryseobacterium sp. SNU WT5	2594269	S	5	2	7	0.00001
ERR6913182	Chryseobacterium indologenes	253	S	13	13	26	0.00004
ERR6913182	Chryseobacterium taklimakanense	536441	S	9	5	14	0.00002
ERR6913182	Chryseobacterium manosquense	2754694	S	8	9	17	0.00002
ERR6913182	Chryseobacterium salivictor	2547600	S	7	1	8	0.00001
ERR6913182	Chryseobacterium daecheongense	192389	S	6	3	9	0.00001
ERR6913182	Chryseobacterium piperi	558152	S	6	1	7	0.00001
ERR6913182	Chryseobacterium shandongense	1493872	S	5	5	10	0.00001
ERR6913182	Chryseobacterium paludis	2956784	S	5	1	6	0.00001
ERR6913182	Chryseobacterium arthrosphaerae	651561	S	5	4	9	0.00001
ERR6913182	Chryseobacterium turcicum	2898076	S	5	6	11	0.00002
ERR6913182	Kaistella antarctica	266748	S	9	0	9	0.00001
ERR6913182	Kaistella jeonii	266749	S	8	0	8	0.00001
ERR6913182	Kaistella flava (ex Peng et al. 2021)	2038776	S	6	1	7	0.00001
ERR6913182	Epilithonimonas vandammei	2487072	S	7	6	13	0.00002
ERR6913182	Elizabethkingia meningoseptica	238	S	9	6	15	0.00002
ERR6913182	Cloacibacterium caeni	2004710	S	5	12	17	0.00002
ERR6913182	Riemerella anatipestifer	34085	S	18	1	19	0.00003
ERR6913182	Bergeyella cardium	1585976	S	13	0	13	0.00002
ERR6913182	Empedobacter falsenii	343874	S	5	0	5	0.00001
ERR6913182	Ornithobacterium rhinotracheale	28251	S	6	0	6	0.00001
ERR6913182	Cruoricaptor ignavus	1118202	S	6	1	7	0.00001
ERR6913182	Blattabacterium cuenoti	1653831	S	9	2	11	0.00002
ERR6913182	Hymenobacter sp. BT18	2835648	S	8	3	11	0.00002
ERR6913182	Hymenobacter sp. 5420S-77	2932254	S	7	1	8	0.00001
ERR6913182	Hymenobacter sp. BRD67	2675877	S	6	13	19	0.00003
ERR6913182	Hymenobacter sp. BRD128	2675878	S	6	2	8	0.00001
ERR6913182	Hymenobacter sp. PAMC 26628	1484118	S	5	3	8	0.00001
ERR6913182	Hymenobacter sp. 5413J-13	2932251	S	5	2	7	0.00001
ERR6913182	Hymenobacter tibetensis	497967	S	9	2	11	0.00002
ERR6913182	Hymenobacter psoromatis	1484116	S	6	1	7	0.00001
ERR6913182	Pontibacter sp. XAAS-72	2592049	S	6	1	7	0.00001
ERR6913182	Rufibacter radiotolerans	1379910	S	8	0	8	0.00001
ERR6913182	Spirosoma aerolatum	1211326	S	7	1	8	0.00001
ERR6913182	Spirosoma rigui	564064	S	5	1	6	0.00001
ERR6913182	Aquirufa lenticrescens	2696560	S	5	3	8	0.00001
ERR6913182	Rhodocytophaga rosea	2704465	S	8	0	8	0.00001
ERR6913182	Dyadobacter fermentans	94254	S	9	0	9	0.00001
ERR6913182	Fibrella sp. ES10-3-2-2	1834519	S	6	0	6	0.00001
ERR6913182	Marinilongibacter aquaticus	2975157	S	5	0	5	0.00001
ERR6913182	Echinicola strongylocentroti	1795355	S	6	0	6	0.00001
ERR6913182	Echinicola sp. 20G	2781961	S	5	0	5	0.00001
ERR6913182	Belliella baltica	232259	S	5	0	5	0.00001
ERR6913182	Flammeovirga pectinis	2494373	S	7	1	8	0.00001
ERR6913182	Flammeovirga kamogawensis	373891	S	6	1	7	0.00001
ERR6913182	Fulvivirga sp. W9P-11	2904246	S	5	0	5	0.00001
ERR6913182	Persicobacter sp. JZB09	1085624	S	6	0	6	0.00001
ERR6913182	Bernardetia litoralis	999	S	5	0	5	0.00001
ERR6913182	Sphingobacterium sp. SYP-B4668	2996035	S	5	2	7	0.00001
ERR6913182	Sphingobacterium mizutaii	1010	S	5	7	12	0.00002
ERR6913182	Mucilaginibacter paludis	423351	S	10	0	10	0.00001
ERR6913182	Mucilaginibacter ginsenosidivorax	862126	S	6	8	14	0.00002
ERR6913182	Pedobacter sp. G11	2482728	S	5	0	5	0.00001
ERR6913182	Pedobacter sp. HDW13	2714940	S	5	0	5	0.00001
ERR6913182	Pedobacter aquae	2605747	S	5	0	5	0.00001
ERR6913182	Chitinophaga sp. XS-30	2604421	S	7	1	8	0.00001
ERR6913182	Chitinophaga filiformis	104663	S	10	0	10	0.00001
ERR6913182	Chitinophaga agri	2703787	S	7	0	7	0.00001
ERR6913182	Chitinophaga oryzae	2725414	S	7	0	7	0.00001
ERR6913182	Chitinophaga pinensis	79329	S	5	0	5	0.00001
ERR6913182	Ferruginibacter albus	2875540	S	6	0	6	0.00001
ERR6913182	Paraflavitalea soli	2315862	S	6	0	6	0.00001
ERR6913182	Pseudocnuella soli	2502779	S	6	0	6	0.00001
ERR6913182	Rhodothermus marinus	29549	S	11	0	11	0.00002
ERR6913182	Rhodocaloribacter litoris	2558931	S	5	0	5	0.00001
ERR6913182	Aureispira sp. EL160426	2864201	S	8	0	8	0.00001
ERR6913182	Leptotrichia wadei	157687	S	18665	1726	20391	0.02966
ERR6913182	Leptotrichia sp. oral taxon 221	712362	S	3819	312	4131	0.00601
ERR6913182	Leptotrichia sp. oral taxon 212	712357	S	1638	22	1660	0.00241
ERR6913182	Leptotrichia sp. oral taxon 218	712361	S	1234	282	1516	0.00221
ERR6913182	Leptotrichia sp. oral taxon 847	1785996	S	849	111	960	0.00140
ERR6913182	Leptotrichia sp. oral taxon 498	712368	S	310	78	388	0.00056
ERR6913182	Leptotrichia trevisanii	109328	S	870	52	922	0.00134
ERR6913182	Leptotrichia shahii	157691	S	780	85	865	0.00126
ERR6913182	Leptotrichia hofstadii	157688	S	454	45	499	0.00073
ERR6913182	Leptotrichia buccalis	40542	S	276	20	296	0.00043
ERR6913182	Leptotrichia hongkongensis	554406	S	184	17	201	0.00029
ERR6913182	Pseudoleptotrichia goodfellowii	157692	S	48	0	48	0.00007
ERR6913182	Streptobacillus moniliformis	34105	S	12	0	12	0.00002
ERR6913182	Sneathia vaginalis	187101	S	6	0	6	0.00001
ERR6913182	Fusobacterium pseudoperiodonticum	2663009	S	5928	1203	7131	0.01037
ERR6913182	Fusobacterium nucleatum	851	S	850	313	1163	0.00169
ERR6913182	Fusobacterium periodonticum	860	S	601	465	1066	0.00155
ERR6913182	Fusobacterium hwasookii	1583098	S	147	74	221	0.00032
ERR6913182	Fusobacterium canifelinum	285729	S	50	12	62	0.00009
ERR6913182	Fusobacterium necrophorum	859	S	26	0	26	0.00004
ERR6913182	Fusobacterium sp. oral taxon 203	671211	S	25	11	36	0.00005
ERR6913182	Fusobacterium gastrosuis	1755100	S	10	0	10	0.00001
ERR6913182	Fusobacterium gonidiaformans	849	S	6	0	6	0.00001
ERR6913182	Fusobacterium ulcerans	861	S	6	0	6	0.00001
ERR6913182	Fusobacterium hominis	2764326	S	6	0	6	0.00001
ERR6913182	Campylobacter concisus	199	S	3490	46	3536	0.00514
ERR6913182	Campylobacter showae	204	S	2704	132	2836	0.00413
ERR6913182	Campylobacter rectus	203	S	413	22	435	0.00063
ERR6913182	Campylobacter sp. VBCF_01 NA2	2983836	S	20	1	21	0.00003
ERR6913182	Campylobacter sp. RM16187	1660063	S	16	4	20	0.00003
ERR6913182	Campylobacter sp. CCUG 57310	2517362	S	11	0	11	0.00002
ERR6913182	Campylobacter sp. RM6914	1032243	S	10	0	10	0.00001
ERR6913182	Campylobacter sp. RM16192	1660080	S	9	3	12	0.00002
ERR6913182	Campylobacter sp. CS_NA3	2984142	S	7	7	14	0.00002
ERR6913182	Campylobacter sp. RM5004	1660078	S	7	0	7	0.00001
ERR6913182	Campylobacter sp. CN_NE2	2984146	S	5	5	10	0.00001
ERR6913182	Campylobacter sp. RM16704	1500960	S	5	0	5	0.00001
ERR6913182	Campylobacter sp. RM6137	1660073	S	5	0	5	0.00001
ERR6913182	Campylobacter gracilis	824	S	68	0	68	0.00010
ERR6913182	Campylobacter curvus	200	S	33	0	33	0.00005
ERR6913182	Campylobacter hominis	76517	S	29	0	29	0.00004
ERR6913182	Campylobacter ureolyticus	827	S	25	0	25	0.00004
ERR6913182	Campylobacter geochelonis	1780362	S	23	0	23	0.00003
ERR6913182	Campylobacter sputorum	206	S	16	0	16	0.00002
ERR6913182	Campylobacter hyointestinalis	198	S	15	1	16	0.00002
ERR6913182	Campylobacter lari	201	S	11	3	14	0.00002
ERR6913182	Campylobacter lanienae	75658	S	11	0	11	0.00002
ERR6913182	Campylobacter iguaniorum	1244531	S	10	0	10	0.00001
ERR6913182	Campylobacter corcagiensis	1448857	S	10	0	10	0.00001
ERR6913182	Campylobacter blaseri	2042961	S	10	0	10	0.00001
ERR6913182	Campylobacter pinnipediorum	1965231	S	9	0	9	0.00001
ERR6913182	Campylobacter jejuni	197	S	9	22	31	0.00005
ERR6913182	Campylobacter mucosalis	202	S	7	0	7	0.00001
ERR6913182	Campylobacter helveticus	28898	S	6	0	6	0.00001
ERR6913182	Candidatus Campylobacter infans	2561898	S	6	0	6	0.00001
ERR6913182	Campylobacter fetus	196	S	5	0	5	0.00001
ERR6913182	Campylobacter vulpis	1655500	S	5	0	5	0.00001
ERR6913182	Campylobacter canadensis	449520	S	5	0	5	0.00001
ERR6913182	Campylobacter upsaliensis	28080	S	5	0	5	0.00001
ERR6913182	Campylobacter coli	195	S	5	1	6	0.00001
ERR6913182	Aliarcobacter cryaerophilus	28198	S	8	10	18	0.00003
ERR6913182	Helicobacter pylori	210	S	16	0	16	0.00002
ERR6913182	Candidatus Nanosynbacter sp. HMT-352	2899133	S	3256	122	3378	0.00491
ERR6913182	Candidatus Nanosynbacter featherlites	2572088	S	40	0	40	0.00006
ERR6913182	Candidatus Nanosynbacter lyticus	2093824	S	30	1	31	0.00005
ERR6913182	Candidatus Saccharimonas aalborgensis	1332188	S	15	0	15	0.00002
ERR6913182	Candidatus Minimicrobia vallesae	2841264	S	261	34	295	0.00043
ERR6913182	Candidatus Mycosynbacter amalyticus	2665156	S	7	0	7	0.00001
ERR6913182	Treponema sp. OMZ 857	1643513	S	38	23	61	0.00009
ERR6913182	Treponema sp. Marseille-Q4132	2766701	S	35	1	36	0.00005
ERR6913182	Treponema sp. OMZ 803	120682	S	28	26	54	0.00008
ERR6913182	Treponema sp. OMZ 838	1539298	S	27	35	62	0.00009
ERR6913182	Treponema sp. OMZ 305	1659192	S	27	17	44	0.00006
ERR6913182	Treponema sp. OMZ 855	1643512	S	23	30	53	0.00008
ERR6913182	Treponema sp. OMZ 906	2563662	S	22	20	42	0.00006
ERR6913182	Treponema vincentii	69710	S	143	21	164	0.00024
ERR6913182	Treponema denticola	158	S	140	43	183	0.00027
ERR6913182	Treponema medium	58231	S	81	10	91	0.00013
ERR6913182	Treponema socranskii	53419	S	72	2	74	0.00011
ERR6913182	Treponema phagedenis	162	S	18	0	18	0.00003
ERR6913182	Treponema pedis	409322	S	18	0	18	0.00003
ERR6913182	Treponema putidum	221027	S	14	1	15	0.00002
ERR6913182	Treponema parvum	138851	S	12	0	12	0.00002
ERR6913182	Treponema peruense	2787628	S	9	0	9	0.00001
ERR6913182	Leadbettera azotonutricia	150829	S	5	0	5	0.00001
ERR6913182	Sulfuriroseicoccus oceanibius	2707525	S	5	0	5	0.00001
ERR6913182	Akkermansia muciniphila	239935	S	6	0	6	0.00001
ERR6913182	Ruficoccus sp. ZRK36	2866311	S	5	0	5	0.00001
ERR6913182	Pseudodesulfovibrio aespoeensis	182210	S	6	4	10	0.00001
ERR6913182	Desulfosarcina alkanivorans	571177	S	5	1	6	0.00001
ERR6913182	Desulfonema limicola	45656	S	7	0	7	0.00001
ERR6913182	Corallococcus sp. EGB	1521117	S	6	3	9	0.00001
ERR6913182	Vulgatibacter incomptus	1391653	S	6	0	6	0.00001
ERR6913182	Sorangium cellulosum	56	S	6	1	7	0.00001
ERR6913182	Sandaracinus amylolyticus	927083	S	5	0	5	0.00001
ERR6913182	Nannocystis sp. fl3	2995304	S	6	0	6	0.00001
ERR6913182	Haliangium ochraceum	80816	S	5	0	5	0.00001
ERR6913182	Fretibacterium fastidiosum	651822	S	26	1	27	0.00004
ERR6913182	Thermovirga lienii	336261	S	5	0	5	0.00001
ERR6913182	Acidisarcina polymorpha	2211140	S	6	1	7	0.00001
ERR6913182	Luteitalea sp. TBR-22	2802971	S	5	0	5	0.00001
ERR6913182	Micavibrio aeruginosavorus	349221	S	7	0	7	0.00001
ERR6913182	Sulfurihydrogenibium azorense	309806	S	6	0	6	0.00001
ERR6913182	Persicimonas caeni	2292766	S	5	0	5	0.00001
ERR6913182	Homo sapiens	9606	S	636	3	639	0.00093
ERR6913182	Drechmeria coniospora	98403	S	5	0	5	0.00001
ERR6913182	Neurospora crassa	5141	S	6	0	6	0.00001
ERR6913182	Botrytis cinerea	40559	S	5	0	5	0.00001
ERR6913182	Fulvia fulva	5499	S	5	0	5	0.00001
ERR6913182	Tetrapisispora blattae	1071379	S	14	0	14	0.00002
ERR6913182	Candida albicans	5476	S	5	0	5	0.00001
ERR6913182	Malassezia restricta	76775	S	96	2	98	0.00014
ERR6913182	Rhizoctonia solani	456999	S	5	0	5	0.00001
ERR6913182	Plasmodium berghei	5821	S	5	3	8	0.00001
ERR6913182	Plasmodium vinckei	5860	S	5	3	8	0.00001
ERR6913182	Plasmodium relictum	85471	S	12	0	12	0.00002
ERR6913182	Plasmodium malariae	5858	S	5	0	5	0.00001
ERR6913182	Neospora caninum	29176	S	5	0	5	0.00001
ERR6913182	Trichomonas vaginalis	5722	S	23	0	23	0.00003
ERR6913182	Leishmania mexicana	5665	S	14	0	14	0.00002
ERR6913182	Dictyostelium discoideum	44689	S	9	2	11	0.00002
ERR6913182	Natrinema salinisoli	2878535	S	8	8	16	0.00002
ERR6913182	Streptococcus phage YMC-2011	1051631	S	58	3	61	0.00009
ERR6913182	Streptococcus phage PH10	644007	S	13	0	13	0.00002
ERR6913182	Streptococcus phage SpSL1	1566990	S	10	0	10	0.00001
ERR6913182	Streptococcus phage PH15	537874	S	10	0	10	0.00001
ERR6913182	Streptococcus phage phiARI0131-2	1701814	S	6	6	12	0.00002
ERR6913182	Moineauvirus Sfi21	64186	S	7	13	20	0.00003
ERR6913182	Vhmlvirus VP585	1922213	S	13	24	37	0.00005
ERR6913182	Bohxovirus oralis	2955512	S	20	0	20	0.00003
ERR6913276	Cutibacterium acnes	1747	S	372170	15543	387713	0.42643
ERR6913276	Cutibacterium granulosum	33011	S	15666	268	15934	0.01753
ERR6913276	Cutibacterium avidum	33010	S	1035	25	1060	0.00117
ERR6913276	Cutibacterium modestum	2559073	S	388	6	394	0.00043
ERR6913276	Cutibacterium sp. CBA3108	3016342	S	44	0	44	0.00005
ERR6913276	Arachnia propionica	1750	S	349	7	356	0.00039
ERR6913276	Arachnia rubra	1547448	S	285	8	293	0.00032
ERR6913276	Tessaracoccus timonensis	2161816	S	146	4	150	0.00016
ERR6913276	Tessaracoccus flavescens	399497	S	63	14	77	0.00008
ERR6913276	Tessaracoccus defluvii	1285901	S	37	7	44	0.00005
ERR6913276	Tessaracoccus aquimaris	1332264	S	19	2	21	0.00002
ERR6913276	Tessaracoccus flavus	1610493	S	13	2	15	0.00002
ERR6913276	Tessaracoccus sp. MC1865	2760310	S	10	0	10	0.00001
ERR6913276	Tessaracoccus palaemonis	2829499	S	10	0	10	0.00001
ERR6913276	Propionibacterium acidifaciens	556499	S	88	3	91	0.00010
ERR6913276	Propionibacterium freudenreichii	1744	S	60	5	65	0.00007
ERR6913276	Microlunatus sagamiharensis	546874	S	45	1	46	0.00005
ERR6913276	Microlunatus soli	630515	S	30	1	31	0.00003
ERR6913276	Microlunatus elymi	2596828	S	29	1	30	0.00003
ERR6913276	Microlunatus phosphovorus	29405	S	22	0	22	0.00002
ERR6913276	Microlunatus sp. Gsoil 973	2672569	S	5	0	5	0.00001
ERR6913276	Acidipropionibacterium jensenii	1749	S	26	3	29	0.00003
ERR6913276	Acidipropionibacterium acidipropionici	1748	S	19	3	22	0.00002
ERR6913276	Acidipropionibacterium virtanenii	2057246	S	16	2	18	0.00002
ERR6913276	Propioniciclava sp. MC1595	2760308	S	25	0	25	0.00003
ERR6913276	Propioniciclava coleopterorum	2714937	S	17	0	17	0.00002
ERR6913276	Auraticoccus monumenti	675864	S	28	0	28	0.00003
ERR6913276	Raineyella fluvialis	2662261	S	25	0	25	0.00003
ERR6913276	Vaginimicrobium propionicum	1871034	S	15	0	15	0.00002
ERR6913276	Nocardioides sp. HDW12B	2714939	S	59	7	66	0.00007
ERR6913276	Nocardioides sp. JQ2195	2592334	S	55	6	61	0.00007
ERR6913276	Nocardioides sp. InS609-2	2760705	S	50	6	56	0.00006
ERR6913276	Nocardioides sp. LMS-CY	2840457	S	39	7	46	0.00005
ERR6913276	Nocardioides sp. S5	2017486	S	34	10	44	0.00005
ERR6913276	Nocardioides sp. S-1144	2582905	S	29	5	34	0.00004
ERR6913276	Nocardioides sp. dk884	2662361	S	29	30	59	0.00006
ERR6913276	Nocardioides sp. zg-1228	2763008	S	29	7	36	0.00004
ERR6913276	Nocardioides sp. cx-173	2898796	S	24	4	28	0.00003
ERR6913276	Nocardioides sp. WS12	2486272	S	24	2	26	0.00003
ERR6913276	Nocardioides sp. JS614	196162	S	22	12	34	0.00004
ERR6913276	Nocardioides sp. CF8	110319	S	22	6	28	0.00003
ERR6913276	Nocardioides sp. W7	2931390	S	18	3	21	0.00002
ERR6913276	Nocardioides sp. zg-579	2663857	S	16	4	20	0.00002
ERR6913276	Nocardioides sp. TF02-7	2917724	S	13	2	15	0.00002
ERR6913276	Nocardioides sp. zg-536	2803858	S	9	2	11	0.00001
ERR6913276	Nocardioides sp. B-3	2895565	S	9	1	10	0.00001
ERR6913276	Nocardioides sp. Kera G14	2884264	S	5	0	5	0.00001
ERR6913276	Nocardioides aquaticus	160826	S	58	11	69	0.00008
ERR6913276	Nocardioides baekrokdamisoli	1804624	S	36	1	37	0.00004
ERR6913276	Nocardioides panacis	2849501	S	36	4	40	0.00004
ERR6913276	Nocardioides cynanchi	2558918	S	35	4	39	0.00004
ERR6913276	Nocardioides okcheonensis	2894081	S	35	11	46	0.00005
ERR6913276	Nocardioides dongkuii	2760089	S	30	11	41	0.00005
ERR6913276	Nocardioides rotundus	1774216	S	28	5	33	0.00004
ERR6913276	Nocardioides ungokensis	1643322	S	24	5	29	0.00003
ERR6913276	Nocardioides sambongensis	2589074	S	23	3	26	0.00003
ERR6913276	Nocardioides houyundeii	2045452	S	22	4	26	0.00003
ERR6913276	Nocardioides humi	449461	S	20	5	25	0.00003
ERR6913276	Nocardioides marinisabuli	419476	S	19	7	26	0.00003
ERR6913276	Nocardioides daphniae	402297	S	19	6	25	0.00003
ERR6913276	Nocardioides anomalus	2712223	S	19	3	22	0.00002
ERR6913276	Nocardioides dokdonensis	450734	S	17	6	23	0.00003
ERR6913276	Nocardioides panacisoli	627624	S	15	2	17	0.00002
ERR6913276	Nocardioides mesophilus	433659	S	14	1	15	0.00002
ERR6913276	Nocardioides piscis	2714938	S	13	3	16	0.00002
ERR6913276	Nocardioides euryhalodurans	2518370	S	12	2	14	0.00002
ERR6913276	Nocardioides jishulii	2575440	S	12	3	15	0.00002
ERR6913276	Nocardioides pantholopis	2483798	S	11	3	14	0.00002
ERR6913276	Nocardioides aromaticivorans	200618	S	11	3	14	0.00002
ERR6913276	Nocardioides campestrisoli	2736757	S	9	1	10	0.00001
ERR6913276	Nocardioides ochotonae	2685869	S	7	7	14	0.00002
ERR6913276	Nocardioides seonyuensis	2518371	S	7	1	8	0.00001
ERR6913276	Nocardioides yefusunii	2500546	S	5	0	5	0.00001
ERR6913276	Aeromicrobium sp. Leaf245	1736306	S	24	6	30	0.00003
ERR6913276	Aeromicrobium sp. A1-2	2107713	S	20	2	22	0.00002
ERR6913276	Aeromicrobium sp. zg.Y1379	2969247	S	15	5	20	0.00002
ERR6913276	Aeromicrobium sp. zg.Y50	2968086	S	7	5	12	0.00001
ERR6913276	Aeromicrobium sp. zg-629	2663859	S	5	3	8	0.00001
ERR6913276	Aeromicrobium marinum	219314	S	14	2	16	0.00002
ERR6913276	Aeromicrobium erythreum	2041	S	11	3	14	0.00002
ERR6913276	Aeromicrobium choanae	1736691	S	8	5	13	0.00001
ERR6913276	Aeromicrobium chenweiae	2079793	S	6	3	9	0.00001
ERR6913276	Aeromicrobium yanjiei	2662028	S	6	3	9	0.00001
ERR6913276	Friedmanniella luteola	546871	S	70	2	72	0.00008
ERR6913276	Pimelobacter simplex	2045	S	49	11	60	0.00007
ERR6913276	Mumia sp. ZJ1417	2708082	S	30	1	31	0.00003
ERR6913276	Marmoricola scoriae	642780	S	29	4	33	0.00004
ERR6913276	Micropruina glycogenica	75385	S	16	0	16	0.00002
ERR6913276	Solicola gregarius	2908642	S	14	0	14	0.00002
ERR6913276	Kribbella qitaiheensis	1544730	S	13	20	33	0.00004
ERR6913276	Kribbella flavida	182640	S	12	20	32	0.00004
ERR6913276	Kribbella sp. CA-293567	3002436	S	7	13	20	0.00002
ERR6913276	Actinopolymorpha singaporensis	117157	S	25	0	25	0.00003
ERR6913276	Kocuria rhizophila	72000	S	21107	2651	23758	0.02613
ERR6913276	Kocuria palustris	71999	S	5415	225	5640	0.00620
ERR6913276	Kocuria rosea	1275	S	883	37	920	0.00101
ERR6913276	Kocuria varians	1272	S	708	40	748	0.00082
ERR6913276	Kocuria sp. BT304	1702043	S	265	111	376	0.00041
ERR6913276	Kocuria sp. KD4	2719588	S	125	19	144	0.00016
ERR6913276	Kocuria sp. TGY1127_2	2711328	S	11	0	11	0.00001
ERR6913276	Kocuria turfanensis	388357	S	156	6	162	0.00018
ERR6913276	Kocuria indica	1049583	S	137	23	160	0.00018
ERR6913276	Kocuria flava	446860	S	75	4	79	0.00009
ERR6913276	Rothia mucilaginosa	43675	S	7986	123	8109	0.00892
ERR6913276	Rothia dentocariosa	2047	S	3108	100	3208	0.00353
ERR6913276	Rothia aeria	172042	S	725	19	744	0.00082
ERR6913276	Rothia kristinae	37923	S	94	5	99	0.00011
ERR6913276	Rothia amarae	169480	S	30	0	30	0.00003
ERR6913276	Rothia nasimurium	85336	S	22	0	22	0.00002
ERR6913276	Rothia sp. ZJ932	2810516	S	19	0	19	0.00002
ERR6913276	Rothia terrae	396015	S	17	0	17	0.00002
ERR6913276	Micrococcus luteus	1270	S	1694	1948	3642	0.00401
ERR6913276	Micrococcus sp. KD337-16	2856555	S	332	42	374	0.00041
ERR6913276	Micrococcus sp. KBS0714	1179670	S	41	234	275	0.00030
ERR6913276	Micrococcus sp. A7	376418	S	15	25	40	0.00004
ERR6913276	Micrococcus sp. A1	404583	S	14	20	34	0.00004
ERR6913276	Micrococcus sp. SL257	2995171	S	13	148	161	0.00018
ERR6913276	Micrococcus sp. 28	161213	S	9	2	11	0.00001
ERR6913276	Micrococcus sp. V7	404582	S	8	0	8	0.00001
ERR6913276	Micrococcus sp. MG-2010-D12	936902	S	5	7	12	0.00001
ERR6913276	Micrococcus yunnanensis	566027	S	132	813	945	0.00104
ERR6913276	Arthrobacter sp. ERGS1:01	1704044	S	35	2	37	0.00004
ERR6913276	Arthrobacter sp. 24S4-2	2575374	S	34	5	39	0.00004
ERR6913276	Arthrobacter sp. PM3	2017685	S	30	6	36	0.00004
ERR6913276	Arthrobacter sp. YA7-1	2987701	S	26	8	34	0.00004
ERR6913276	Arthrobacter sp. FB24	290399	S	19	4	23	0.00003
ERR6913276	Arthrobacter sp. U41	1849032	S	17	3	20	0.00002
ERR6913276	Arthrobacter sp. D5-1	1477518	S	17	13	30	0.00003
ERR6913276	Arthrobacter sp. zg-Y462	2886936	S	16	2	18	0.00002
ERR6913276	Arthrobacter sp. NicSoilB8	2830998	S	16	3	19	0.00002
ERR6913276	Arthrobacter sp. MMS18-M83	2996261	S	15	2	17	0.00002
ERR6913276	Arthrobacter sp. PAMC25284	2861279	S	15	1	16	0.00002
ERR6913276	Arthrobacter sp. StoSoilB5	2830992	S	14	3	17	0.00002
ERR6913276	Arthrobacter sp. ATA002	2991715	S	14	1	15	0.00002
ERR6913276	Arthrobacter sp. FW306-2-2C-D06B	2879618	S	13	4	17	0.00002
ERR6913276	Arthrobacter sp. UKPF54-2	2600159	S	13	5	18	0.00002
ERR6913276	Arthrobacter sp. QXT-31	1357915	S	12	2	14	0.00002
ERR6913276	Arthrobacter sp. Helios	2828862	S	12	1	13	0.00001
ERR6913276	Arthrobacter sp. zg-Y859	2964609	S	11	8	19	0.00002
ERR6913276	Arthrobacter sp. StoSoilB20	2830995	S	11	2	13	0.00001
ERR6913276	Arthrobacter sp.	1667	S	11	0	11	0.00001
ERR6913276	Arthrobacter sp. NicSoilC5	2831000	S	9	9	18	0.00002
ERR6913276	Arthrobacter sp. zg-Y1110	2886932	S	9	10	19	0.00002
ERR6913276	Arthrobacter sp. CDRTa11	2651199	S	8	0	8	0.00001
ERR6913276	Arthrobacter sp. FW305-BF8	2879617	S	8	1	9	0.00001
ERR6913276	Arthrobacter sp. PAMC 25486	1494608	S	8	0	8	0.00001
ERR6913276	Arthrobacter sp. zg-Y1171	2964610	S	7	10	17	0.00002
ERR6913276	Arthrobacter sp. DNA4	2963432	S	7	6	13	0.00001
ERR6913276	Arthrobacter sp. KBS0702	2578107	S	6	2	8	0.00001
ERR6913276	Arthrobacter sp. PAMC25564	2565366	S	6	1	7	0.00001
ERR6913276	Arthrobacter sp. CJ23	2972479	S	5	0	5	0.00001
ERR6913276	Arthrobacter sp. NicSoilB4	2830997	S	5	1	6	0.00001
ERR6913276	Arthrobacter agilis	37921	S	58	3	61	0.00007
ERR6913276	Arthrobacter alpinus	656366	S	45	66	111	0.00012
ERR6913276	Arthrobacter crystallopoietes	37928	S	33	1	34	0.00004
ERR6913276	Arthrobacter antioxidans	2895818	S	22	2	24	0.00003
ERR6913276	Arthrobacter koreensis	199136	S	19	2	21	0.00002
ERR6913276	Arthrobacter polaris	2813727	S	18	0	18	0.00002
ERR6913276	Arthrobacter dokdonellae	2211210	S	17	1	18	0.00002
ERR6913276	Arthrobacter jiangjiafuii	2817475	S	16	2	18	0.00002
ERR6913276	Arthrobacter sulfonylureivorans	2486855	S	13	0	13	0.00001
ERR6913276	Arthrobacter woluwensis	156980	S	11	0	11	0.00001
ERR6913276	Renibacterium salmoninarum	1646	S	726	4	730	0.00080
ERR6913276	Glutamicibacter sp. M10	3023076	S	25	1	26	0.00003
ERR6913276	Glutamicibacter sp. MNS18	2989817	S	21	0	21	0.00002
ERR6913276	Glutamicibacter creatinolyticus	162496	S	35	1	36	0.00004
ERR6913276	Glutamicibacter arilaitensis	256701	S	24	1	25	0.00003
ERR6913276	Glutamicibacter mishrai	1775880	S	17	2	19	0.00002
ERR6913276	Glutamicibacter halophytocola	1933880	S	15	0	15	0.00002
ERR6913276	Glutamicibacter nicotianae	37929	S	13	23	36	0.00004
ERR6913276	Glutamicibacter protophormiae	37930	S	13	0	13	0.00001
ERR6913276	Psychromicrobium lacuslunae	1618207	S	174	1	175	0.00019
ERR6913276	Citricoccus sp. SGAir0253	2567881	S	98	5	103	0.00011
ERR6913276	Citricoccus sp. NR2	3004095	S	59	3	62	0.00007
ERR6913276	Pseudarthrobacter sp. BIM B-2242	2772401	S	26	2	28	0.00003
ERR6913276	Pseudarthrobacter sp. L1SW	2851598	S	16	2	18	0.00002
ERR6913276	Pseudarthrobacter sp. NIBRBAC000502772	2590775	S	11	10	21	0.00002
ERR6913276	Pseudarthrobacter sp. SSS035	2931399	S	7	7	14	0.00002
ERR6913276	Pseudarthrobacter sp. NBSH8	2596911	S	6	2	8	0.00001
ERR6913276	Pseudarthrobacter sp. NS4	2973976	S	6	0	6	0.00001
ERR6913276	Pseudarthrobacter phenanthrenivorans	361575	S	12	1	13	0.00001
ERR6913276	Pseudarthrobacter psychrotolerans	2697569	S	11	2	13	0.00001
ERR6913276	Pseudarthrobacter sulfonivorans	121292	S	9	5	14	0.00002
ERR6913276	Pseudarthrobacter chlorophenolicus	85085	S	8	1	9	0.00001
ERR6913276	Auritidibacter sp. NML130574	2170745	S	64	0	64	0.00007
ERR6913276	Paenarthrobacter sp. YJN-5	2735316	S	12	14	26	0.00003
ERR6913276	Paenarthrobacter ureafaciens	37931	S	11	8	19	0.00002
ERR6913276	Sinomonas atrocyanea	37927	S	28	1	29	0.00003
ERR6913276	Sinomonas sp. R1AF57	2020377	S	15	0	15	0.00002
ERR6913276	Paeniglutamicibacter sp. Y32M11	2853258	S	19	0	19	0.00002
ERR6913276	Paeniglutamicibacter sp. ZC-3	2986919	S	16	0	16	0.00002
ERR6913276	Neomicrococcus aestuarii	556325	S	10	0	10	0.00001
ERR6913276	Janibacter sp. CX7	2963431	S	2052	395	2447	0.00269
ERR6913276	Janibacter sp. YB324	2761047	S	745	789	1534	0.00169
ERR6913276	Janibacter limosus	53458	S	1927	105	2032	0.00223
ERR6913276	Janibacter indicus	857417	S	1717	1164	2881	0.00317
ERR6913276	Janibacter melonis	262209	S	228	11	239	0.00026
ERR6913276	Phycicoccus sp. HDW14	2714941	S	47	3	50	0.00005
ERR6913276	Phycicoccus endophyticus	1690220	S	33	2	35	0.00004
ERR6913276	Tetrasphaera sp. HKS02	1813880	S	39	1	40	0.00004
ERR6913276	Intrasporangium calvum	53358	S	36	2	38	0.00004
ERR6913276	Pedococcus dokdonensis	443156	S	24	1	25	0.00003
ERR6913276	Arsenicicoccus sp. oral taxon 190	1658671	S	20	0	20	0.00002
ERR6913276	Microbacterium sp. Y-01	2048898	S	183	36	219	0.00024
ERR6913276	Microbacterium sp. Nx66	2766784	S	135	49	184	0.00020
ERR6913276	Microbacterium sp. str. 'China'	2103230	S	104	294	398	0.00044
ERR6913276	Microbacterium sp. PM5	2014534	S	63	6	69	0.00008
ERR6913276	Microbacterium sp. 10M-3C3	2483401	S	43	7	50	0.00005
ERR6913276	Microbacterium sp. 1S1	2606451	S	38	8	46	0.00005
ERR6913276	Microbacterium sp. KUDC0405	2909587	S	32	2	34	0.00004
ERR6913276	Microbacterium sp. LKL04	912630	S	28	3	31	0.00003
ERR6913276	Microbacterium sp. No. 7	1714373	S	28	3	31	0.00003
ERR6913276	Microbacterium sp. SSW1-51	2851650	S	27	4	31	0.00003
ERR6913276	Microbacterium sp. H1-D42	2925844	S	25	2	27	0.00003
ERR6913276	Microbacterium sp. TPU 3598	1938334	S	22	3	25	0.00003
ERR6913276	Microbacterium sp. JZ31	1906274	S	22	2	24	0.00003
ERR6913276	Microbacterium sp. ABRD_28	2268461	S	22	1	23	0.00003
ERR6913276	Microbacterium sp. YJN-G	2763257	S	22	3	25	0.00003
ERR6913276	Microbacterium sp. cx-55	2875948	S	21	1	22	0.00002
ERR6913276	Microbacterium sp. PAMC 28756	1795053	S	21	148	169	0.00019
ERR6913276	Microbacterium sp. BH-3-3-3	1906742	S	20	2	22	0.00002
ERR6913276	Microbacterium sp. 4R-513	2567934	S	19	2	21	0.00002
ERR6913276	Microbacterium sp. PAMC22086	2861281	S	17	22	39	0.00004
ERR6913276	Microbacterium sp. SSW1-36	2851648	S	17	2	19	0.00002
ERR6913276	Microbacterium sp. A18JL241	2782166	S	16	1	17	0.00002
ERR6913276	Microbacterium sp. NIBRBAC000506063	2734618	S	16	2	18	0.00002
ERR6913276	Microbacterium sp. nov. GSS16	3019890	S	15	2	17	0.00002
ERR6913276	Microbacterium sp. KUDC0406	2909588	S	13	1	14	0.00002
ERR6913276	Microbacterium sp. J1-1	2992441	S	12	18	30	0.00003
ERR6913276	Microbacterium sp. M28	2962064	S	12	1	13	0.00001
ERR6913276	Microbacterium sp. CBA3102	2603598	S	12	39	51	0.00006
ERR6913276	Microbacterium sp. Clip185	3025663	S	10	1	11	0.00001
ERR6913276	Microbacterium sp. MPKO10	2989818	S	10	0	10	0.00001
ERR6913276	Microbacterium sp. XT11	367477	S	8	0	8	0.00001
ERR6913276	Microbacterium sp. SL75	2995140	S	7	0	7	0.00001
ERR6913276	Microbacterium sp. PAMC21962	2861280	S	6	98	104	0.00011
ERR6913276	Microbacterium oxydans	82380	S	263	87	350	0.00038
ERR6913276	Microbacterium paraoxydans	199592	S	155	470	625	0.00069
ERR6913276	Microbacterium aurum	36805	S	129	19	148	0.00016
ERR6913276	Microbacterium foliorum	104336	S	57	6	63	0.00007
ERR6913276	Microbacterium oleivorans	273677	S	56	5	61	0.00007
ERR6913276	Microbacterium esteraromaticum	57043	S	50	5	55	0.00006
ERR6913276	Microbacterium luteum	2782167	S	42	4	46	0.00005
ERR6913276	Microbacterium lemovicicum	1072463	S	42	5	47	0.00005
ERR6913276	Microbacterium terricola	344163	S	32	4	36	0.00004
ERR6913276	Microbacterium hominis	162426	S	30	36	66	0.00007
ERR6913276	Microbacterium sediminis	904291	S	26	4	30	0.00003
ERR6913276	Microbacterium resistens	156977	S	26	2	28	0.00003
ERR6913276	Microbacterium oryzae	743009	S	23	2	25	0.00003
ERR6913276	Microbacterium cremeum	2782169	S	20	2	22	0.00002
ERR6913276	Microbacterium chocolatum	84292	S	19	2	21	0.00002
ERR6913276	Microbacterium caowuchunii	2614638	S	17	1	18	0.00002
ERR6913276	Microbacterium azadirachtae	582680	S	15	1	16	0.00002
ERR6913276	Microbacterium chengjingii	2769067	S	15	0	15	0.00002
ERR6913276	Microbacterium lushaniae	2614639	S	14	1	15	0.00002
ERR6913276	Microbacterium amylolyticum	936337	S	14	0	14	0.00002
ERR6913276	Microbacterium hydrocarbonoxydans	273678	S	12	1	13	0.00001
ERR6913276	Microbacterium pygmaeum	370764	S	11	0	11	0.00001
ERR6913276	Microbacterium atlanticum	2782168	S	11	1	12	0.00001
ERR6913276	Microbacterium testaceum	2033	S	11	1	12	0.00001
ERR6913276	Microbacterium endophyticum	1526412	S	10	0	10	0.00001
ERR6913276	Microbacterium fandaimingii	2708079	S	10	0	10	0.00001
ERR6913276	Microbacterium schleiferi	69362	S	10	0	10	0.00001
ERR6913276	Leucobacter sp. Psy1	2875729	S	24	1	25	0.00003
ERR6913276	Leucobacter sp. CX169	2813744	S	21	2	23	0.00003
ERR6913276	Leucobacter sp. NB 10	2873270	S	17	3	20	0.00002
ERR6913276	Leucobacter sp. H25R-14	2932245	S	14	1	15	0.00002
ERR6913276	Leucobacter sp. H21R-36	2932246	S	5	25	30	0.00003
ERR6913276	Leucobacter aridicollis	283878	S	95	9	104	0.00011
ERR6913276	Leucobacter triazinivorans	1784719	S	23	4	27	0.00003
ERR6913276	Leucobacter muris	1935379	S	19	6	25	0.00003
ERR6913276	Leucobacter insecticola	2714934	S	18	0	18	0.00002
ERR6913276	Leucobacter viscericola	2714935	S	18	1	19	0.00002
ERR6913276	Leucobacter denitrificans	683042	S	13	0	13	0.00001
ERR6913276	Leucobacter luti	340320	S	9	0	9	0.00001
ERR6913276	Leucobacter coleopterorum	2714933	S	5	0	5	0.00001
ERR6913276	Aurantimicrobium photophilum	1987356	S	207	6	213	0.00023
ERR6913276	Aurantimicrobium minutum	708131	S	22	2	24	0.00003
ERR6913276	Rhodoluna lacicola	529884	S	51	32	83	0.00009
ERR6913276	Candidatus Rhodoluna planktonica	535712	S	10	2	12	0.00001
ERR6913276	Rhodoluna limnophila	232537	S	6	94	100	0.00011
ERR6913276	Candidatus Aquiluna sp. UB-MaderosW2red	1855377	S	12	2	14	0.00002
ERR6913276	Aquiluna sp. KACHI24	2968831	S	7	4	11	0.00001
ERR6913276	Curtobacterium sp. TC1	2862880	S	20	9	29	0.00003
ERR6913276	Curtobacterium sp. L6-1	2841594	S	12	2	14	0.00002
ERR6913276	Curtobacterium sp. SGAir0471	2070337	S	10	9	19	0.00002
ERR6913276	Curtobacterium sp. TXMA1	2876939	S	10	9	19	0.00002
ERR6913276	Curtobacterium sp. 24E2	2804758	S	9	4	13	0.00001
ERR6913276	Curtobacterium sp. YC1	2795488	S	6	1	7	0.00001
ERR6913276	Curtobacterium sp. MR_MD2014	1561023	S	5	2	7	0.00001
ERR6913276	Curtobacterium sp. BH-2-1-1	1905847	S	5	1	6	0.00001
ERR6913276	Curtobacterium sp. C1	2898151	S	5	15	20	0.00002
ERR6913276	Curtobacterium flaccumfaciens	2035	S	32	17	49	0.00005
ERR6913276	Curtobacterium luteum	33881	S	16	3	19	0.00002
ERR6913276	Cryobacterium sp. SO1	1897061	S	37	8	45	0.00005
ERR6913276	Cryobacterium sp. LW097	1978566	S	37	8	45	0.00005
ERR6913276	Cryobacterium sp. PAMC25264	2861288	S	8	5	13	0.00001
ERR6913276	Cryobacterium sp.	1926290	S	5	1	6	0.00001
ERR6913276	Cryobacterium soli	2220095	S	32	18	50	0.00005
ERR6913276	Cryobacterium arcticum	670052	S	22	18	40	0.00004
ERR6913276	Agromyces sp. CFWR-12	2929802	S	19	6	25	0.00003
ERR6913276	Agromyces sp. H17E-10	2932244	S	17	3	20	0.00002
ERR6913276	Agromyces sp. LHK192	2498704	S	9	1	10	0.00001
ERR6913276	Agromyces marinus	1389020	S	21	4	25	0.00003
ERR6913276	Agromyces flavus	589382	S	17	3	20	0.00002
ERR6913276	Agromyces laixinhei	2585717	S	17	2	19	0.00002
ERR6913276	Agromyces aureus	453304	S	15	2	17	0.00002
ERR6913276	Agromyces protaetiae	2509455	S	15	2	17	0.00002
ERR6913276	Agromyces soli	659012	S	14	3	17	0.00002
ERR6913276	Agromyces archimandritae	2781962	S	13	2	15	0.00002
ERR6913276	Agromyces badenianii	2080742	S	9	2	11	0.00001
ERR6913276	Agromyces intestinalis	2592652	S	6	2	8	0.00001
ERR6913276	Rathayibacter sp. VKM Ac-2759	2609252	S	35	9	44	0.00005
ERR6913276	Rathayibacter sp. VKM Ac-2760	2609253	S	27	12	39	0.00004
ERR6913276	Rathayibacter sp. VKM Ac-2801	2609255	S	16	20	36	0.00004
ERR6913276	Rathayibacter festucae	110937	S	14	12	26	0.00003
ERR6913276	Rathayibacter rathayi	33887	S	12	3	15	0.00002
ERR6913276	Rathayibacter iranicus	59737	S	9	0	9	0.00001
ERR6913276	Rathayibacter tanaceti	1671680	S	7	1	8	0.00001
ERR6913276	Clavibacter michiganensis	28447	S	59	31	90	0.00010
ERR6913276	Clavibacter zhangzhiyongii	2768071	S	9	4	13	0.00001
ERR6913276	Clavibacter californiensis	1401995	S	5	4	9	0.00001
ERR6913276	Leifsonia sp. PS1209	2724914	S	18	3	21	0.00002
ERR6913276	Leifsonia sp. ZF2019	2781978	S	15	3	18	0.00002
ERR6913276	Leifsonia sp. 21MFCrub1.1	1798223	S	12	8	20	0.00002
ERR6913276	Leifsonia shinshuensis	150026	S	26	5	31	0.00003
ERR6913276	Leifsonia xyli	1575	S	16	1	17	0.00002
ERR6913276	Agrococcus sp. Marseille-Q4369	2810513	S	22	5	27	0.00003
ERR6913276	Agrococcus sp. SGAir0287	2070347	S	19	3	22	0.00002
ERR6913276	Agrococcus sp. SCSIO52902	2933290	S	15	4	19	0.00002
ERR6913276	Agrococcus sp. SL85	2995141	S	6	1	7	0.00001
ERR6913276	Agrococcus carbonis	684552	S	20	4	24	0.00003
ERR6913276	Agrococcus jejuensis	399736	S	7	1	8	0.00001
ERR6913276	Protaetiibacter larvae	2592654	S	24	4	28	0.00003
ERR6913276	Protaetiibacter intestinalis	2419774	S	19	4	23	0.00003
ERR6913276	Protaetiibacter sp. SSC-01	2759943	S	12	3	15	0.00002
ERR6913276	Salinibacterium sp. M195	2583374	S	10	2	12	0.00001
ERR6913276	Salinibacterium sp. ZJ70	2708084	S	10	2	12	0.00001
ERR6913276	Salinibacterium sp. ZJ450	2708338	S	9	1	10	0.00001
ERR6913276	Salinibacterium sp. dk2585	2603292	S	6	0	6	0.00001
ERR6913276	Salinibacterium hongtaonis	2079791	S	9	0	9	0.00001
ERR6913276	Gulosibacter molinativorax	256821	S	27	2	29	0.00003
ERR6913276	Gulosibacter sediminis	1729695	S	21	2	23	0.00003
ERR6913276	Frigoribacterium sp. NBH87	2596916	S	21	6	27	0.00003
ERR6913276	Frigoribacterium sp. SL97	2994664	S	17	3	20	0.00002
ERR6913276	Plantibacter sp. PA-3-X8	2480625	S	6	8	14	0.00002
ERR6913276	Plantibacter sp. M259	2583822	S	5	6	11	0.00001
ERR6913276	Plantibacter flavus	150123	S	8	6	14	0.00002
ERR6913276	Pseudoclavibacter sp. Marseille-Q3772	2866588	S	31	0	31	0.00003
ERR6913276	Microcella sp. MMS21-STM10	2963406	S	13	7	20	0.00002
ERR6913276	Microcella alkaliphila	279828	S	8	1	9	0.00001
ERR6913276	Mycetocola spongiae	2859226	S	15	0	15	0.00002
ERR6913276	Mycetocola zhujimingii	2079792	S	10	0	10	0.00001
ERR6913276	Microterricola viridarii	412690	S	23	3	26	0.00003
ERR6913276	Herbiconiux sp. SALV-R1	2735133	S	18	2	20	0.00002
ERR6913276	Herbiconiux sp. L3-i23	2905871	S	5	0	5	0.00001
ERR6913276	Homoserinibacter sp. YIM 151385	2985506	S	23	5	28	0.00003
ERR6913276	Frondihabitans sp. PAMC 28766	1795630	S	11	1	12	0.00001
ERR6913276	Frondihabitans sp. 762G35	1446794	S	7	2	9	0.00001
ERR6913276	Chryseoglobus indicus	2750620	S	10	11	21	0.00002
ERR6913276	Subtercola sp. PAMC28395	2846775	S	8	1	9	0.00001
ERR6913276	Subtercola sp. AK-R2A1-2	2895559	S	6	1	7	0.00001
ERR6913276	Humibacter ginsenosidimutans	2599293	S	14	1	15	0.00002
ERR6913276	Pontimonas salivibrio	1159327	S	10	0	10	0.00001
ERR6913276	Agreia sp. COWG	2773266	S	8	0	8	0.00001
ERR6913276	Cnuibacter physcomitrellae	1619308	S	8	1	9	0.00001
ERR6913276	Gryllotalpicola protaetiae	2419771	S	6	0	6	0.00001
ERR6913276	Diaminobutyricimonas sp. LJ205	2683590	S	6	0	6	0.00001
ERR6913276	Brachybacterium sp. SGAir0954	2571029	S	162	72	234	0.00026
ERR6913276	Brachybacterium sp. Z12	2759167	S	152	15	167	0.00018
ERR6913276	Brachybacterium sp. NBEC-018	2996004	S	105	39	144	0.00016
ERR6913276	Brachybacterium sp. P6-10-X1	1903186	S	100	6	106	0.00012
ERR6913276	Brachybacterium saurashtrense	556288	S	172	21	193	0.00021
ERR6913276	Brachybacterium faecium	43669	S	171	26	197	0.00022
ERR6913276	Brachybacterium ginsengisoli	1331682	S	101	13	114	0.00013
ERR6913276	Brachybacterium vulturis	2017484	S	77	17	94	0.00010
ERR6913276	Brachybacterium avium	2017485	S	73	15	88	0.00010
ERR6913276	Brachybacterium huguangmaarense	1652028	S	71	5	76	0.00008
ERR6913276	Brachybacterium kimchii	2942909	S	38	20	58	0.00006
ERR6913276	Brachybacterium halotolerans	2795215	S	34	20	54	0.00006
ERR6913276	Dermabacter jinjuensis	1667168	S	535	48	583	0.00064
ERR6913276	Dermabacter vaginalis	1630135	S	106	8	114	0.00013
ERR6913276	Devriesea agamarum	472569	S	14	0	14	0.00002
ERR6913276	Brevibacterium sp. CS2	2575923	S	755	36	791	0.00087
ERR6913276	Brevibacterium sp. BRM-1	2999062	S	67	4	71	0.00008
ERR6913276	Brevibacterium sp. SMBL_HHYL_HB1	2777556	S	36	2	38	0.00004
ERR6913276	Brevibacterium sp. W7.2	2823518	S	10	13	23	0.00003
ERR6913276	Brevibacterium sp. WHS-Z9	2909672	S	5	0	5	0.00001
ERR6913276	Brevibacterium casei	33889	S	138	21	159	0.00017
ERR6913276	Brevibacterium luteolum	199591	S	55	2	57	0.00006
ERR6913276	Brevibacterium linens	1703	S	39	11	50	0.00005
ERR6913276	Brevibacterium aurantiacum	273384	S	30	28	58	0.00006
ERR6913276	Brevibacterium oceani	358099	S	19	1	20	0.00002
ERR6913276	Brevibacterium sandarakinum	629680	S	14	0	14	0.00002
ERR6913276	Brevibacterium zhoupengii	2898795	S	11	1	12	0.00001
ERR6913276	Brevibacterium pigmentatum	1496080	S	9	3	12	0.00001
ERR6913276	Brevibacterium siliguriense	1136497	S	7	0	7	0.00001
ERR6913276	Brevibacterium atlanticum	2697563	S	7	0	7	0.00001
ERR6913276	Brevibacterium limosum	2697565	S	6	0	6	0.00001
ERR6913276	Dermacoccus nishinomiyaensis	1274	S	885	41	926	0.00102
ERR6913276	Dermacoccus sp. PAMC28757	2762331	S	29	1	30	0.00003
ERR6913276	Yimella sp. cx-51	2770551	S	37	0	37	0.00004
ERR6913276	Allobranchiibius sp. GilTou73	2904523	S	24	0	24	0.00003
ERR6913276	Luteipulveratus mongoliensis	571913	S	20	0	20	0.00002
ERR6913276	Kytococcus sedentarius	1276	S	667	25	692	0.00076
ERR6913276	Cellulomonas sp. Y8	2591145	S	27	3	30	0.00003
ERR6913276	Cellulomonas sp. C5510	2871170	S	19	2	21	0.00002
ERR6913276	Cellulomonas sp. NS3	2973977	S	17	1	18	0.00002
ERR6913276	Cellulomonas sp. PSBB021	2003551	S	13	5	18	0.00002
ERR6913276	Cellulomonas sp. H30R-01	2704467	S	11	4	15	0.00002
ERR6913276	Cellulomonas sp. zg.B89	2968083	S	10	2	12	0.00001
ERR6913276	Cellulomonas sp. JZ18	2654191	S	8	1	9	0.00001
ERR6913276	Cellulomonas sp. S1-8	2904790	S	8	1	9	0.00001
ERR6913276	Cellulomonas sp. zg.Y338	2968084	S	5	0	5	0.00001
ERR6913276	Cellulomonas sp. zg.Y908	2968085	S	5	1	6	0.00001
ERR6913276	Cellulomonas fimi	1708	S	27	7	34	0.00004
ERR6913276	Cellulomonas gilvus	11	S	22	3	25	0.00003
ERR6913276	Cellulomonas fengjieae	2819978	S	20	1	21	0.00002
ERR6913276	Cellulomonas iranensis	76862	S	11	2	13	0.00001
ERR6913276	Cellulomonas wangleii	2816956	S	11	3	14	0.00002
ERR6913276	Cellulomonas shaoxiangyii	2566013	S	8	1	9	0.00001
ERR6913276	Cellulomonas palmilytica	2608402	S	7	2	9	0.00001
ERR6913276	Cellulomonas flavigena	1711	S	6	1	7	0.00001
ERR6913276	Cellulomonas taurus	2729175	S	6	0	6	0.00001
ERR6913276	Pseudactinotalea sp. HY158	2654547	S	19	0	19	0.00002
ERR6913276	Actinotalea sp. JY-7876	2758442	S	10	1	11	0.00001
ERR6913276	Oerskovia sp. KBS0722	1179673	S	9	0	9	0.00001
ERR6913276	Paraoerskovia marina	545619	S	5	0	5	0.00001
ERR6913276	Ornithinimicrobium sp. HY006	2508882	S	28	8	36	0.00004
ERR6913276	Ornithinimicrobium sp. HY1793	2934158	S	21	12	33	0.00004
ERR6913276	Ornithinimicrobium sp. INDO-MA30-4	2908651	S	19	0	19	0.00002
ERR6913276	Ornithinimicrobium sp. JY.X270	2934161	S	8	6	14	0.00002
ERR6913276	Ornithinimicrobium flavum	1288636	S	34	3	37	0.00004
ERR6913276	Ornithinimicrobium ciconiae	2594265	S	21	1	22	0.00002
ERR6913276	Ornithinimicrobium avium	2283195	S	19	1	20	0.00002
ERR6913276	Ornithinimicrobium pratense	2593973	S	18	2	20	0.00002
ERR6913276	Serinicoccus profundi	1078471	S	28	4	32	0.00004
ERR6913276	Serinicoccus hydrothermalis	1758689	S	26	10	36	0.00004
ERR6913276	Serinicoccus marinus	247333	S	21	9	30	0.00003
ERR6913276	Serinicoccus chungangensis	767452	S	21	3	24	0.00003
ERR6913276	Cellulosimicrobium cellulans	1710	S	36	15	51	0.00006
ERR6913276	Cellulosimicrobium protaetiae	2587808	S	8	1	9	0.00001
ERR6913276	Cellulosimicrobium sp. 72-3	2731680	S	5	13	18	0.00002
ERR6913276	Xylanimonas protaetiae	2509457	S	19	4	23	0.00003
ERR6913276	Xylanimonas cellulosilytica	186189	S	5	0	5	0.00001
ERR6913276	Xylanimonas allomyrinae	2509459	S	5	0	5	0.00001
ERR6913276	Isoptericola variabilis	139208	S	12	0	12	0.00001
ERR6913276	Isoptericola dokdonensis	372663	S	7	0	7	0.00001
ERR6913276	Georgenia faecalis	2483799	S	23	2	25	0.00003
ERR6913276	Georgenia wutianyii	2585135	S	21	2	23	0.00003
ERR6913276	Georgenia yuyongxinii	2589797	S	20	1	21	0.00002
ERR6913276	Georgenia sp. TF02-10	2917725	S	18	1	19	0.00002
ERR6913276	Ruania alkalisoli	2779775	S	25	3	28	0.00003
ERR6913276	Ruania halotolerans	2897773	S	11	1	12	0.00001
ERR6913276	Ruania suaedae	2897774	S	10	0	10	0.00001
ERR6913276	Ruania zhangjianzhongii	2603206	S	9	0	9	0.00001
ERR6913276	Occultella kanbiaonis	2675754	S	18	0	18	0.00002
ERR6913276	Dermatophilus congolensis	1863	S	30	0	30	0.00003
ERR6913276	Gephyromycinifex aptenodytis	2716227	S	21	0	21	0.00002
ERR6913276	Austwickia chelonae	100225	S	18	0	18	0.00002
ERR6913276	Beutenbergia cavernae	84757	S	16	0	16	0.00002
ERR6913276	Miniimonas sp. S16	2171623	S	16	1	17	0.00002
ERR6913276	Pengzhenrongella sicca	2819238	S	14	0	14	0.00002
ERR6913276	Luteimicrobium xylanilyticum	1133546	S	11	0	11	0.00001
ERR6913276	Sanguibacter keddieii	60920	S	13	0	13	0.00001
ERR6913276	Sanguibacter sp. HDW7	2714931	S	5	0	5	0.00001
ERR6913276	Jonesia denitrificans	43674	S	10	0	10	0.00001
ERR6913276	Demequina sp. TMPB413	2881056	S	5	0	5	0.00001
ERR6913276	Corynebacterium tuberculostearicum	38304	S	5787	489	6276	0.00690
ERR6913276	Corynebacterium matruchotii	43768	S	2836	23	2859	0.00314
ERR6913276	Corynebacterium ihumii	1232427	S	2747	202	2949	0.00324
ERR6913276	Corynebacterium kefirresidentii	1979527	S	1782	200	1982	0.00218
ERR6913276	Corynebacterium jeikeium	38289	S	1151	484	1635	0.00180
ERR6913276	Corynebacterium sp. SCR221107	3017361	S	382	15	397	0.00044
ERR6913276	Corynebacterium sp. FDAARGOS 1242	2778078	S	210	142	352	0.00039
ERR6913276	Corynebacterium sp. CNCTC7651	2815361	S	76	3	79	0.00009
ERR6913276	Corynebacterium sp. sy039	2599641	S	27	0	27	0.00003
ERR6913276	Corynebacterium sp. NML98-0116	702967	S	25	28	53	0.00006
ERR6913276	Corynebacterium genitalium	38288	S	669	24	693	0.00076
ERR6913276	Corynebacterium amycolatum	43765	S	627	1049	1676	0.00184
ERR6913276	Corynebacterium glucuronolyticum	39791	S	593	13	606	0.00067
ERR6913276	Corynebacterium xerosis	1725	S	550	54	604	0.00066
ERR6913276	Corynebacterium sanguinis	2594913	S	526	54	580	0.00064
ERR6913276	Corynebacterium pseudodiphtheriticum	37637	S	491	31	522	0.00057
ERR6913276	Corynebacterium ureicelerivorans	401472	S	431	29	460	0.00051
ERR6913276	Corynebacterium variabile	1727	S	419	27	446	0.00049
ERR6913276	Corynebacterium minutissimum	38301	S	347	91	438	0.00048
ERR6913276	Corynebacterium kroppenstedtii	161879	S	343	3	346	0.00038
ERR6913276	Corynebacterium lujinxingii	2763010	S	312	20	332	0.00037
ERR6913276	Corynebacterium aurimucosum	169292	S	308	21	329	0.00036
ERR6913276	Corynebacterium jeddahense	1414719	S	267	22	289	0.00032
ERR6913276	Corynebacterium coyleae	53374	S	227	12	239	0.00026
ERR6913276	Corynebacterium singulare	161899	S	182	15	197	0.00022
ERR6913276	Corynebacterium accolens	38284	S	181	119	300	0.00033
ERR6913276	Corynebacterium simulans	146827	S	177	26	203	0.00022
ERR6913276	Corynebacterium segmentosum	43990	S	163	109	272	0.00030
ERR6913276	Corynebacterium macginleyi	38290	S	146	6	152	0.00017
ERR6913276	Corynebacterium striatum	43770	S	143	17	160	0.00018
ERR6913276	Corynebacterium riegelii	156976	S	120	5	125	0.00014
ERR6913276	Corynebacterium propinquum	43769	S	111	7	118	0.00013
ERR6913276	Corynebacterium imitans	156978	S	108	5	113	0.00012
ERR6913276	Corynebacterium urealyticum	43771	S	102	6	108	0.00012
ERR6913276	Corynebacterium glaucum	187491	S	89	3	92	0.00010
ERR6913276	Corynebacterium mycetoides	38302	S	78	7	85	0.00009
ERR6913276	Corynebacterium efficiens	152794	S	74	2	76	0.00008
ERR6913276	Corynebacterium falsenii	108486	S	73	2	75	0.00008
ERR6913276	Corynebacterium zhongnanshanii	2768834	S	72	1	73	0.00008
ERR6913276	Corynebacterium urogenitale	2487892	S	70	1	71	0.00008
ERR6913276	Corynebacterium provencense	1737425	S	69	2	71	0.00008
ERR6913276	Corynebacterium aquilae	203263	S	68	1	69	0.00008
ERR6913276	Corynebacterium argentoratense	42817	S	63	1	64	0.00007
ERR6913276	Corynebacterium massiliense	441501	S	59	2	61	0.00007
ERR6913276	Corynebacterium timonense	441500	S	58	2	60	0.00007
ERR6913276	Corynebacterium diphtheriae	1717	S	52	30	82	0.00009
ERR6913276	Corynebacterium ulcerans	65058	S	51	7	58	0.00006
ERR6913276	Corynebacterium qintianiae	2709392	S	51	3	54	0.00006
ERR6913276	Corynebacterium pseudogenitalium	38303	S	51	56	107	0.00012
ERR6913276	Corynebacterium lactis	1231000	S	50	1	51	0.00006
ERR6913276	Corynebacterium doosanense	1121358	S	49	2	51	0.00006
ERR6913276	Corynebacterium resistens	258224	S	46	3	49	0.00005
ERR6913276	Corynebacterium incognita	2754725	S	45	1	46	0.00005
ERR6913276	Corynebacterium yudongzhengii	2080740	S	45	2	47	0.00005
ERR6913276	Corynebacterium flavescens	28028	S	44	1	45	0.00005
ERR6913276	Corynebacterium callunae	1721	S	44	2	46	0.00005
ERR6913276	Corynebacterium hindlerae	699041	S	43	0	43	0.00005
ERR6913276	Corynebacterium cystitidis	35757	S	43	0	43	0.00005
ERR6913276	Corynebacterium poyangense	2684405	S	43	0	43	0.00005
ERR6913276	Corynebacterium freneyi	134034	S	42	3	45	0.00005
ERR6913276	Corynebacterium kutscheri	35755	S	42	0	42	0.00005
ERR6913276	Corynebacterium uterequi	1072256	S	39	1	40	0.00004
ERR6913276	Corynebacterium casei	160386	S	38	2	40	0.00004
ERR6913276	Corynebacterium choanae	1862358	S	36	0	36	0.00004
ERR6913276	Corynebacterium testudinoris	136857	S	33	1	34	0.00004
ERR6913276	Corynebacterium anserum	2684406	S	33	0	33	0.00004
ERR6913276	Corynebacterium glutamicum	1718	S	32	95	127	0.00014
ERR6913276	Corynebacterium phocae	161895	S	32	0	32	0.00004
ERR6913276	Corynebacterium endometrii	2488819	S	31	0	31	0.00003
ERR6913276	Corynebacterium glyciniphilum	1404244	S	31	0	31	0.00003
ERR6913276	Corynebacterium stationis	1705	S	31	1	32	0.00004
ERR6913276	Corynebacterium kalinowskii	2675216	S	30	0	30	0.00003
ERR6913276	Corynebacterium lizhenjunii	2709394	S	30	0	30	0.00003
ERR6913276	Corynebacterium renale	1724	S	30	0	30	0.00003
ERR6913276	Corynebacterium vitaeruminis	38305	S	29	1	30	0.00003
ERR6913276	Corynebacterium maris	575200	S	28	1	29	0.00003
ERR6913276	Corynebacterium camporealensis	161896	S	28	1	29	0.00003
ERR6913276	Corynebacterium terpenotabidum	89154	S	27	1	28	0.00003
ERR6913276	Corynebacterium liangguodongii	2079535	S	26	1	27	0.00003
ERR6913276	Corynebacterium marinum	349751	S	25	2	27	0.00003
ERR6913276	Corynebacterium halotolerans	225326	S	25	1	26	0.00003
ERR6913276	Corynebacterium pelargi	1471400	S	25	2	27	0.00003
ERR6913276	Corynebacterium uberis	2883169	S	24	0	24	0.00003
ERR6913276	Corynebacterium sphenisci	191493	S	24	1	25	0.00003
ERR6913276	Corynebacterium cyclohexanicum	322009	S	24	0	24	0.00003
ERR6913276	Corynebacterium humireducens	1223514	S	24	1	25	0.00003
ERR6913276	Corynebacterium nuruki	1032851	S	24	1	25	0.00003
ERR6913276	Corynebacterium frankenforstense	1230998	S	23	1	24	0.00003
ERR6913276	Corynebacterium occultum	2675219	S	23	0	23	0.00003
ERR6913276	Corynebacterium ammoniagenes	1697	S	21	0	21	0.00002
ERR6913276	Corynebacterium gerontici	2079234	S	19	0	19	0.00002
ERR6913276	Corynebacterium mustelae	571915	S	19	0	19	0.00002
ERR6913276	Corynebacterium bovis	36808	S	17	0	17	0.00002
ERR6913276	Corynebacterium suranareeae	2506452	S	17	1	18	0.00002
ERR6913276	Corynebacterium heidelbergense	2055947	S	16	0	16	0.00002
ERR6913276	Corynebacterium deserti	1408191	S	15	0	15	0.00002
ERR6913276	Corynebacterium atypicum	191610	S	15	0	15	0.00002
ERR6913276	Corynebacterium rouxii	2719119	S	15	2	17	0.00002
ERR6913276	Corynebacterium comes	2675218	S	13	0	13	0.00001
ERR6913276	Corynebacterium crudilactis	1652495	S	13	1	14	0.00002
ERR6913276	Corynebacterium pseudopelargi	2080757	S	12	1	13	0.00001
ERR6913276	Corynebacterium pseudotuberculosis	1719	S	12	0	12	0.00001
ERR6913276	Corynebacterium epidermidicanis	1050174	S	7	0	7	0.00001
ERR6913276	Corynebacterium silvaticum	2320431	S	5	0	5	0.00001
ERR6913276	Lawsonella clevelandensis	1528099	S	4575	105	4680	0.00515
ERR6913276	Mycolicibacterium fortuitum	1766	S	48	14	62	0.00007
ERR6913276	Mycolicibacterium fluoranthenivorans	258505	S	32	3	35	0.00004
ERR6913276	Mycolicibacterium sp. YH-1	2908837	S	11	21	32	0.00004
ERR6913276	Mycolicibacterium neoaurum	1795	S	29	5	34	0.00004
ERR6913276	Mycolicibacterium doricum	126673	S	28	5	33	0.00004
ERR6913276	Mycolicibacterium boenickei	146017	S	27	17	44	0.00005
ERR6913276	Mycolicibacterium thermoresistibile	1797	S	25	4	29	0.00003
ERR6913276	Mycolicibacterium aurum	1791	S	23	2	25	0.00003
ERR6913276	Mycolicibacterium celeriflavum	1249101	S	23	4	27	0.00003
ERR6913276	Mycolicibacterium poriferae	39694	S	23	5	28	0.00003
ERR6913276	Mycolicibacterium litorale	758802	S	22	5	27	0.00003
ERR6913276	Mycolicibacterium chubuense	1800	S	21	4	25	0.00003
ERR6913276	Mycolicibacterium parafortuitum	39692	S	20	3	23	0.00003
ERR6913276	Mycolicibacterium moriokaense	39691	S	19	2	21	0.00002
ERR6913276	Mycolicibacterium goodii	134601	S	18	3	21	0.00002
ERR6913276	Mycolicibacterium rhodesiae	36814	S	18	2	20	0.00002
ERR6913276	Mycolicibacterium monacense	85693	S	17	4	21	0.00002
ERR6913276	Mycolicibacterium alvei	67081	S	17	5	22	0.00002
ERR6913276	Mycolicibacterium mucogenicum	56689	S	17	5	22	0.00002
ERR6913276	Mycolicibacterium insubricum	444597	S	17	3	20	0.00002
ERR6913276	Mycolicibacterium smegmatis	1772	S	17	4	21	0.00002
ERR6913276	Mycolicibacterium madagascariense	212765	S	16	1	17	0.00002
ERR6913276	Mycolicibacterium rufum	318424	S	16	5	21	0.00002
ERR6913276	Mycolicibacterium sediminis	1286180	S	16	2	18	0.00002
ERR6913276	Mycolicibacterium arabiense	1286181	S	16	1	17	0.00002
ERR6913276	Mycolicibacterium phocaicum	319706	S	14	5	19	0.00002
ERR6913276	Mycolicibacterium baixiangningiae	2761578	S	14	1	15	0.00002
ERR6913276	Mycolicibacterium fallax	1793	S	14	4	18	0.00002
ERR6913276	Mycolicibacterium austroafricanum	39687	S	14	37	51	0.00006
ERR6913276	Mycolicibacterium gilvum	1804	S	14	5	19	0.00002
ERR6913276	Mycolicibacterium hassiacum	46351	S	13	2	15	0.00002
ERR6913276	Mycolicibacterium brumae	85968	S	13	3	16	0.00002
ERR6913276	Mycolicibacterium mageritense	53462	S	13	2	15	0.00002
ERR6913276	Mycolicibacterium gadium	1794	S	13	1	14	0.00002
ERR6913276	Mycolicibacterium confluentis	28047	S	13	1	14	0.00002
ERR6913276	Mycolicibacterium psychrotolerans	216929	S	12	2	14	0.00002
ERR6913276	Mycolicibacterium aichiense	1799	S	11	2	13	0.00001
ERR6913276	Mycolicibacterium vaccae	1810	S	11	2	13	0.00001
ERR6913276	Mycolicibacterium phlei	1771	S	10	2	12	0.00001
ERR6913276	Mycolicibacterium duvalii	39688	S	10	1	11	0.00001
ERR6913276	Mycolicibacterium tokaiense	39695	S	10	1	11	0.00001
ERR6913276	Mycolicibacterium farcinogenes	1802	S	7	9	16	0.00002
ERR6913276	Mycolicibacterium vanbaalenii	110539	S	7	41	48	0.00005
ERR6913276	Mycolicibacterium sarraceniae	1534348	S	6	0	6	0.00001
ERR6913276	Mycolicibacterium chitae	1792	S	6	1	7	0.00001
ERR6913276	Mycolicibacterium mengxianglii	2736649	S	6	0	6	0.00001
ERR6913276	Mycobacterium sp. SMC-4	2857059	S	18	10	28	0.00003
ERR6913276	Mycobacterium sp. JS623	212767	S	17	1	18	0.00002
ERR6913276	Mycobacterium sp. YC-RL4	1682113	S	15	5	20	0.00002
ERR6913276	Mycobacterium sp. IDR2000157661	2867005	S	14	3	17	0.00002
ERR6913276	Mycobacterium sp. SMC-8	2857060	S	14	9	23	0.00003
ERR6913276	Mycobacterium sp. MS1601	1936029	S	13	2	15	0.00002
ERR6913276	Mycobacterium sp. SMC-2	2857058	S	11	1	12	0.00001
ERR6913276	Mycobacterium sp. DL592	2675524	S	7	1	8	0.00001
ERR6913276	Mycobacterium sp. DL440	2675523	S	7	2	9	0.00001
ERR6913276	Mycobacterium sp. Aquia_216	2991729	S	5	0	5	0.00001
ERR6913276	Mycobacterium lentiflavum	141349	S	47	9	56	0.00006
ERR6913276	Mycobacterium stomatepiae	470076	S	19	3	22	0.00002
ERR6913276	Mycobacterium simiae	1784	S	12	1	13	0.00001
ERR6913276	Mycobacterium parmense	185642	S	12	2	14	0.00002
ERR6913276	Mycobacterium kubicae	120959	S	10	1	11	0.00001
ERR6913276	Mycobacterium saskatchewanense	220927	S	10	1	11	0.00001
ERR6913276	Mycobacterium heidelbergense	53376	S	8	1	9	0.00001
ERR6913276	Mycobacterium florentinum	292462	S	8	1	9	0.00001
ERR6913276	Mycobacterium intracellulare	1767	S	25	63	88	0.00010
ERR6913276	Mycobacterium avium	1764	S	19	14	33	0.00004
ERR6913276	Mycobacterium mantenii	560555	S	9	1	10	0.00001
ERR6913276	Mycobacterium senriense	2775496	S	8	1	9	0.00001
ERR6913276	Mycobacterium gordonae	1778	S	53	4	57	0.00006
ERR6913276	Mycobacterium frederiksbergense	117567	S	24	8	32	0.00004
ERR6913276	Mycobacterium kansasii	1768	S	23	3	26	0.00003
ERR6913276	Mycobacterium tuberculosis	1773	S	11	91	102	0.00011
ERR6913276	Mycobacterium canettii	78331	S	11	4	15	0.00002
ERR6913276	Mycobacterium paragordonae	1389713	S	18	2	20	0.00002
ERR6913276	Mycobacterium shinjukuense	398694	S	18	2	20	0.00002
ERR6913276	Mycobacterium heckeshornense	110505	S	17	1	18	0.00002
ERR6913276	Mycobacterium spongiae	886343	S	16	0	16	0.00002
ERR6913276	Mycobacterium haemophilum	29311	S	14	0	14	0.00002
ERR6913276	Mycobacterium noviomagense	459858	S	13	1	14	0.00002
ERR6913276	Mycobacterium virginiense	1795032	S	12	4	16	0.00002
ERR6913276	Mycobacterium cookii	1775	S	11	1	12	0.00001
ERR6913276	Mycobacterium riyadhense	486698	S	11	0	11	0.00001
ERR6913276	Mycobacterium grossiae	1552759	S	10	2	12	0.00001
ERR6913276	Mycobacterium paraseoulense	590652	S	10	2	12	0.00001
ERR6913276	Mycobacterium paraterrae	577492	S	9	0	9	0.00001
ERR6913276	Mycobacterium basiliense	2094119	S	8	0	8	0.00001
ERR6913276	Mycobacterium vicinigordonae	1719132	S	8	0	8	0.00001
ERR6913276	Mycobacterium lacus	169765	S	7	0	7	0.00001
ERR6913276	Mycobacterium dioxanotrophicus	482462	S	6	1	7	0.00001
ERR6913276	Mycobacterium branderi	43348	S	6	0	6	0.00001
ERR6913276	Mycobacterium xenopi	1789	S	5	0	5	0.00001
ERR6913276	Mycobacterium seoulense	386911	S	5	1	6	0.00001
ERR6913276	Mycobacteroides chelonae	1774	S	98	32	130	0.00014
ERR6913276	Mycobacteroides abscessus	36809	S	41	11	52	0.00006
ERR6913276	Mycobacteroides salmoniphilum	404941	S	6	0	6	0.00001
ERR6913276	[Mycobacterium] stephanolepidis	1520670	S	6	2	8	0.00001
ERR6913276	Mycobacteroides saopaulense	1578165	S	5	0	5	0.00001
ERR6913276	Mycolicibacter sp. MYC340	2855503	S	10	3	13	0.00001
ERR6913276	Mycolicibacter sp. MYC098	2872309	S	7	2	9	0.00001
ERR6913276	Mycolicibacter terrae	1788	S	13	4	17	0.00002
ERR6913276	Mycolicibacter hiberniae	29314	S	9	1	10	0.00001
ERR6913276	Hoyosella subflava	639313	S	28	0	28	0.00003
ERR6913276	Mycolicibacillus koreensis	1069220	S	11	2	13	0.00001
ERR6913276	Mycolicibacillus parakoreensis	1069221	S	6	1	7	0.00001
ERR6913276	Rhodococcus sp. ABRD24	2507582	S	36	5	41	0.00005
ERR6913276	Rhodococcus sp. PBTS 1	1653478	S	29	3	32	0.00004
ERR6913276	Rhodococcus sp. B7740	1564114	S	26	2	28	0.00003
ERR6913276	Rhodococcus sp. WMMA185	679318	S	25	1	26	0.00003
ERR6913276	Rhodococcus sp. USK13	2806442	S	21	15	36	0.00004
ERR6913276	Rhodococcus sp. P1Y	1302308	S	20	0	20	0.00002
ERR6913276	Rhodococcus sp. MTM3W5.2	1805827	S	18	2	20	0.00002
ERR6913276	Rhodococcus sp. YL-1	1045808	S	12	32	44	0.00005
ERR6913276	Rhodococcus sp. SGAir0479	2567884	S	10	3	13	0.00001
ERR6913276	Rhodococcus sp. Z13	2962047	S	9	1	10	0.00001
ERR6913276	Rhodococcus sp. WAY2	2663121	S	8	8	16	0.00002
ERR6913276	Rhodococcus sp. X156	2499145	S	8	0	8	0.00001
ERR6913276	Rhodococcus sp. W8901	2742603	S	7	1	8	0.00001
ERR6913276	Rhodococcus sp. H-CA8f	1727214	S	7	18	25	0.00003
ERR6913276	Rhodococcus sp. ZPP	2749906	S	6	11	17	0.00002
ERR6913276	Rhodococcus sp. USK10	2789739	S	5	2	7	0.00001
ERR6913276	Rhodococcus fascians	1828	S	300	24	324	0.00036
ERR6913276	Rhodococcus qingshengii	334542	S	59	217	276	0.00030
ERR6913276	Rhodococcus erythropolis	1833	S	45	155	200	0.00022
ERR6913276	Rhodococcus globerulus	33008	S	30	1	31	0.00003
ERR6913276	Rhodococcus opacus	37919	S	22	14	36	0.00004
ERR6913276	Rhodococcus ruber	1830	S	16	37	53	0.00006
ERR6913276	Rhodococcus coprophilus	38310	S	13	0	13	0.00001
ERR6913276	Rhodococcus pyridinivorans	103816	S	12	35	47	0.00005
ERR6913276	Rhodococcus jostii	132919	S	10	3	13	0.00001
ERR6913276	Rhodococcus aetherivorans	191292	S	9	61	70	0.00008
ERR6913276	Rhodococcus rhodochrous	1829	S	8	6	14	0.00002
ERR6913276	Rhodococcus pseudokoreensis	2811421	S	7	2	9	0.00001
ERR6913276	Rhodococcus gordoniae	223392	S	6	1	7	0.00001
ERR6913276	Rhodococcus koreensis	99653	S	5	1	6	0.00001
ERR6913276	Nocardia cyriacigeorgica	135487	S	52	14	66	0.00007
ERR6913276	Nocardia brasiliensis	37326	S	49	10	59	0.00006
ERR6913276	Nocardia asteroides	1824	S	48	12	60	0.00007
ERR6913276	Nocardia huaxiensis	2755382	S	29	5	34	0.00004
ERR6913276	Nocardia nova	37330	S	26	2	28	0.00003
ERR6913276	Nocardia farcinica	37329	S	20	7	27	0.00003
ERR6913276	Nocardia mangyaensis	2213200	S	20	4	24	0.00003
ERR6913276	Nocardia otitidiscaviarum	1823	S	20	3	23	0.00003
ERR6913276	Nocardia sp. CS682	1047172	S	18	4	22	0.00002
ERR6913276	Nocardia yamanashiensis	209247	S	17	3	20	0.00002
ERR6913276	Nocardia arthritidis	228602	S	16	1	17	0.00002
ERR6913276	Nocardia tengchongensis	2055889	S	15	3	18	0.00002
ERR6913276	Nocardia terpenica	455432	S	14	1	15	0.00002
ERR6913276	Nocardia gipuzkoensis	2749991	S	14	5	19	0.00002
ERR6913276	Nocardia seriolae	37332	S	10	2	12	0.00001
ERR6913276	Nocardia yunnanensis	2382165	S	10	2	12	0.00001
ERR6913276	Nocardia wallacei	480035	S	9	2	11	0.00001
ERR6913276	Prescottella equi	43767	S	6	1	7	0.00001
ERR6913276	Gordonia sp. PDNC005	2811424	S	36	2	38	0.00004
ERR6913276	Gordonia sp. SL306	2995145	S	24	2	26	0.00003
ERR6913276	Gordonia sp. KTR9	337191	S	18	2	20	0.00002
ERR6913276	Gordonia sp. YC-JH1	2059875	S	11	3	14	0.00002
ERR6913276	Gordonia sp. WA4-43	2878678	S	5	7	12	0.00001
ERR6913276	Gordonia polyisoprenivorans	84595	S	82	14	96	0.00011
ERR6913276	Gordonia bronchialis	2054	S	79	10	89	0.00010
ERR6913276	Gordonia otitidis	249058	S	76	8	84	0.00009
ERR6913276	Gordonia alkanivorans	84096	S	40	71	111	0.00012
ERR6913276	Gordonia amicalis	89053	S	21	66	87	0.00010
ERR6913276	Gordonia mangrovi	2665643	S	19	1	20	0.00002
ERR6913276	Gordonia iterans	1004901	S	18	3	21	0.00002
ERR6913276	Gordonia rubripertincta	36822	S	16	5	21	0.00002
ERR6913276	Gordonia phthalatica	1136941	S	14	1	15	0.00002
ERR6913276	Gordonia terrae	2055	S	13	3	16	0.00002
ERR6913276	Gordonia zhaorongruii	2597659	S	13	1	14	0.00002
ERR6913276	Gordonia insulae	2420509	S	12	1	13	0.00001
ERR6913276	Gordonia hongkongensis	1701090	S	11	16	27	0.00003
ERR6913276	Gordonia pseudamarae	2831662	S	10	1	11	0.00001
ERR6913276	Gordonia amarae	36821	S	6	0	6	0.00001
ERR6913276	Skermania piniformis	39122	S	27	19	46	0.00005
ERR6913276	Dietzia sp. oral taxon 368	712270	S	111	76	187	0.00021
ERR6913276	Dietzia sp. B32	2915130	S	20	9	29	0.00003
ERR6913276	Dietzia kunjamensis	322509	S	48	22	70	0.00008
ERR6913276	Dietzia lutea	546160	S	41	12	53	0.00006
ERR6913276	Dietzia psychralcaliphila	139021	S	34	5	39	0.00004
ERR6913276	Dietzia timorensis	499555	S	19	3	22	0.00002
ERR6913276	Tsukamurella paurometabola	2061	S	45	6	51	0.00006
ERR6913276	Tsukamurella tyrosinosolvens	57704	S	26	6	32	0.00004
ERR6913276	Tsukamurella pulmonis	47312	S	19	3	22	0.00002
ERR6913276	Tomitella gaofuii	2760083	S	16	1	17	0.00002
ERR6913276	Tomitella fengzijianii	2597660	S	9	0	9	0.00001
ERR6913276	Segniliparus rotundus	286802	S	13	0	13	0.00001
ERR6913276	Actinomyces sp. oral taxon 169	712116	S	909	264	1173	0.00129
ERR6913276	Actinomyces sp. oral taxon 171	706438	S	458	51	509	0.00056
ERR6913276	Actinomyces sp. oral taxon 414	712122	S	408	12	420	0.00046
ERR6913276	Actinomyces sp. HMT 175	2789425	S	324	227	551	0.00061
ERR6913276	Actinomyces sp. oral taxon 897	2081702	S	70	78	148	0.00016
ERR6913276	Actinomyces sp. HMT897	2789424	S	69	75	144	0.00016
ERR6913276	Actinomyces sp. MAS-1	2755559	S	54	1	55	0.00006
ERR6913276	Actinomyces sp. Chiba101	1851395	S	22	1	23	0.00003
ERR6913276	Actinomyces sp. 432	2057798	S	22	0	22	0.00002
ERR6913276	Actinomyces sp. Z16	2079536	S	20	1	21	0.00002
ERR6913276	Actinomyces oris	544580	S	2274	726	3000	0.00330
ERR6913276	Actinomyces naeslundii	1655	S	878	57	935	0.00103
ERR6913276	Actinomyces viscosus	1656	S	225	14	239	0.00026
ERR6913276	Actinomyces pacaensis	1852377	S	49	1	50	0.00005
ERR6913276	Actinomyces radicidentis	111015	S	43	1	44	0.00005
ERR6913276	Actinomyces howellii	52771	S	42	0	42	0.00005
ERR6913276	Actinomyces faecalis	2722820	S	41	0	41	0.00005
ERR6913276	Actinomyces slackii	52774	S	35	0	35	0.00004
ERR6913276	Actinomyces qiguomingii	2057800	S	32	0	32	0.00004
ERR6913276	Actinomyces trachealis	2763540	S	29	0	29	0.00003
ERR6913276	Actinomyces marmotae	2737173	S	29	2	31	0.00003
ERR6913276	Actinomyces gaoshouyii	1960083	S	24	1	25	0.00003
ERR6913276	Actinomyces weissii	675090	S	22	0	22	0.00002
ERR6913276	Actinomyces procaprae	2560010	S	20	1	21	0.00002
ERR6913276	Actinomyces respiraculi	2744574	S	17	0	17	0.00002
ERR6913276	Actinomyces wuliandei	2057743	S	9	0	9	0.00001
ERR6913276	Schaalia odontolytica	1660	S	776	57	833	0.00092
ERR6913276	Schaalia meyeri	52773	S	43	4	47	0.00005
ERR6913276	Schaalia radingae	131110	S	33	0	33	0.00004
ERR6913276	Schaalia sp. JY-X169	2758572	S	16	0	16	0.00002
ERR6913276	Schaalia sp. 19OD2882	2794089	S	12	0	12	0.00001
ERR6913276	Schaalia cardiffensis	181487	S	14	0	14	0.00002
ERR6913276	Schaalia turicensis	131111	S	12	0	12	0.00001
ERR6913276	Pauljensenia hongkongensis	178339	S	447	36	483	0.00053
ERR6913276	Winkia neuii	33007	S	159	9	168	0.00018
ERR6913276	Varibaculum prostatecancerukia	2811781	S	113	2	115	0.00013
ERR6913276	Trueperella pecoris	2733571	S	26	1	27	0.00003
ERR6913276	Trueperella pyogenes	1661	S	13	0	13	0.00001
ERR6913276	Trueperella bialowiezensis	312285	S	7	0	7	0.00001
ERR6913276	Flaviflexus salsibiostraticola	1282737	S	13	2	15	0.00002
ERR6913276	Flaviflexus ciconiae	2496867	S	13	1	14	0.00002
ERR6913276	Flaviflexus equikiangi	2758573	S	12	1	13	0.00001
ERR6913276	Changpingibacter yushuensis	2758440	S	33	0	33	0.00004
ERR6913276	Mobiluncus curtisii	2051	S	28	0	28	0.00003
ERR6913276	Fannyhessea vaginae	82135	S	21	0	21	0.00002
ERR6913276	Nanchangia anserum	2692125	S	20	0	20	0.00002
ERR6913276	Boudabousia tangfeifanii	1912795	S	17	0	17	0.00002
ERR6913276	Arcanobacterium pinnipediorum	1503041	S	6	2	8	0.00001
ERR6913276	Actinotignum schaalii	59505	S	9	0	9	0.00001
ERR6913276	Actinobaculum sp. 313	2495645	S	8	0	8	0.00001
ERR6913276	Streptomyces sp. T12	477697	S	84	27	111	0.00012
ERR6913276	Streptomyces sp. NA02950	2742137	S	31	4	35	0.00004
ERR6913276	Streptomyces sp. SN-593	659352	S	26	2	28	0.00003
ERR6913276	Streptomyces sp. MA3_2.13	2867410	S	23	1	24	0.00003
ERR6913276	Streptomyces sp. ST1015	1848900	S	22	3	25	0.00003
ERR6913276	Streptomyces sp. So13.3	2136173	S	20	1	21	0.00002
ERR6913276	Streptomyces sp. SCUT-3	2684469	S	19	2	21	0.00002
ERR6913276	Streptomyces sp. RerS4	2942449	S	18	4	22	0.00002
ERR6913276	Streptomyces sp. Go40/10	2825844	S	18	9	27	0.00003
ERR6913276	Streptomyces sp. fd1-xmd	1812480	S	17	9	26	0.00003
ERR6913276	Streptomyces sp. LRE541	2931983	S	16	3	19	0.00002
ERR6913276	Streptomyces sp. SirexAA-E	862751	S	16	4	20	0.00002
ERR6913276	Streptomyces sp. MOE7	1961713	S	15	24	39	0.00004
ERR6913276	Streptomyces sp. CB01881	2078691	S	13	1	14	0.00002
ERR6913276	Streptomyces sp. CA-210063	2801029	S	13	7	20	0.00002
ERR6913276	Streptomyces sp. YIM 121038	2136401	S	13	3	16	0.00002
ERR6913276	Streptomyces sp. HP-A2021	2927875	S	12	8	20	0.00002
ERR6913276	Streptomyces sp. SYP-A7193	2662065	S	12	9	21	0.00002
ERR6913276	Streptomyces sp. Rer75	2750011	S	11	10	21	0.00002
ERR6913276	Streptomyces sp. WAC 01529	2203205	S	11	4	15	0.00002
ERR6913276	Streptomyces sp. SAT1	1849967	S	11	2	13	0.00001
ERR6913276	Streptomyces sp. S465	2979468	S	11	3	14	0.00002
ERR6913276	Streptomyces sp. Jing01	2726118	S	11	7	18	0.00002
ERR6913276	Streptomyces sp. BH-MK-02	2880933	S	10	1	11	0.00001
ERR6913276	Streptomyces sp. DSM 40868	2721173	S	10	3	13	0.00001
ERR6913276	Streptomyces sp. HUAS 15-9	2981136	S	9	2	11	0.00001
ERR6913276	Streptomyces sp. HSG2	2797167	S	9	0	9	0.00001
ERR6913276	Streptomyces sp. NA04227	2742136	S	9	1	10	0.00001
ERR6913276	Streptomyces sp. CdTB01	1725411	S	9	2	11	0.00001
ERR6913276	Streptomyces sp. SM18	1736046	S	9	2	11	0.00001
ERR6913276	Streptomyces sp. KMM 9044	2744474	S	9	2	11	0.00001
ERR6913276	Streptomyces sp. HL-66	2964669	S	9	1	10	0.00001
ERR6913276	Streptomyces sp. AMCC400023	2056258	S	9	4	13	0.00001
ERR6913276	Streptomyces sp. HUAS 14-6	2981135	S	9	3	12	0.00001
ERR6913276	Streptomyces sp. QHH-9511	2684468	S	8	1	9	0.00001
ERR6913276	Streptomyces sp. NEAU-sy36	2751189	S	8	2	10	0.00001
ERR6913276	Streptomyces sp. DSM 40750	2801030	S	7	3	10	0.00001
ERR6913276	Streptomyces sp. Tu 2975	2676871	S	7	2	9	0.00001
ERR6913276	Streptomyces sp. ST13-2-2	2879846	S	7	1	8	0.00001
ERR6913276	Streptomyces sp. WAC 01438	2203204	S	7	2	9	0.00001
ERR6913276	Streptomyces sp. MBT27	1488356	S	7	1	8	0.00001
ERR6913276	Streptomyces sp. MMBL 11-1	3026420	S	7	4	11	0.00001
ERR6913276	Streptomyces sp. FIT100	2837956	S	7	2	9	0.00001
ERR6913276	Streptomyces sp. HUAS 13-4	2981134	S	7	1	8	0.00001
ERR6913276	Streptomyces sp. Z423-1	2730915	S	7	2	9	0.00001
ERR6913276	Streptomyces sp. Je 1-369	2966192	S	7	3	10	0.00001
ERR6913276	Streptomyces sp. 769	1262452	S	6	5	11	0.00001
ERR6913276	Streptomyces sp. W1SF4	2305220	S	6	1	7	0.00001
ERR6913276	Streptomyces sp. MST-110588	2833628	S	6	0	6	0.00001
ERR6913276	Streptomyces sp. RPA4-5	2721245	S	6	5	11	0.00001
ERR6913276	Streptomyces sp. GMY02	1333528	S	6	0	6	0.00001
ERR6913276	Streptomyces sp. HUAS 2-6	3004093	S	6	2	8	0.00001
ERR6913276	Streptomyces sp. HNA39	2850561	S	6	9	15	0.00002
ERR6913276	Streptomyces sp. CRSS-Y-16	2906474	S	6	89	95	0.00010
ERR6913276	Streptomyces sp. NEAU-S7GS2	2202000	S	5	12	17	0.00002
ERR6913276	Streptomyces sp. 3214.6	1882757	S	5	1	6	0.00001
ERR6913276	Streptomyces sp. VB1	2986803	S	5	38	43	0.00005
ERR6913276	Streptomyces sp. 135	2838850	S	5	1	6	0.00001
ERR6913276	Streptomyces sp. C8S0	2585716	S	5	0	5	0.00001
ERR6913276	Streptomyces sp. AgN23	1188315	S	5	6	11	0.00001
ERR6913276	Streptomyces sp. S8	1837283	S	5	6	11	0.00001
ERR6913276	Streptomyces sp. S4.7	2705439	S	5	1	6	0.00001
ERR6913276	Streptomyces hygroscopicus	1912	S	30	30	60	0.00007
ERR6913276	Streptomyces rapamycinicus	1226757	S	15	4	19	0.00002
ERR6913276	Streptomyces yatensis	155177	S	12	10	22	0.00002
ERR6913276	Streptomyces violaceusniger	68280	S	7	5	12	0.00001
ERR6913276	Streptomyces venezuelae	54571	S	51	15	66	0.00007
ERR6913276	Streptomyces anulatus	1892	S	20	26	46	0.00005
ERR6913276	Streptomyces griseus	1911	S	19	10	29	0.00003
ERR6913276	Streptomyces aurantiacus	47760	S	16	2	18	0.00002
ERR6913276	Streptomyces qaidamensis	1783515	S	10	4	14	0.00002
ERR6913276	Streptomyces cadmiisoli	2184053	S	9	1	10	0.00001
ERR6913276	Streptomyces viridosporus	67581	S	33	10	43	0.00005
ERR6913276	Streptomyces xinghaiensis	1038928	S	29	3	32	0.00004
ERR6913276	Streptomyces akebiae	2865673	S	28	11	39	0.00004
ERR6913276	Streptomyces niveus	193462	S	28	5	33	0.00004
ERR6913276	Streptomyces tanashiensis	67367	S	26	8	34	0.00004
ERR6913276	Streptomyces lydicus	47763	S	23	18	41	0.00005
ERR6913276	Streptomyces marincola	2878388	S	23	1	24	0.00003
ERR6913276	Streptomyces ferrugineus	1413221	S	22	6	28	0.00003
ERR6913276	Streptomyces liangshanensis	2717324	S	21	2	23	0.00003
ERR6913276	Streptomyces avermitilis	33903	S	20	4	24	0.00003
ERR6913276	Streptomyces angustmyceticus	285578	S	20	6	26	0.00003
ERR6913276	Streptomyces pratensis	1169025	S	19	3	22	0.00002
ERR6913276	Streptomyces lusitanus	68232	S	19	8	27	0.00003
ERR6913276	Streptomyces coeruleorubidus	116188	S	18	9	27	0.00003
ERR6913276	Streptomyces armeniacus	83291	S	17	1	18	0.00002
ERR6913276	Streptomyces drozdowiczii	202862	S	16	2	18	0.00002
ERR6913276	Streptomyces roseochromogenus	285450	S	16	4	20	0.00002
ERR6913276	Streptomyces tsukubensis	83656	S	16	2	18	0.00002
ERR6913276	Streptomyces aureoverticillatus	66871	S	16	3	19	0.00002
ERR6913276	Streptomyces buecherae	2763006	S	15	1	16	0.00002
ERR6913276	Streptomyces genisteinicus	2768068	S	15	2	17	0.00002
ERR6913276	Streptomyces albus	1888	S	14	16	30	0.00003
ERR6913276	Streptomyces griseocarneus	51201	S	14	2	16	0.00002
ERR6913276	Streptomyces pactum	68249	S	14	4	18	0.00002
ERR6913276	Streptomyces vinaceus	1960	S	14	3	17	0.00002
ERR6913276	Streptomyces spectabilis	68270	S	13	3	16	0.00002
ERR6913276	Streptomyces alboflavus	67267	S	13	2	15	0.00002
ERR6913276	Streptomyces clavuligerus	1901	S	13	1	14	0.00002
ERR6913276	Streptomyces dangxiongensis	1442032	S	13	3	16	0.00002
ERR6913276	Streptomyces asoensis	249586	S	13	3	16	0.00002
ERR6913276	Streptomyces nigrescens	1920	S	12	6	18	0.00002
ERR6913276	Streptomyces vietnamensis	362257	S	12	3	15	0.00002
ERR6913276	Streptomyces griseorubiginosus	67304	S	12	3	15	0.00002
ERR6913276	Streptomyces fagopyri	2662397	S	12	3	15	0.00002
ERR6913276	Streptomyces xanthophaeus	67385	S	12	2	14	0.00002
ERR6913276	Streptomyces atratus	1893	S	12	1	13	0.00001
ERR6913276	Streptomyces yangpuensis	1648182	S	12	4	16	0.00002
ERR6913276	Streptomyces mobaraensis	35621	S	11	201	212	0.00023
ERR6913276	Streptomyces californicus	67351	S	11	41	52	0.00006
ERR6913276	Streptomyces xanthii	2768069	S	11	1	12	0.00001
ERR6913276	Streptomyces ambofaciens	1889	S	11	6	17	0.00002
ERR6913276	Streptomyces deccanensis	424188	S	11	5	16	0.00002
ERR6913276	Streptomyces nigra	1827580	S	10	2	12	0.00001
ERR6913276	Streptomyces broussonetiae	2686304	S	10	2	12	0.00001
ERR6913276	Streptomyces olivoreticuli	68246	S	10	1	11	0.00001
ERR6913276	Streptomyces formicae	1616117	S	10	3	13	0.00001
ERR6913276	Streptomyces nojiriensis	66374	S	10	4	14	0.00002
ERR6913276	Streptomyces cyaneochromogenes	2496836	S	10	2	12	0.00001
ERR6913276	Streptomyces finlayi	67296	S	9	1	10	0.00001
ERR6913276	Streptomyces qinzhouensis	2599401	S	9	1	10	0.00001
ERR6913276	Streptomyces peucetius	1950	S	9	1	10	0.00001
ERR6913276	Streptomyces lienomycini	284035	S	9	4	13	0.00001
ERR6913276	Streptomyces aquilus	2548456	S	9	2	11	0.00001
ERR6913276	Streptomyces tuirus	68278	S	9	4	13	0.00001
ERR6913276	Streptomyces lunaelactis	1535768	S	9	1	10	0.00001
ERR6913276	Streptomyces harbinensis	1176198	S	8	0	8	0.00001
ERR6913276	Streptomyces thermocarboxydus	59299	S	8	4	12	0.00001
ERR6913276	Streptomyces katrae	68223	S	8	1	9	0.00001
ERR6913276	Streptomyces subrutilus	36818	S	8	1	9	0.00001
ERR6913276	Streptomyces griseoviridis	45398	S	7	1	8	0.00001
ERR6913276	Streptomyces roseirectus	2768066	S	7	1	8	0.00001
ERR6913276	Streptomyces paludis	2282738	S	7	0	7	0.00001
ERR6913276	Streptomyces lincolnensis	1915	S	7	1	8	0.00001
ERR6913276	Streptomyces phaeolivaceus	2653200	S	7	1	8	0.00001
ERR6913276	Streptomyces nitrosporeus	28894	S	7	1	8	0.00001
ERR6913276	Streptomyces rectiverticillatus	173860	S	6	0	6	0.00001
ERR6913276	Streptomyces seoulensis	73044	S	6	1	7	0.00001
ERR6913276	Streptomyces cyanogenus	80860	S	6	2	8	0.00001
ERR6913276	Streptomyces durmitorensis	319947	S	6	0	6	0.00001
ERR6913276	Streptomyces gardneri	66892	S	6	2	8	0.00001
ERR6913276	Streptomyces tubercidicus	47759	S	6	2	8	0.00001
ERR6913276	Streptomyces collinus	42684	S	6	2	8	0.00001
ERR6913276	Streptomyces fungicidicus	68203	S	6	22	28	0.00003
ERR6913276	Streptomyces nodosus	40318	S	6	0	6	0.00001
ERR6913276	Streptomyces lavendulae	1914	S	6	1	7	0.00001
ERR6913276	Streptomyces noursei	1971	S	6	3	9	0.00001
ERR6913276	Streptomyces prasinus	67345	S	6	1	7	0.00001
ERR6913276	Streptomyces tubbatahanensis	2923272	S	5	0	5	0.00001
ERR6913276	Streptomyces luteoverticillatus	66425	S	5	0	5	0.00001
ERR6913276	Streptomyces pluripotens	1355015	S	5	0	5	0.00001
ERR6913276	Streptomyces calvus	67282	S	5	1	6	0.00001
ERR6913276	Streptomyces capitiformicae	2014920	S	5	0	5	0.00001
ERR6913276	Streptomyces murinus	33900	S	5	13	18	0.00002
ERR6913276	Streptomyces rimosus	1927	S	5	0	5	0.00001
ERR6913276	Streptomyces antimycoticus	68175	S	5	7	12	0.00001
ERR6913276	Streptomyces auratus	114687	S	5	4	9	0.00001
ERR6913276	Kitasatospora sp. HUAS 3-15	3004092	S	10	4	14	0.00002
ERR6913276	Kitasatospora sp. MMS16-BH015	2018025	S	9	1	10	0.00001
ERR6913276	Kitasatospora sp. NA04385	2742135	S	6	6	12	0.00001
ERR6913276	Kitasatospora setae	2066	S	7	3	10	0.00001
ERR6913276	Kitasatospora aureofaciens	1894	S	5	2	7	0.00001
ERR6913276	Streptacidiphilus sp. PB12-B1b	2705012	S	30	2	32	0.00004
ERR6913276	Streptacidiphilus sp. P02-A3a	2704468	S	20	1	21	0.00002
ERR6913276	Peterkaempfera bronchialis	2126346	S	17	1	18	0.00002
ERR6913276	Yinghuangia sp. ASG 101	2896848	S	9	0	9	0.00001
ERR6913276	Streptantibioticus cattleyicolor	29303	S	9	0	9	0.00001
ERR6913276	Actinacidiphila bryophytorum	1436133	S	6	0	6	0.00001
ERR6913276	Amycolatopsis sp. WQ 127309	2932773	S	22	2	24	0.00003
ERR6913276	Amycolatopsis sp. Hca4	2742131	S	18	3	21	0.00002
ERR6913276	Amycolatopsis sp. HUAS 11-8	2995223	S	17	1	18	0.00002
ERR6913276	Amycolatopsis sp. AA4	1896961	S	15	4	19	0.00002
ERR6913276	Amycolatopsis sp. FDAARGOS 1241	2778070	S	15	1	16	0.00002
ERR6913276	Amycolatopsis sp. CA-230715	2745196	S	14	0	14	0.00002
ERR6913276	Amycolatopsis sp. BJA-103	1911175	S	12	2	14	0.00002
ERR6913276	Amycolatopsis sp. YIM 10	2653857	S	11	1	12	0.00001
ERR6913276	Amycolatopsis sp. DSM 110486	2865832	S	8	0	8	0.00001
ERR6913276	Amycolatopsis sp. FU40	2914159	S	8	2	10	0.00001
ERR6913276	Amycolatopsis sp. EV170708-02-1	2919322	S	7	3	10	0.00001
ERR6913276	Amycolatopsis roodepoortensis	700274	S	37	15	52	0.00006
ERR6913276	Amycolatopsis aidingensis	2842453	S	17	0	17	0.00002
ERR6913276	Amycolatopsis methanolica	1814	S	14	2	16	0.00002
ERR6913276	Amycolatopsis pretoriensis	218821	S	12	1	13	0.00001
ERR6913276	Amycolatopsis acidiphila	715473	S	11	0	11	0.00001
ERR6913276	Amycolatopsis albispora	1804986	S	11	2	13	0.00001
ERR6913276	Amycolatopsis keratiniphila	129921	S	8	6	14	0.00002
ERR6913276	Amycolatopsis orientalis	31958	S	9	1	10	0.00001
ERR6913276	Amycolatopsis thermalba	944492	S	9	1	10	0.00001
ERR6913276	Amycolatopsis mediterranei	33910	S	5	0	5	0.00001
ERR6913276	Pseudonocardia sp. DSM 110487	2865833	S	32	1	33	0.00004
ERR6913276	Pseudonocardia sp. AL041005-10	445576	S	26	20	46	0.00005
ERR6913276	Pseudonocardia sp. HH130629-09	1641402	S	14	19	33	0.00004
ERR6913276	Pseudonocardia sp. HH130630-07	1690815	S	14	10	24	0.00003
ERR6913276	Pseudonocardia autotrophica	2074	S	34	2	36	0.00004
ERR6913276	Pseudonocardia broussonetiae	2736640	S	24	3	27	0.00003
ERR6913276	Pseudonocardia dioxanivorans	240495	S	21	1	22	0.00002
ERR6913276	Pseudonocardia petroleophila	37331	S	13	4	17	0.00002
ERR6913276	Pseudonocardia abyssalis	2792008	S	12	3	15	0.00002
ERR6913276	Pseudonocardia alaniniphila	75291	S	5	0	5	0.00001
ERR6913276	Saccharopolyspora gloriosae	455344	S	29	3	32	0.00004
ERR6913276	Saccharopolyspora erythraea	1836	S	21	1	22	0.00002
ERR6913276	Saccharopolyspora gregorii	33914	S	15	2	17	0.00002
ERR6913276	Saccharopolyspora sp. ASAGF58	2719023	S	8	11	19	0.00002
ERR6913276	Kutzneria albida	43357	S	56	5	61	0.00007
ERR6913276	Kutzneria chonburiensis	1483604	S	14	2	16	0.00002
ERR6913276	Kutzneria sp. CA-103260	2802641	S	6	1	7	0.00001
ERR6913276	Saccharomonospora viridis	1852	S	25	1	26	0.00003
ERR6913276	Saccharomonospora marina	632569	S	12	1	13	0.00001
ERR6913276	Saccharomonospora cyanea	40989	S	10	1	11	0.00001
ERR6913276	Saccharomonospora azurea	40988	S	8	0	8	0.00001
ERR6913276	Saccharomonospora xinjiangensis	75294	S	7	0	7	0.00001
ERR6913276	Saccharothrix espanaensis	103731	S	22	3	25	0.00003
ERR6913276	Saccharothrix sp. 6-C	2781735	S	15	3	18	0.00002
ERR6913276	Saccharothrix syringae	103733	S	12	2	14	0.00002
ERR6913276	Actinoalloteichus hymeniacidonis	340345	S	13	2	15	0.00002
ERR6913276	Actinoalloteichus hoggarensis	1470176	S	13	9	22	0.00002
ERR6913276	Lentzea sp. HUAS12	2951806	S	17	5	22	0.00002
ERR6913276	Lentzea guizhouensis	1586287	S	10	3	13	0.00001
ERR6913276	Kibdelosporangium phytohabitans	860235	S	22	1	23	0.00003
ERR6913276	Alloactinosynnema sp. L-07	1653480	S	21	1	22	0.00002
ERR6913276	Prauserella marina	530584	S	18	0	18	0.00002
ERR6913276	Actinokineospora sp. UTMC 2448	2268449	S	16	1	17	0.00002
ERR6913276	Allokutzneria albata	211114	S	14	1	15	0.00002
ERR6913276	Actinosynnema pretiosum	42197	S	7	6	13	0.00001
ERR6913276	Allosaccharopolyspora coralli	2665642	S	5	0	5	0.00001
ERR6913276	Gardnerella vaginalis	2702	S	385	69	454	0.00050
ERR6913276	Gardnerella piotii	2792977	S	121	29	150	0.00016
ERR6913276	Gardnerella leopoldii	2792978	S	7	2	9	0.00001
ERR6913276	Bifidobacterium longum	216816	S	50	91	141	0.00016
ERR6913276	Bifidobacterium adolescentis	1680	S	26	10	36	0.00004
ERR6913276	Bifidobacterium dentium	1689	S	24	0	24	0.00003
ERR6913276	Bifidobacterium breve	1685	S	21	10	31	0.00003
ERR6913276	Bifidobacterium pseudolongum	1694	S	19	0	19	0.00002
ERR6913276	Bifidobacterium pseudocatenulatum	28026	S	14	4	18	0.00002
ERR6913276	Bifidobacterium asteroides	1684	S	13	0	13	0.00001
ERR6913276	Bifidobacterium thermophilum	33905	S	8	0	8	0.00001
ERR6913276	Bifidobacterium choerinum	35760	S	7	0	7	0.00001
ERR6913276	Bifidobacterium eulemuris	1765219	S	6	0	6	0.00001
ERR6913276	Bifidobacterium scardovii	158787	S	6	0	6	0.00001
ERR6913276	Scardovia inopinata	78259	S	15	0	15	0.00002
ERR6913276	Micromonospora sp. HM134	2583243	S	18	4	22	0.00002
ERR6913276	Verrucosispora sp. NA02020	2742132	S	11	2	13	0.00001
ERR6913276	Micromonospora sp. WMMC415	2675222	S	9	1	10	0.00001
ERR6913276	Micromonospora sp. LH3U1	3018339	S	9	1	10	0.00001
ERR6913276	Micromonospora maris	1003110	S	17	2	19	0.00002
ERR6913276	Micromonospora carbonacea	47853	S	16	3	19	0.00002
ERR6913276	Micromonospora coxensis	356852	S	16	4	20	0.00002
ERR6913276	Micromonospora endophytica	515350	S	13	1	14	0.00002
ERR6913276	Micromonospora aurantiaca	47850	S	12	36	48	0.00005
ERR6913276	Micromonospora zamorensis	709883	S	12	2	14	0.00002
ERR6913276	Micromonospora tulbaghiae	479978	S	12	7	19	0.00002
ERR6913276	Micromonospora siamensis	299152	S	11	2	13	0.00001
ERR6913276	Micromonospora sagamiensis	47875	S	10	2	12	0.00001
ERR6913276	Micromonospora narathiwatensis	299146	S	9	2	11	0.00001
ERR6913276	Micromonospora craniellae	2294034	S	8	1	9	0.00001
ERR6913276	Micromonospora echinofusca	47858	S	8	1	9	0.00001
ERR6913276	Micromonospora coriariae	285665	S	8	1	9	0.00001
ERR6913276	Micromonospora echinospora	1877	S	7	1	8	0.00001
ERR6913276	Micromonospora krabiensis	307121	S	7	1	8	0.00001
ERR6913276	Micromonospora rifamycinica	291594	S	7	1	8	0.00001
ERR6913276	Micromonospora inositola	47865	S	6	1	7	0.00001
ERR6913276	Micromonospora echinaurantiaca	47857	S	6	1	7	0.00001
ERR6913276	Micromonospora viridifaciens	1881	S	6	1	7	0.00001
ERR6913276	Micromonospora ferruginea	2749844	S	6	1	7	0.00001
ERR6913276	Actinoplanes sp. OR16	946334	S	17	8	25	0.00003
ERR6913276	Actinoplanes sp. L3-i22	2836373	S	12	11	23	0.00003
ERR6913276	Actinoplanes sp. N902-109	649831	S	8	2	10	0.00001
ERR6913276	Actinoplanes ianthinogenes	122358	S	24	5	29	0.00003
ERR6913276	Actinoplanes teichomyceticus	1867	S	23	5	28	0.00003
ERR6913276	Actinoplanes friuliensis	196914	S	17	1	18	0.00002
ERR6913276	Actinoplanes missouriensis	1866	S	16	3	19	0.00002
ERR6913276	Actinoplanes derwentensis	113562	S	8	0	8	0.00001
ERR6913276	Dactylosporangium aurantiacum	35754	S	24	1	25	0.00003
ERR6913276	Dactylosporangium fulvum	53359	S	23	4	27	0.00003
ERR6913276	Dactylosporangium roseum	47989	S	12	2	14	0.00002
ERR6913276	Dactylosporangium matsuzakiense	53360	S	10	13	23	0.00003
ERR6913276	Dactylosporangium vinaceum	53362	S	6	6	12	0.00001
ERR6913276	Phytohabitans suffuscus	624315	S	22	4	26	0.00003
ERR6913276	Phytohabitans flavus	1076124	S	6	1	7	0.00001
ERR6913276	Catellatospora sp. IY07-71	2728827	S	29	2	31	0.00003
ERR6913276	Actinocatenispora sera	390989	S	19	2	21	0.00002
ERR6913276	Actinocatenispora thailandica	227318	S	8	0	8	0.00001
ERR6913276	Polymorphospora rubra	338584	S	24	4	28	0.00003
ERR6913276	Plantactinospora sp. BB1	2071627	S	5	11	16	0.00002
ERR6913276	Couchioplanes caeruleus	56438	S	12	2	14	0.00002
ERR6913276	Natronosporangium hydrolyticum	2811111	S	8	0	8	0.00001
ERR6913276	Salinispora tropica	168695	S	6	1	7	0.00001
ERR6913276	Candidatus Planktophila sulfonica	1884904	S	155	131	286	0.00031
ERR6913276	Candidatus Planktophila versatilis	1884905	S	47	17	64	0.00007
ERR6913276	Candidatus Planktophila lacus	1884913	S	46	10	56	0.00006
ERR6913276	Candidatus Planktophila vernalis	1884907	S	32	5	37	0.00004
ERR6913276	Candidatus Planktophila dulcis	1884914	S	29	23	52	0.00006
ERR6913276	Candidatus Planktophila limnetica	573600	S	8	1	9	0.00001
ERR6913276	Candidatus Nanopelagicus limnes	1884634	S	19	23	42	0.00005
ERR6913276	Candidatus Nanopelagicus abundans	1884916	S	10	5	15	0.00002
ERR6913276	Nonomuraea sp. ATCC 55076	1909395	S	51	6	57	0.00006
ERR6913276	Nonomuraea gerenzanensis	93944	S	31	4	35	0.00004
ERR6913276	Nonomuraea phyllanthi	2219224	S	26	2	28	0.00003
ERR6913276	Nonomuraea coxensis	404386	S	16	1	17	0.00002
ERR6913276	Streptosporangium sp. 'caverna'	2202249	S	18	2	20	0.00002
ERR6913276	Streptosporangium roseum	2001	S	15	2	17	0.00002
ERR6913276	Thermobispora bispora	2006	S	15	0	15	0.00002
ERR6913276	Nocardiopsis sp. HDS12	2831968	S	5	13	18	0.00002
ERR6913276	Nocardiopsis dassonvillei	2014	S	14	2	16	0.00002
ERR6913276	Nocardiopsis gilva	280236	S	13	0	13	0.00001
ERR6913276	Nocardiopsis alba	53437	S	11	0	11	0.00001
ERR6913276	Nocardiopsis exhalans	163604	S	5	0	5	0.00001
ERR6913276	Thermobifida alba	53522	S	11	6	17	0.00002
ERR6913276	Thermobifida fusca	2021	S	10	2	12	0.00001
ERR6913276	Thermobifida halotolerans	483545	S	9	4	13	0.00001
ERR6913276	Streptomonospora nanhaiensis	1323731	S	30	2	32	0.00004
ERR6913276	Streptomonospora litoralis	2498135	S	8	0	8	0.00001
ERR6913276	Spiractinospora alimapuensis	2820884	S	8	0	8	0.00001
ERR6913276	Actinomadura sp. WMMB 499	1219491	S	24	1	25	0.00003
ERR6913276	Actinomadura sp. NAK00032	2742128	S	11	1	12	0.00001
ERR6913276	Actinomadura sp. WMMA1423	2591108	S	8	0	8	0.00001
ERR6913276	Actinomadura verrucosospora	46165	S	16	0	16	0.00002
ERR6913276	Actinomadura madurae	1993	S	13	0	13	0.00001
ERR6913276	Actinomadura graeca	2750812	S	13	0	13	0.00001
ERR6913276	Thermomonospora amylolytica	1411117	S	10	1	11	0.00001
ERR6913276	Thermomonospora curvata	2020	S	9	1	10	0.00001
ERR6913276	Modestobacter marinus	477641	S	41	8	49	0.00005
ERR6913276	Modestobacter sp. L9-4	2851567	S	18	4	22	0.00002
ERR6913276	Blastococcus saxobsidens	138336	S	35	2	37	0.00004
ERR6913276	Blastococcus sp. PRF04-17	2933797	S	20	1	21	0.00002
ERR6913276	Geodermatophilus obscurus	1861	S	39	3	42	0.00005
ERR6913276	Nakamurella antarctica	1902245	S	30	1	31	0.00003
ERR6913276	Nakamurella multipartita	53461	S	24	1	25	0.00003
ERR6913276	Nakamurella sp. PAMC28650	2762325	S	17	3	20	0.00002
ERR6913276	Nakamurella panacisegetis	1090615	S	7	1	8	0.00001
ERR6913276	Jatrophihabitans telluris	2038343	S	43	1	44	0.00005
ERR6913276	Jatrophihabitans sp. SB3-54	2944128	S	22	0	22	0.00002
ERR6913276	Jatrophihabitans sp. GAS493	1907575	S	16	0	16	0.00002
ERR6913276	Frankia inefficax	298654	S	20	0	20	0.00002
ERR6913276	Frankia alni	1859	S	13	21	34	0.00004
ERR6913276	Frankia sp. ArI3	1858	S	5	7	12	0.00001
ERR6913276	Frankia casuarinae	106370	S	8	0	8	0.00001
ERR6913276	Jiangella sp. DSM 45060	1798224	S	35	4	39	0.00004
ERR6913276	Jiangella alkaliphila	419479	S	26	3	29	0.00003
ERR6913276	Epidermidibacterium keratini	1891644	S	38	0	38	0.00004
ERR6913276	Catenulispora acidiphila	304895	S	26	0	26	0.00003
ERR6913276	Kineococcus radiotolerans	131568	S	16	0	16	0.00002
ERR6913276	Acidothermus cellulolyticus	28049	S	16	0	16	0.00002
ERR6913276	Stackebrandtia nassauensis	283811	S	5	0	5	0.00001
ERR6913276	Actinopolyspora erythraea	414996	S	5	0	5	0.00001
ERR6913276	Aquihabitans sp. G128	2849779	S	97	22	119	0.00013
ERR6913276	Aquihabitans sp. Kera 3	2884263	S	44	5	49	0.00005
ERR6913276	Iamia sp. SCSIO 61187	2722752	S	58	17	75	0.00008
ERR6913276	Iamia majanohamensis	467976	S	26	8	34	0.00004
ERR6913276	Actinomarinicola tropica	2789776	S	51	11	62	0.00007
ERR6913276	Ilumatobacter coccineus	467094	S	90	5	95	0.00010
ERR6913276	Acidimicrobium ferrooxidans	53635	S	51	2	53	0.00006
ERR6913276	Olsenella sp. oral taxon 807	712411	S	98	2	100	0.00011
ERR6913276	Olsenella timonensis	1805478	S	7	1	8	0.00001
ERR6913276	Lancefieldella parvula	1382	S	101	2	103	0.00011
ERR6913276	Parafannyhessea umbonata	604330	S	10	2	12	0.00001
ERR6913276	Parolsenella catena	2003188	S	7	1	8	0.00001
ERR6913276	Leptogranulimonas caecicola	2894156	S	9	0	9	0.00001
ERR6913276	Thermophilibacter immobilis	2779519	S	8	1	9	0.00001
ERR6913276	Atopobium sp. oral taxon 416	712157	S	7	0	7	0.00001
ERR6913276	Collinsella aerofaciens	74426	S	80	5	85	0.00009
ERR6913276	Collinsella stercoris	147206	S	8	0	8	0.00001
ERR6913276	Coriobacterium glomerans	33871	S	6	0	6	0.00001
ERR6913276	Eggerthella lenta	84112	S	25	4	29	0.00003
ERR6913276	Eggerthella sp. YY7918	502558	S	12	0	12	0.00001
ERR6913276	Eggerthella guodeyinii	2690837	S	6	1	7	0.00001
ERR6913276	Denitrobacterium detoxificans	79604	S	10	0	10	0.00001
ERR6913276	Phoenicibacter congonensis	1944646	S	9	0	9	0.00001
ERR6913276	Gordonibacter pamelaeae	471189	S	5	1	6	0.00001
ERR6913276	Conexibacter sp. SYSU D00693	2812560	S	33	4	37	0.00004
ERR6913276	Conexibacter sp. S30A1	2937800	S	20	0	20	0.00002
ERR6913276	Conexibacter sp. DBS9H8	2937801	S	8	0	8	0.00001
ERR6913276	Conexibacter woesei	191495	S	33	3	36	0.00004
ERR6913276	Capillimicrobium parvum	2884022	S	38	3	41	0.00005
ERR6913276	Paraconexibacter antarcticus	2949664	S	18	1	19	0.00002
ERR6913276	Miltoncostaea marina	2843215	S	31	8	39	0.00004
ERR6913276	Miltoncostaea oceani	2843216	S	27	3	30	0.00003
ERR6913276	Thermoleophilum album	29539	S	20	1	21	0.00002
ERR6913276	Rubrobacter marinus	2653852	S	21	4	25	0.00003
ERR6913276	Rubrobacter xylanophilus	49319	S	15	1	16	0.00002
ERR6913276	Rubrobacter tropicus	2653851	S	13	2	15	0.00002
ERR6913276	Rubrobacter radiotolerans	42256	S	11	3	14	0.00002
ERR6913276	Rubrobacter indicoceani	2051957	S	5	0	5	0.00001
ERR6913276	Baekduia sp. 0141_2	2997333	S	35	1	36	0.00004
ERR6913276	Baekduia soli	496014	S	10	0	10	0.00001
ERR6913276	Euzebya pacifica	1608957	S	8	0	8	0.00001
ERR6913276	Egibacter rhizosphaerae	1670831	S	7	0	7	0.00001
ERR6913276	Egicoccus halophilus	1670830	S	6	0	6	0.00001
ERR6913276	Staphylococcus epidermidis	1282	S	25470	2166	27636	0.03040
ERR6913276	Staphylococcus capitis	29388	S	23826	1627	25453	0.02799
ERR6913276	Staphylococcus hominis	1290	S	866	77	943	0.00104
ERR6913276	Staphylococcus aureus	1280	S	379	1459	1838	0.00202
ERR6913276	Staphylococcus saprophyticus	29385	S	291	17	308	0.00034
ERR6913276	Staphylococcus lugdunensis	28035	S	153	4	157	0.00017
ERR6913276	Staphylococcus warneri	1292	S	127	47	174	0.00019
ERR6913276	Staphylococcus haemolyticus	1283	S	126	14	140	0.00015
ERR6913276	Staphylococcus auricularis	29379	S	91	2	93	0.00010
ERR6913276	Staphylococcus sp. NRL 22/194	3020908	S	44	3	47	0.00005
ERR6913276	Staphylococcus sp. MI 10-1553	1912064	S	10	1	11	0.00001
ERR6913276	Staphylococcus sp. 11-B-312	2799680	S	8	12	20	0.00002
ERR6913276	Staphylococcus pasteuri	45972	S	72	300	372	0.00041
ERR6913276	Staphylococcus simulans	1286	S	68	2	70	0.00008
ERR6913276	Staphylococcus caprae	29380	S	55	2	57	0.00006
ERR6913276	Staphylococcus nepalensis	214473	S	43	1	44	0.00005
ERR6913276	Staphylococcus chromogenes	46126	S	37	2	39	0.00004
ERR6913276	Staphylococcus saccharolyticus	33028	S	26	0	26	0.00003
ERR6913276	Staphylococcus xylosus	1288	S	24	4	28	0.00003
ERR6913276	Staphylococcus cohnii	29382	S	20	7	27	0.00003
ERR6913276	Staphylococcus pseudintermedius	283734	S	14	1	15	0.00002
ERR6913276	Staphylococcus pettenkoferi	170573	S	14	0	14	0.00002
ERR6913276	Staphylococcus simiae	308354	S	12	0	12	0.00001
ERR6913276	Staphylococcus hyicus	1284	S	12	1	13	0.00001
ERR6913276	Staphylococcus equorum	246432	S	9	8	17	0.00002
ERR6913276	Staphylococcus condimenti	70255	S	9	0	9	0.00001
ERR6913276	Staphylococcus argenteus	985002	S	8	1	9	0.00001
ERR6913276	Staphylococcus arlettae	29378	S	8	0	8	0.00001
ERR6913276	Staphylococcus kloosii	29384	S	8	0	8	0.00001
ERR6913276	Staphylococcus felis	46127	S	6	0	6	0.00001
ERR6913276	Staphylococcus succinus	61015	S	6	0	6	0.00001
ERR6913276	Mammaliicoccus sciuri	1296	S	54	3	57	0.00006
ERR6913276	Mammaliicoccus vitulinus	71237	S	6	0	6	0.00001
ERR6913276	Mammaliicoccus lentus	42858	S	5	0	5	0.00001
ERR6913276	Jeotgalicoccus sp. WY2	2708346	S	19	0	19	0.00002
ERR6913276	Jeotgalicoccus sp. ATCC 8456	946435	S	15	0	15	0.00002
ERR6913276	Jeotgalicoccus saudimassiliensis	1461582	S	10	0	10	0.00001
ERR6913276	Abyssicoccus albus	1817405	S	26	0	26	0.00003
ERR6913276	Macrococcus caseolyticus	69966	S	9	3	12	0.00001
ERR6913276	Salinicoccus halodurans	407035	S	8	0	8	0.00001
ERR6913276	Nosocomiicoccus ampullae	489910	S	5	0	5	0.00001
ERR6913276	Gemella haemolysans	1379	S	1019	83	1102	0.00121
ERR6913276	Gemella sanguinis	84135	S	297	34	331	0.00036
ERR6913276	Gemella morbillorum	29391	S	177	29	206	0.00023
ERR6913276	Gemella sp. zg-570	2840371	S	15	8	23	0.00003
ERR6913276	Exiguobacterium sp. MH3	1399115	S	16	8	24	0.00003
ERR6913276	Exiguobacterium sp. ZWU0009	1224749	S	12	28	40	0.00004
ERR6913276	Exiguobacterium sp. PFWT01	2829816	S	8	4	12	0.00001
ERR6913276	Exiguobacterium sp. N4-1P	2051906	S	7	0	7	0.00001
ERR6913276	Exiguobacterium sp. AT1b	360911	S	6	3	9	0.00001
ERR6913276	Exiguobacterium acetylicum	41170	S	57	27	84	0.00009
ERR6913276	Exiguobacterium mexicanum	340146	S	11	1	12	0.00001
ERR6913276	Exiguobacterium antarcticum	132920	S	10	0	10	0.00001
ERR6913276	Exiguobacterium sibiricum	332410	S	7	0	7	0.00001
ERR6913276	Exiguobacterium alkaliphilum	1428684	S	7	0	7	0.00001
ERR6913276	Exiguobacterium marinum	273528	S	5	0	5	0.00001
ERR6913276	Bacillus atrophaeus	1452	S	55	13	68	0.00007
ERR6913276	Bacillus velezensis	492670	S	29	69	98	0.00011
ERR6913276	Bacillus amyloliquefaciens	1390	S	14	38	52	0.00006
ERR6913276	Bacillus subtilis	1423	S	18	18	36	0.00004
ERR6913276	Bacillus cereus	1396	S	40	203	243	0.00027
ERR6913276	Bacillus mycoides	1405	S	9	1	10	0.00001
ERR6913276	Bacillus tropicus	2026188	S	8	11	19	0.00002
ERR6913276	Bacillus anthracis	1392	S	7	9	16	0.00002
ERR6913276	Bacillus thuringiensis	1428	S	7	2	9	0.00001
ERR6913276	Bacillus pseudomycoides	64104	S	6	0	6	0.00001
ERR6913276	Bacillus sp. THAF10	2587848	S	8	0	8	0.00001
ERR6913276	Bacillus sp. F19	2884833	S	7	3	10	0.00001
ERR6913276	Bacillus sp. NSP9.1	1071078	S	6	0	6	0.00001
ERR6913276	Bacillus sp. S3	486398	S	5	0	5	0.00001
ERR6913276	Bacillus aquiflavi	2672567	S	27	0	27	0.00003
ERR6913276	Bacillus pumilus	1408	S	8	0	8	0.00001
ERR6913276	Bacillus safensis	561879	S	6	1	7	0.00001
ERR6913276	Bacillus dafuensis	1742359	S	6	0	6	0.00001
ERR6913276	Alkalihalobacillus clausii	79880	S	28	9	37	0.00004
ERR6913276	Alkalihalobacillus sp. LMS39	2924032	S	9	0	9	0.00001
ERR6913276	Alkalihalobacillus krulwichiae	199441	S	6	0	6	0.00001
ERR6913276	Lysinibacillus fusiformis	28031	S	11	9	20	0.00002
ERR6913276	Lysinibacillus timonensis	2086577	S	11	0	11	0.00001
ERR6913276	Anoxybacillus flavithermus	33934	S	20	10	30	0.00003
ERR6913276	Anoxybacillus amylolyticus	294699	S	8	0	8	0.00001
ERR6913276	Anoxybacillus caldiproteolyticus	247480	S	5	0	5	0.00001
ERR6913276	Metabacillus sp. cB07	2806989	S	9	0	9	0.00001
ERR6913276	Metabacillus sp. KUDC1714	2745198	S	7	0	7	0.00001
ERR6913276	Metabacillus sediminilitoris	2567941	S	14	0	14	0.00002
ERR6913276	Priestia megaterium	1404	S	14	19	33	0.00004
ERR6913276	Priestia flexa	86664	S	5	0	5	0.00001
ERR6913276	Priestia aryabhattai	412384	S	5	44	49	0.00005
ERR6913276	Priestia filamentosa	1402861	S	5	0	5	0.00001
ERR6913276	Evansella cellulosilytica	1413	S	10	3	13	0.00001
ERR6913276	Evansella sp. LMS18	2924033	S	7	2	9	0.00001
ERR6913276	Oceanobacillus jeddahense	1462527	S	7	0	7	0.00001
ERR6913276	Oceanobacillus iheyensis	182710	S	5	0	5	0.00001
ERR6913276	Oceanobacillus zhaokaii	2052660	S	5	0	5	0.00001
ERR6913276	Peribacillus frigoritolerans	450367	S	8	0	8	0.00001
ERR6913276	Peribacillus asahii	228899	S	7	0	7	0.00001
ERR6913276	Parageobacillus caldoxylosilyticus	81408	S	8	1	9	0.00001
ERR6913276	Parageobacillus thermoglucosidasius	1426	S	6	1	7	0.00001
ERR6913276	Geobacillus stearothermophilus	1422	S	5	7	12	0.00001
ERR6913276	Mesobacillus jeotgali	129985	S	14	0	14	0.00002
ERR6913276	Weizmannia coagulans	1398	S	18	1	19	0.00002
ERR6913276	Gracilibacillus salitolerans	2663022	S	12	0	12	0.00001
ERR6913276	Lentibacillus sp. ZS110521	2911514	S	5	0	5	0.00001
ERR6913276	Allobacillus halotolerans	570278	S	12	0	12	0.00001
ERR6913276	Salicibibacter cibarius	2743000	S	5	3	8	0.00001
ERR6913276	Caldalkalibacillus thermarum	296745	S	10	0	10	0.00001
ERR6913276	Lederbergia lenta	1467	S	10	0	10	0.00001
ERR6913276	Niallia sp. Man26	2912824	S	8	0	8	0.00001
ERR6913276	Terribacillus goriensis	386490	S	6	0	6	0.00001
ERR6913276	Fictibacillus sp. KU28468	2991053	S	5	0	5	0.00001
ERR6913276	Caldibacillus thermoamylovorans	35841	S	7	0	7	0.00001
ERR6913276	Halalkalibacterium halodurans	86665	S	6	0	6	0.00001
ERR6913276	Salimicrobium jeotgali	1230341	S	5	0	5	0.00001
ERR6913276	Paenibacillus sp. B01	2660554	S	11	4	15	0.00002
ERR6913276	Paenibacillus sp. 32O-W	1695218	S	6	0	6	0.00001
ERR6913276	Paenibacillus sp. FSL R7-0331	1536773	S	6	5	11	0.00001
ERR6913276	Paenibacillus sp. 481	2835869	S	5	0	5	0.00001
ERR6913276	Paenibacillus sp. HWE-109	1306526	S	5	0	5	0.00001
ERR6913276	Paenibacillus lutimineralis	2707005	S	9	0	9	0.00001
ERR6913276	Paenibacillus lycopersici	2704462	S	9	0	9	0.00001
ERR6913276	Paenibacillus mucilaginosus	61624	S	9	0	9	0.00001
ERR6913276	Paenibacillus donghaensis	414771	S	7	0	7	0.00001
ERR6913276	Paenibacillus beijingensis	1126833	S	7	0	7	0.00001
ERR6913276	Paenibacillus azoreducens	116718	S	7	0	7	0.00001
ERR6913276	Paenibacillus swuensis	1178515	S	6	0	6	0.00001
ERR6913276	Paenibacillus polymyxa	1406	S	5	18	23	0.00003
ERR6913276	Paenibacillus jilunlii	682956	S	5	6	11	0.00001
ERR6913276	Paenibacillus agaridevorans	171404	S	5	8	13	0.00001
ERR6913276	Paenibacillus bovis	1616788	S	5	0	5	0.00001
ERR6913276	Paenibacillus psychroresistens	1778678	S	5	0	5	0.00001
ERR6913276	Paenibacillus konkukensis	2020716	S	5	0	5	0.00001
ERR6913276	Paenibacillus alvei	44250	S	5	0	5	0.00001
ERR6913276	Brevibacillus sp. MMS20-4M-10-Y	2895522	S	17	0	17	0.00002
ERR6913276	Brevibacillus brevis	1393	S	5	4	9	0.00001
ERR6913276	Brevibacillus agri	51101	S	5	0	5	0.00001
ERR6913276	Cohnella abietis	2507935	S	5	0	5	0.00001
ERR6913276	Cohnella sp. LGH	1619153	S	5	1	6	0.00001
ERR6913276	Cohnella candidum	2674991	S	5	0	5	0.00001
ERR6913276	Aneurinibacillus sp. B1	2966586	S	5	0	5	0.00001
ERR6913276	Saccharibacillus brassicae	2583377	S	8	0	8	0.00001
ERR6913276	Planococcus halotolerans	2233542	S	27	2	29	0.00003
ERR6913276	Planococcus lenghuensis	2213202	S	11	0	11	0.00001
ERR6913276	Planococcus sp. MB-3u-03	2058136	S	6	1	7	0.00001
ERR6913276	Planococcus antarcticus	161360	S	8	0	8	0.00001
ERR6913276	Planococcus rifietoensis	200991	S	7	1	8	0.00001
ERR6913276	Planococcus halocryophilus	1215089	S	6	1	7	0.00001
ERR6913276	Planococcus glaciei	459472	S	5	0	5	0.00001
ERR6913276	Sporosarcina ureae	1571	S	10	7	17	0.00002
ERR6913276	Solibacillus silvestris	76853	S	8	0	8	0.00001
ERR6913276	Kroppenstedtia eburnea	714067	S	8	93	101	0.00011
ERR6913276	Novibacillus thermophilus	1471761	S	5	18	23	0.00003
ERR6913276	Brochothrix thermosphacta	2756	S	49	2	51	0.00006
ERR6913276	Listeria innocua	1642	S	9	3	12	0.00001
ERR6913276	Listeria grayi	1641	S	8	0	8	0.00001
ERR6913276	Listeria monocytogenes	1639	S	7	7	14	0.00002
ERR6913276	Listeria sp. PSOL-1	1844999	S	6	0	6	0.00001
ERR6913276	Alicyclobacillus cycloheptanicus	1457	S	12	3	15	0.00002
ERR6913276	Alicyclobacillus mengziensis	2931921	S	6	1	7	0.00001
ERR6913276	Streptococcus oralis	1303	S	5911	2227	8138	0.00895
ERR6913276	Streptococcus mitis	28037	S	5725	1552	7277	0.00800
ERR6913276	Streptococcus sp. oral taxon 431	712633	S	994	99	1093	0.00120
ERR6913276	Streptococcus sp. oral taxon 061	712623	S	606	121	727	0.00080
ERR6913276	Streptococcus sp. A12	1759399	S	600	122	722	0.00079
ERR6913276	Streptococcus sp. 116-D4	2598453	S	409	76	485	0.00053
ERR6913276	Streptococcus sp. Marseille-Q6470	2972784	S	399	72	471	0.00052
ERR6913276	Streptococcus sp. Marseille-Q3533	2759692	S	322	39	361	0.00040
ERR6913276	Streptococcus sp. LPB0220	2610896	S	177	51	228	0.00025
ERR6913276	Streptococcus sp. NPS 308	1902136	S	163	44	207	0.00023
ERR6913276	Streptococcus sp. HSISM1	1316408	S	161	43	204	0.00022
ERR6913276	Streptococcus sp. 1643	2576376	S	125	83	208	0.00023
ERR6913276	Streptococcus sp. oral taxon 064	712624	S	96	132	228	0.00025
ERR6913276	Streptococcus sp. HSISS2	1316411	S	13	11	24	0.00003
ERR6913276	Streptococcus sp. FDAARGOS_192	1839799	S	13	13	26	0.00003
ERR6913276	Streptococcus sp. HN38	3020829	S	12	9	21	0.00002
ERR6913276	Streptococcus sp. HSISS3	1316412	S	12	10	22	0.00002
ERR6913276	Streptococcus sp. NSJ-72	2763068	S	9	18	27	0.00003
ERR6913276	Streptococcus sp. HSISS1	1316410	S	6	99	105	0.00012
ERR6913276	Streptococcus sp. KS 6	2598457	S	5	2	7	0.00001
ERR6913276	Streptococcus sanguinis	1305	S	2895	154	3049	0.00335
ERR6913276	Streptococcus pneumoniae	1313	S	1560	1166	2726	0.00300
ERR6913276	Streptococcus infantis	68892	S	1063	113	1176	0.00129
ERR6913276	Streptococcus gordonii	1302	S	1011	54	1065	0.00117
ERR6913276	Streptococcus salivarius	1304	S	875	314	1189	0.00131
ERR6913276	Streptococcus cristatus	45634	S	641	60	701	0.00077
ERR6913276	Streptococcus gwangjuense	1433513	S	566	200	766	0.00084
ERR6913276	Streptococcus australis	113107	S	499	238	737	0.00081
ERR6913276	Streptococcus toyakuensis	2819619	S	456	205	661	0.00073
ERR6913276	Streptococcus ilei	1156431	S	381	192	573	0.00063
ERR6913276	Streptococcus thermophilus	1308	S	356	244	600	0.00066
ERR6913276	Streptococcus pseudopneumoniae	257758	S	342	113	455	0.00050
ERR6913276	Streptococcus parasanguinis	1318	S	292	53	345	0.00038
ERR6913276	Streptococcus intermedius	1338	S	119	26	145	0.00016
ERR6913276	Streptococcus anginosus	1328	S	46	28	74	0.00008
ERR6913276	Streptococcus constellatus	76860	S	8	533	541	0.00060
ERR6913276	Streptococcus koreensis	2382163	S	183	110	293	0.00032
ERR6913276	Streptococcus rubneri	1234680	S	157	63	220	0.00024
ERR6913276	Streptococcus lactarius	684066	S	86	6	92	0.00010
ERR6913276	Streptococcus suis	1307	S	76	23	99	0.00011
ERR6913276	Streptococcus pyogenes	1314	S	68	46	114	0.00013
ERR6913276	Streptococcus agalactiae	1311	S	40	141	181	0.00020
ERR6913276	Streptococcus vestibularis	1343	S	37	7	44	0.00005
ERR6913276	Streptococcus equinus	1335	S	23	3	26	0.00003
ERR6913276	Streptococcus mutans	1309	S	22	1	23	0.00003
ERR6913276	Streptococcus equi	1336	S	16	0	16	0.00002
ERR6913276	Streptococcus pseudoporcinus	361101	S	17	1	18	0.00002
ERR6913276	Streptococcus canis	1329	S	14	1	15	0.00002
ERR6913276	Streptococcus pluranimalium	82348	S	14	0	14	0.00002
ERR6913276	Streptococcus sobrinus	1310	S	13	0	13	0.00001
ERR6913276	Streptococcus merionis	400065	S	11	0	11	0.00001
ERR6913276	Streptococcus halotolerans	1814128	S	11	0	11	0.00001
ERR6913276	Streptococcus alactolyticus	29389	S	10	1	11	0.00001
ERR6913276	Streptococcus infantarius	102684	S	9	4	13	0.00001
ERR6913276	Streptococcus troglodytae	1111760	S	9	1	10	0.00001
ERR6913276	Streptococcus gallolyticus	315405	S	9	5	14	0.00002
ERR6913276	Streptococcus respiraculi	2021971	S	9	0	9	0.00001
ERR6913276	Streptococcus parasuis	1501662	S	8	3	11	0.00001
ERR6913276	Streptococcus lutetiensis	150055	S	8	2	10	0.00001
ERR6913276	Streptococcus ferus	1345	S	8	0	8	0.00001
ERR6913276	Streptococcus himalayensis	1888195	S	7	0	7	0.00001
ERR6913276	Streptococcus uberis	1349	S	7	0	7	0.00001
ERR6913276	Streptococcus marmotae	1825069	S	6	0	6	0.00001
ERR6913276	Streptococcus oriscaviae	2781599	S	6	0	6	0.00001
ERR6913276	Streptococcus parauberis	1348	S	6	0	6	0.00001
ERR6913276	Lactococcus lactis	1358	S	240	155	395	0.00043
ERR6913276	Lactococcus cremoris	1359	S	176	60	236	0.00026
ERR6913276	Lactococcus piscium	1364	S	7	5	12	0.00001
ERR6913276	Lactococcus formosensis	1281486	S	7	1	8	0.00001
ERR6913276	Granulicatella adiacens	46124	S	1504	78	1582	0.00174
ERR6913276	Granulicatella elegans	137732	S	124	21	145	0.00016
ERR6913276	Dolosigranulum pigrum	29394	S	438	6	444	0.00049
ERR6913276	Carnobacterium maltaromaticum	2751	S	35	1	36	0.00004
ERR6913276	Carnobacterium divergens	2748	S	12	0	12	0.00001
ERR6913276	Carnobacterium inhibens	147709	S	9	4	13	0.00001
ERR6913276	Jeotgalibaca sp. MA1X17-3	2908211	S	9	15	24	0.00003
ERR6913276	Marinilactibacillus sp. 15R	1911586	S	18	0	18	0.00002
ERR6913276	Lactobacillus crispatus	47770	S	223	18	241	0.00027
ERR6913276	Lactobacillus gasseri	1596	S	116	47	163	0.00018
ERR6913276	Lactobacillus delbrueckii	1584	S	52	2	54	0.00006
ERR6913276	Lactobacillus johnsonii	33959	S	25	1	26	0.00003
ERR6913276	Lactobacillus sp. PV034	2594495	S	5	2	7	0.00001
ERR6913276	Lactobacillus sp. IBH004	2879107	S	5	1	6	0.00001
ERR6913276	Lactobacillus iners	147802	S	16	0	16	0.00002
ERR6913276	Lactobacillus jensenii	109790	S	14	0	14	0.00002
ERR6913276	Lactobacillus amylovorus	1604	S	9	0	9	0.00001
ERR6913276	Lactobacillus acidophilus	1579	S	7	0	7	0.00001
ERR6913276	Lactobacillus helveticus	1587	S	6	0	6	0.00001
ERR6913276	Lactobacillus ultunensis	227945	S	6	0	6	0.00001
ERR6913276	Lactobacillus panisapium	2012495	S	5	0	5	0.00001
ERR6913276	Leuconostoc mesenteroides	1245	S	62	33	95	0.00010
ERR6913276	Leuconostoc lactis	1246	S	43	18	61	0.00007
ERR6913276	Leuconostoc gasicomitatum	115778	S	13	2	15	0.00002
ERR6913276	Leuconostoc gelidum	1244	S	12	0	12	0.00001
ERR6913276	Leuconostoc garlicum	255248	S	10	16	26	0.00003
ERR6913276	Leuconostoc pseudomesenteroides	33968	S	6	1	7	0.00001
ERR6913276	Lactiplantibacillus plantarum	1590	S	97	34	131	0.00014
ERR6913276	Lactiplantibacillus pentosus	1589	S	32	1	33	0.00004
ERR6913276	Lacticaseibacillus rhamnosus	47715	S	49	1	50	0.00005
ERR6913276	Lacticaseibacillus paracasei	1597	S	30	21	51	0.00006
ERR6913276	Lacticaseibacillus casei	1582	S	7	13	20	0.00002
ERR6913276	Weissella cibaria	137591	S	15	9	24	0.00003
ERR6913276	Weissella hellenica	46256	S	9	7	16	0.00002
ERR6913276	Weissella confusa	1583	S	7	5	12	0.00001
ERR6913276	Weissella jogaejeotgali	1631871	S	6	6	12	0.00001
ERR6913276	Weissella paramesenteroides	1249	S	5	5	10	0.00001
ERR6913276	Ligilactobacillus animalis	1605	S	23	1	24	0.00003
ERR6913276	Ligilactobacillus ruminis	1623	S	9	0	9	0.00001
ERR6913276	Ligilactobacillus murinus	1622	S	8	0	8	0.00001
ERR6913276	Ligilactobacillus agilis	1601	S	7	0	7	0.00001
ERR6913276	Ligilactobacillus salivarius	1624	S	7	0	7	0.00001
ERR6913276	Limosilactobacillus reuteri	1598	S	27	2	29	0.00003
ERR6913276	Limosilactobacillus fermentum	1613	S	10	1	11	0.00001
ERR6913276	Limosilactobacillus vaginalis	1633	S	10	1	11	0.00001
ERR6913276	Levilactobacillus brevis	1580	S	24	4	28	0.00003
ERR6913276	Latilactobacillus sakei	1599	S	16	1	17	0.00002
ERR6913276	Latilactobacillus curvatus	28038	S	9	0	9	0.00001
ERR6913276	Pediococcus pentosaceus	1255	S	12	0	12	0.00001
ERR6913276	Companilactobacillus pabuli	2714036	S	5	1	6	0.00001
ERR6913276	Lentilactobacillus buchneri	1581	S	5	0	5	0.00001
ERR6913276	Bombilactobacillus bombi	1303590	S	7	0	7	0.00001
ERR6913276	Amylolactobacillus amylophilus	1603	S	8	0	8	0.00001
ERR6913276	Abiotrophia defectiva	46125	S	773	47	820	0.00090
ERR6913276	Aerococcus viridans	1377	S	91	20	111	0.00012
ERR6913276	Aerococcus urinaeequi	51665	S	84	9	93	0.00010
ERR6913276	Aerococcus urinae	1376	S	13	0	13	0.00001
ERR6913276	Aerococcus sanguinicola	119206	S	7	0	7	0.00001
ERR6913276	Aerococcus urinaehominis	128944	S	6	0	6	0.00001
ERR6913276	Ignavigranum ruoffiae	89093	S	6	0	6	0.00001
ERR6913276	Enterococcus gilvus	160453	S	165	8	173	0.00019
ERR6913276	Enterococcus faecium	1352	S	24	16	40	0.00004
ERR6913276	Enterococcus casseliflavus	37734	S	17	9	26	0.00003
ERR6913276	Enterococcus faecalis	1351	S	17	11	28	0.00003
ERR6913276	Enterococcus hirae	1354	S	15	1	16	0.00002
ERR6913276	Enterococcus rotai	118060	S	10	0	10	0.00001
ERR6913276	Enterococcus raffinosus	71452	S	9	0	9	0.00001
ERR6913276	Enterococcus cecorum	44008	S	6	0	6	0.00001
ERR6913276	Enterococcus thailandicus	417368	S	6	0	6	0.00001
ERR6913276	Vagococcus hydrophili	2714947	S	9	0	9	0.00001
ERR6913276	Vagococcus penaei	633807	S	7	0	7	0.00001
ERR6913276	Vagococcus zengguangii	2571750	S	7	0	7	0.00001
ERR6913276	Vagococcus coleopterorum	2714946	S	7	0	7	0.00001
ERR6913276	Vagococcus fluvialis	2738	S	6	0	6	0.00001
ERR6913276	Tetragenococcus halophilus	51669	S	5	2	7	0.00001
ERR6913276	Blautia wexlerae	418240	S	136	65	201	0.00022
ERR6913276	Blautia obeum	40520	S	69	28	97	0.00011
ERR6913276	Blautia hansenii	1322	S	33	11	44	0.00005
ERR6913276	Blautia sp. SC05B48	2479767	S	24	44	68	0.00007
ERR6913276	Blautia sp. NBRC 113351	2877527	S	6	1	7	0.00001
ERR6913276	Blautia producta	33035	S	6	0	6	0.00001
ERR6913276	Blautia argi	1912897	S	5	0	5	0.00001
ERR6913276	Blautia liquoris	2779518	S	5	0	5	0.00001
ERR6913276	Lachnoanaerobaculum umeaense	617123	S	133	3	136	0.00015
ERR6913276	[Ruminococcus] gnavus	33038	S	37	13	50	0.00005
ERR6913276	[Ruminococcus] torques	33039	S	31	17	48	0.00005
ERR6913276	[Ruminococcus] lactaris	46228	S	26	7	33	0.00004
ERR6913276	Simiaoa sunii	2763672	S	80	18	98	0.00011
ERR6913276	Coprococcus comes	410072	S	36	15	51	0.00006
ERR6913276	Coprococcus sp. ART55/1	751585	S	12	1	13	0.00001
ERR6913276	Coprococcus eutactus	33043	S	9	1	10	0.00001
ERR6913276	Coprococcus catus	116085	S	9	2	11	0.00001
ERR6913276	Roseburia intestinalis	166486	S	28	32	60	0.00007
ERR6913276	Roseburia hominis	301301	S	22	5	27	0.00003
ERR6913276	Butyrivibrio fibrisolvens	831	S	21	5	26	0.00003
ERR6913276	Butyrivibrio crossotus	45851	S	13	2	15	0.00002
ERR6913276	Butyrivibrio proteoclasticus	43305	S	12	6	18	0.00002
ERR6913276	[Clostridium] scindens	29347	S	19	2	21	0.00002
ERR6913276	Lachnoclostridium phocaeense	1871021	S	12	1	13	0.00001
ERR6913276	Lachnoclostridium phytofermentans	66219	S	9	0	9	0.00001
ERR6913276	Dorea longicatena	88431	S	30	11	41	0.00005
ERR6913276	Dorea formicigenerans	39486	S	11	4	15	0.00002
ERR6913276	Anaerobutyricum hallii	39488	S	39	8	47	0.00005
ERR6913276	Lachnospira eligens	39485	S	35	3	38	0.00004
ERR6913276	Anaerostipes hadrus	649756	S	27	4	31	0.00003
ERR6913276	[Clostridium] colinum	36835	S	27	0	27	0.00003
ERR6913276	Lacrimispora sphenoides	29370	S	13	5	18	0.00002
ERR6913276	Anaeropeptidivorans aminofermentans	2934315	S	22	0	22	0.00002
ERR6913276	Enterocloster bolteae	208479	S	11	2	13	0.00001
ERR6913276	Enterocloster asparagiformis	333367	S	7	0	7	0.00001
ERR6913276	Anaerocolumna chitinilytica	1727145	S	6	0	6	0.00001
ERR6913276	Anaerocolumna sedimenticola	2696063	S	6	0	6	0.00001
ERR6913276	Anaerocolumna cellulosilytica	433286	S	5	0	5	0.00001
ERR6913276	Sellimonas intestinalis	1653434	S	10	0	10	0.00001
ERR6913276	Anaerotignum propionicum	28446	S	9	0	9	0.00001
ERR6913276	Wansuia hejianensis	2763667	S	9	0	9	0.00001
ERR6913276	Faecalicatena sp. Marseille-Q4148	2823316	S	8	1	9	0.00001
ERR6913276	Pseudobutyrivibrio xylanivorans	185007	S	5	0	5	0.00001
ERR6913276	Clostridium tyrobutyricum	1519	S	209	3	212	0.00023
ERR6913276	Clostridium botulinum	1491	S	166	86	252	0.00028
ERR6913276	Clostridium sp. MD294	97138	S	19	0	19	0.00002
ERR6913276	Clostridium sp. M62/1	411486	S	15	4	19	0.00002
ERR6913276	Clostridium sp. JN-9	2507159	S	10	2	12	0.00001
ERR6913276	Clostridium sp. C1	1155388	S	9	0	9	0.00001
ERR6913276	Clostridium sp. DL-VIII	641107	S	7	2	9	0.00001
ERR6913276	Clostridium gelidum	704125	S	46	1	47	0.00005
ERR6913276	Clostridium perfringens	1502	S	34	85	119	0.00013
ERR6913276	Clostridium pasteurianum	1501	S	26	0	26	0.00003
ERR6913276	Clostridium beijerinckii	1520	S	22	11	33	0.00004
ERR6913276	Clostridium kluyveri	1534	S	22	277	299	0.00033
ERR6913276	Clostridium manihotivorum	2320868	S	21	0	21	0.00002
ERR6913276	Clostridium estertheticum	238834	S	18	0	18	0.00002
ERR6913276	Clostridium cadaveris	1529	S	17	0	17	0.00002
ERR6913276	Clostridium butyricum	1492	S	14	13	27	0.00003
ERR6913276	Clostridium felsineum	36839	S	13	0	13	0.00001
ERR6913276	Clostridium baratii	1561	S	12	0	12	0.00001
ERR6913276	Clostridium saccharoperbutylacetonicum	36745	S	11	4	15	0.00002
ERR6913276	Clostridium scatologenes	1548	S	10	3	13	0.00001
ERR6913276	Clostridium intestinale	36845	S	10	0	10	0.00001
ERR6913276	Clostridium neonatale	137838	S	10	0	10	0.00001
ERR6913276	Clostridium thermarum	1716543	S	9	1	10	0.00001
ERR6913276	Clostridium bornimense	1216932	S	9	1	10	0.00001
ERR6913276	Clostridium gasigenes	94869	S	8	0	8	0.00001
ERR6913276	Clostridium tetani	1513	S	8	0	8	0.00001
ERR6913276	Clostridium tagluense	360422	S	7	0	7	0.00001
ERR6913276	Clostridium formicaceticum	1497	S	7	0	7	0.00001
ERR6913276	Clostridium cochlearium	1494	S	7	0	7	0.00001
ERR6913276	Clostridium cellulovorans	1493	S	5	0	5	0.00001
ERR6913276	Clostridium acetobutylicum	1488	S	5	0	5	0.00001
ERR6913276	Clostridium argentinense	29341	S	5	0	5	0.00001
ERR6913276	Caloramator sp. Dgby_cultured_2	3029174	S	6	2	8	0.00001
ERR6913276	Caloramator sp. mosi_1	3023090	S	5	2	7	0.00001
ERR6913276	Candidatus Arthromitus sp. SFB-rat-Yit	1041504	S	10	5	15	0.00002
ERR6913276	Crassaminicella sp. 143-21	2855394	S	5	3	8	0.00001
ERR6913276	Geosporobacter ferrireducens	1424294	S	12	0	12	0.00001
ERR6913276	Hungatella hathewayi	154046	S	9	0	9	0.00001
ERR6913276	Hathewaya histolytica	1498	S	7	0	7	0.00001
ERR6913276	Faecalibacterium prausnitzii	853	S	118	55	173	0.00019
ERR6913276	Faecalibacterium sp. I4-3-84	2929495	S	42	39	81	0.00009
ERR6913276	Faecalibacterium sp. I2-3-92	2929490	S	13	18	31	0.00003
ERR6913276	Faecalibacterium sp. HTF-F	2929491	S	13	3	16	0.00002
ERR6913276	Faecalibacterium sp. IP-3-29	2929489	S	8	10	18	0.00002
ERR6913276	Faecalibacterium sp. I3-3-89	2929493	S	8	2	10	0.00001
ERR6913276	Faecalibacterium sp. I4-1-79	2929494	S	8	4	12	0.00001
ERR6913276	Faecalibacterium sp. I3-3-33	2929492	S	6	2	8	0.00001
ERR6913276	Faecalibacterium duncaniae	411483	S	17	64	81	0.00009
ERR6913276	Ruminococcus champanellensis	1161942	S	17	1	18	0.00002
ERR6913276	Ruminococcus bicirculans	1160721	S	15	2	17	0.00002
ERR6913276	Ruminococcus gauvreauii	438033	S	11	1	12	0.00001
ERR6913276	Ruminococcus bovis	2564099	S	7	0	7	0.00001
ERR6913276	Dysosmobacter welbionis	2093857	S	16	6	22	0.00002
ERR6913276	Dysosmobacter sp. Marseille-Q4140	2830675	S	16	2	18	0.00002
ERR6913276	Vescimonas coprocola	2714355	S	19	8	27	0.00003
ERR6913276	Vescimonas fastidiosa	2714353	S	8	3	11	0.00001
ERR6913276	Subdoligranulum variabile	214851	S	28	3	31	0.00003
ERR6913276	Mageeibacillus indolicus	884684	S	22	1	23	0.00003
ERR6913276	Acetivibrio thermocellus	1515	S	8	1	9	0.00001
ERR6913276	Acetivibrio clariflavus	288965	S	6	2	8	0.00001
ERR6913276	Flavonifractor plautii	292800	S	19	2	21	0.00002
ERR6913276	Ruthenibacterium lactatiformans	1550024	S	14	1	15	0.00002
ERR6913276	Caproiciproducens sp. NJN-50	2507162	S	12	0	12	0.00001
ERR6913276	Caproicibacterium sp. BJN0003	2994078	S	7	0	7	0.00001
ERR6913276	Ruminiclostridium herbifermentans	2488810	S	7	2	9	0.00001
ERR6913276	Oscillibacter hominis	2763056	S	9	1	10	0.00001
ERR6913276	Thermoclostridium stercorarium	1510	S	7	8	15	0.00002
ERR6913276	Caproicibacter fermentans	2576756	S	7	0	7	0.00001
ERR6913276	Ethanoligenens harbinense	253239	S	7	0	7	0.00001
ERR6913276	Acutalibacter muris	1796620	S	6	0	6	0.00001
ERR6913276	Monoglobus pectinilyticus	1981510	S	6	0	6	0.00001
ERR6913276	Fastidiosipila sanguinis	236753	S	6	0	6	0.00001
ERR6913276	Pseudoclostridium thermosuccinogenes	84032	S	5	0	5	0.00001
ERR6913276	Anaerotruncus colihominis	169435	S	5	1	6	0.00001
ERR6913276	Desulfosporosinus meridiei	79209	S	76	36	112	0.00012
ERR6913276	Desulfosporosinus acidiphilus	885581	S	32	6	38	0.00004
ERR6913276	Desulfosporosinus orientis	1563	S	12	3	15	0.00002
ERR6913276	Desulfosporosinus youngiae	339862	S	8	4	12	0.00001
ERR6913276	Desulfitobacterium dichloroeliminans	233055	S	9	5	14	0.00002
ERR6913276	Desulfitobacterium dehalogenans	36854	S	6	3	9	0.00001
ERR6913276	Desulfitobacterium metallireducens	142877	S	6	1	7	0.00001
ERR6913276	Dehalobacter restrictus	55583	S	10	12	22	0.00002
ERR6913276	Syntrophobotulus glycolicus	51197	S	9	0	9	0.00001
ERR6913276	Mogibacterium diversum	114527	S	70	10	80	0.00009
ERR6913276	Mogibacterium pumilum	86332	S	11	1	12	0.00001
ERR6913276	Aminipila butyrica	433296	S	5	3	8	0.00001
ERR6913276	Fenollaria massiliensis	938288	S	57	4	61	0.00007
ERR6913276	Fenollaria sporofastidiosus	2811778	S	17	2	19	0.00002
ERR6913276	Intestinimonas butyriciproducens	1297617	S	23	1	24	0.00003
ERR6913276	Thermaerobacter sp. FW80	2546351	S	7	1	8	0.00001
ERR6913276	Thermaerobacter marianensis	73919	S	5	3	8	0.00001
ERR6913276	Massilistercora timonensis	2086584	S	6	1	7	0.00001
ERR6913276	Clostridioides difficile	1496	S	33	9	42	0.00005
ERR6913276	Romboutsia ilealis	1115758	S	12	5	17	0.00002
ERR6913276	Romboutsia hominis	1507512	S	6	2	8	0.00001
ERR6913276	Peptostreptococcus sp. CBA3647	3003601	S	15	0	15	0.00002
ERR6913276	Peptacetobacter hiranonis	89152	S	8	1	9	0.00001
ERR6913276	Acetoanaerobium sticklandii	1511	S	5	0	5	0.00001
ERR6913276	Eubacterium ventriosum	39496	S	25	17	42	0.00005
ERR6913276	Eubacterium hominis	2764325	S	12	1	13	0.00001
ERR6913276	Eubacterium sp. c-25	2841037	S	5	0	5	0.00001
ERR6913276	Acetobacterium wieringae	52694	S	8	2	10	0.00001
ERR6913276	Acetobacterium woodii	33952	S	5	1	6	0.00001
ERR6913276	Alkalibacter rhizosphaerae	2815577	S	11	0	11	0.00001
ERR6913276	Desulforamulus ferrireducens	1833852	S	20	5	25	0.00003
ERR6913276	Desulforamulus ruminis	1564	S	12	0	12	0.00001
ERR6913276	Desulforamulus reducens	59610	S	7	0	7	0.00001
ERR6913276	Desulfofarcimen acetoxidans	58138	S	14	0	14	0.00002
ERR6913276	Candidatus Desulforudis audaxviator	471827	S	7	0	7	0.00001
ERR6913276	Candidatus Formimonas warabiya	1761012	S	7	0	7	0.00001
ERR6913276	Acididesulfobacillus acetoxydans	1561005	S	7	0	7	0.00001
ERR6913276	Thermanaerosceptrum fracticalcis	1712410	S	6	0	6	0.00001
ERR6913276	Syntrophothermus lipocalidus	86170	S	12	21	33	0.00004
ERR6913276	Candidatus Contubernalis alkalaceticum	338645	S	6	0	6	0.00001
ERR6913276	Christensenella sp. Marseille-P3954	2086585	S	15	1	16	0.00002
ERR6913276	Christensenella minuta	626937	S	7	0	7	0.00001
ERR6913276	Symbiobacterium thermophilum	2734	S	7	0	7	0.00001
ERR6913276	Heliorestis convoluta	356322	S	5	0	5	0.00001
ERR6913276	Desulfotomaculum nigrificans	1565	S	5	0	5	0.00001
ERR6913276	Caldanaerobacter subterraneus	911092	S	39	3	42	0.00005
ERR6913276	Thermacetogenium phaeum	85874	S	13	6	19	0.00002
ERR6913276	Carboxydothermus hydrogenoformans	129958	S	10	0	10	0.00001
ERR6913276	Gelria sp. Kuro-4	2796927	S	10	0	10	0.00001
ERR6913276	Caldicellulosiruptor acetigenus	301953	S	7	2	9	0.00001
ERR6913276	Caldicellulosiruptor changbaiensis	1222016	S	6	4	10	0.00001
ERR6913276	Thermodesulfobium acidiphilum	1794699	S	6	8	14	0.00002
ERR6913276	Mahella australiensis	252966	S	7	0	7	0.00001
ERR6913276	Halanaerobium praevalens	2331	S	17	0	17	0.00002
ERR6913276	Halanaerobium hydrogeniformans	656519	S	9	0	9	0.00001
ERR6913276	Acetohalobium arabaticum	28187	S	11	0	11	0.00001
ERR6913276	Biomaibacter acetigenes	2316383	S	5	0	5	0.00001
ERR6913276	Veillonella parvula	29466	S	1895	335	2230	0.00245
ERR6913276	Veillonella atypica	39777	S	298	33	331	0.00036
ERR6913276	Veillonella rogosae	423477	S	275	95	370	0.00041
ERR6913276	Veillonella nakazawae	2682456	S	143	229	372	0.00041
ERR6913276	Veillonella dispar	39778	S	106	78	184	0.00020
ERR6913276	Veillonella sp. S12025-13	2682455	S	101	144	245	0.00027
ERR6913276	Veillonella rodentium	248315	S	22	1	23	0.00003
ERR6913276	Megasphaera stantonii	2144175	S	6	20	26	0.00003
ERR6913276	Dialister pneumosintes	39950	S	11	6	17	0.00002
ERR6913276	Selenomonas sp. oral taxon 126	712528	S	91	16	107	0.00012
ERR6913276	Selenomonas sp. oral taxon 920	1884263	S	84	10	94	0.00010
ERR6913276	Selenomonas sp. oral taxon 478	712538	S	16	14	30	0.00003
ERR6913276	Selenomonas sp. oral taxon 136	713030	S	6	4	10	0.00001
ERR6913276	Selenomonas sputigena	69823	S	61	1	62	0.00007
ERR6913276	Selenomonas timonae	2754044	S	49	14	63	0.00007
ERR6913276	Selenomonas ruminantium	971	S	17	0	17	0.00002
ERR6913276	Megamonas funiformis	437897	S	28	9	37	0.00004
ERR6913276	Pelosinus sp. UFO1	484770	S	33	16	49	0.00005
ERR6913276	Pelosinus fermentans	365349	S	7	2	9	0.00001
ERR6913276	Methylomusa anaerophila	1930071	S	16	1	17	0.00002
ERR6913276	Sporomusa termitida	2377	S	6	0	6	0.00001
ERR6913276	Phascolarctobacterium faecium	33025	S	30	0	30	0.00003
ERR6913276	Finegoldia magna	1260	S	1612	175	1787	0.00197
ERR6913276	Anaerococcus prevotii	33034	S	416	39	455	0.00050
ERR6913276	Anaerococcus mediterraneensis	1870984	S	89	12	101	0.00011
ERR6913276	Anaerococcus obesiensis	1287640	S	31	32	63	0.00007
ERR6913276	Anaerococcus vaginalis	33037	S	29	31	60	0.00007
ERR6913276	Peptoniphilus harei	54005	S	203	41	244	0.00027
ERR6913276	Peptoniphilus sp. SAHP1	2948573	S	122	33	155	0.00017
ERR6913276	Peptoniphilus ivorii	54006	S	19	0	19	0.00002
ERR6913276	Parvimonas micra	33033	S	52	5	57	0.00006
ERR6913276	Helcococcus kunzii	40091	S	16	0	16	0.00002
ERR6913276	Murdochiella vaginalis	1852373	S	13	1	14	0.00002
ERR6913276	Miniphocaeibacter halophilus	2931922	S	11	0	11	0.00001
ERR6913276	Gudongella oleilytica	1582259	S	9	0	9	0.00001
ERR6913276	Schnuerera ultunensis	45497	S	6	0	6	0.00001
ERR6913276	Ezakiella coagulans	46507	S	62	19	81	0.00009
ERR6913276	Ezakiella massiliensis	1852374	S	18	3	21	0.00002
ERR6913276	Sedimentibacter sp. zth1	2816908	S	35	0	35	0.00004
ERR6913276	Bulleidia sp. zg-1006	2806552	S	97	4	101	0.00011
ERR6913276	Erysipelothrix larvae	1514105	S	8	5	13	0.00001
ERR6913276	Faecalibacillus intestinalis	1982626	S	18	4	22	0.00002
ERR6913276	Allobaculum sp. Allo2	2853432	S	11	0	11	0.00001
ERR6913276	Faecalitalea cylindroides	39483	S	8	2	10	0.00001
ERR6913276	Longicatena caecimuris	1796635	S	6	1	7	0.00001
ERR6913276	Catenibacterium mitsuokai	100886	S	13	0	13	0.00001
ERR6913276	Thomasclavelia ramosa	1547	S	7	0	7	0.00001
ERR6913276	Turicibacter sanguinis	154288	S	7	4	11	0.00001
ERR6913276	Ndongobacter massiliensis	1871025	S	11	0	11	0.00001
ERR6913276	Limnochorda pilosa	1555112	S	6	0	6	0.00001
ERR6913276	Limnospira indica	147322	S	377	1081	1458	0.00160
ERR6913276	Oscillatoria nigro-viridis	482564	S	134	31	165	0.00018
ERR6913276	Oscillatoria acuminata	118323	S	6	0	6	0.00001
ERR6913276	Moorena producens	1155739	S	139	1	140	0.00015
ERR6913276	Phormidium yuhuli	2974039	S	7	1	8	0.00001
ERR6913276	Microcoleus vaginatus	119532	S	171	16	187	0.00021
ERR6913276	Planktothrix agardhii	1160	S	24	178	202	0.00022
ERR6913276	Oxynema aestuarii	2874213	S	7	0	7	0.00001
ERR6913276	Allocoleopsis franciscana	2886352	S	60	9	69	0.00008
ERR6913276	Geitlerinema sp. PCC 7407	1173025	S	8	1	9	0.00001
ERR6913276	Crinalium epipsammum	241425	S	24	5	29	0.00003
ERR6913276	Geminocystis sp. NIES-3708	1615909	S	165	83	248	0.00027
ERR6913276	Geminocystis sp. NIES-3709	1617448	S	52	23	75	0.00008
ERR6913276	Geminocystis herdmanii	669359	S	12	6	18	0.00002
ERR6913276	Chondrocystis sp. NIES-4102	2005460	S	129	53	182	0.00020
ERR6913276	Gloeocapsa sp. PCC 7428	1173026	S	10	2	12	0.00001
ERR6913276	Candidatus Atelocyanobacterium thalassa	713887	S	197	35	232	0.00026
ERR6913276	Gloeothece verrucosa	2546359	S	23	2	25	0.00003
ERR6913276	Gloeothece citriformis	2546356	S	6	0	6	0.00001
ERR6913276	Euhalothece natronophila	577489	S	8	3	11	0.00001
ERR6913276	Halothece sp. PCC 7418	65093	S	6	4	10	0.00001
ERR6913276	Crocosphaera subtropica	2546360	S	7	1	8	0.00001
ERR6913276	Microcystis sp. MC19	1967666	S	8	64	72	0.00008
ERR6913276	Cyanobacterium aponinum	379064	S	30	29	59	0.00006
ERR6913276	Cyanobacterium sp. uoEpiScrs1	2976343	S	11	9	20	0.00002
ERR6913276	Synechococcus sp. PCC 7336	195250	S	254	11	265	0.00029
ERR6913276	Synechococcus sp. PCC 7502	1173263	S	209	25	234	0.00026
ERR6913276	Synechococcus sp. JA-2-3B'a(2-13)	321332	S	94	40	134	0.00015
ERR6913276	Synechococcus sp. PCC 6312	195253	S	32	2	34	0.00004
ERR6913276	Synechococcus sp. CB0101	232348	S	23	30	53	0.00006
ERR6913276	Synechococcus sp. CBW1004	1353136	S	16	26	42	0.00005
ERR6913276	Synechococcus sp. CBW1107	2789857	S	15	25	40	0.00004
ERR6913276	Synechococcus sp. LA31	2741953	S	14	15	29	0.00003
ERR6913276	Synechococcus sp. JA-3-3Ab	321327	S	11	4	15	0.00002
ERR6913276	Synechococcus sp. NIES-970	1827144	S	7	2	9	0.00001
ERR6913276	Synechococcus sp. PCC 73109	374982	S	6	60	66	0.00007
ERR6913276	Synechococcus sp. BIOS-U3-1	1400865	S	5	2	7	0.00001
ERR6913276	Synechococcus sp. WH 8020	32052	S	5	4	9	0.00001
ERR6913276	Dactylococcopsis salina	292566	S	5	3	8	0.00001
ERR6913276	Chamaesiphon minutus	1173032	S	302	26	328	0.00036
ERR6913276	Prochlorococcus marinus	1219	S	44	17	61	0.00007
ERR6913276	Prochlorococcus sp. MIT 0604	1501268	S	7	29	36	0.00004
ERR6913276	Cyanobium gracile	59930	S	8	18	26	0.00003
ERR6913276	Cyanobium sp. NS01	261284	S	6	22	28	0.00003
ERR6913276	Acaryochloris marina	155978	S	26	7	33	0.00004
ERR6913276	Acaryochloris sp. 'Moss Beach'	2740837	S	12	13	25	0.00003
ERR6913276	Calothrix sp. PCC 6303	1170562	S	423	58	481	0.00053
ERR6913276	Calothrix sp. NIES-3974	2005462	S	20	1	21	0.00002
ERR6913276	Calothrix sp. PCC 7716	2853227	S	18	4	22	0.00002
ERR6913276	Calothrix sp. PCC 7507	99598	S	15	2	17	0.00002
ERR6913276	Calothrix sp. 336/3	1337936	S	9	1	10	0.00001
ERR6913276	Calothrix sp. NIES-2098	1954171	S	5	1	6	0.00001
ERR6913276	Calothrix parasitica	1973486	S	8	0	8	0.00001
ERR6913276	Nostoc sp. CENA543	1869241	S	17	4	21	0.00002
ERR6913276	Nostoc sp. UHCC 0870	2914041	S	16	5	21	0.00002
ERR6913276	Nostoc sp. UHCC 0926	3025190	S	10	18	28	0.00003
ERR6913276	Nostoc sp. MS1	2764711	S	9	4	13	0.00001
ERR6913276	Nostoc sp. TCL26-01	2576904	S	9	1	10	0.00001
ERR6913276	Nostoc sp. PCC 7107	317936	S	8	6	14	0.00002
ERR6913276	Nostoc sp. 'Peltigera membranacea cyanobiont' N6	1261031	S	6	13	19	0.00002
ERR6913276	Nostoc sp. TCL240-02	2572090	S	6	25	31	0.00003
ERR6913276	Nostoc sp. UHCC 0702	2814655	S	5	2	7	0.00001
ERR6913276	Nostoc flagelliforme	1306274	S	8	25	33	0.00004
ERR6913276	Nostoc edaphicum	264686	S	6	17	23	0.00003
ERR6913276	Nostoc punctiforme	272131	S	6	35	41	0.00005
ERR6913276	Nostoc piscinale	224012	S	5	2	7	0.00001
ERR6913276	Anabaena sp. YBS01	2490939	S	6	182	188	0.00021
ERR6913276	Anabaena cylindrica	1165	S	6	5	11	0.00001
ERR6913276	Trichormus azollae	1164	S	9	1	10	0.00001
ERR6913276	Dolichospermum compactum	136073	S	17	28	45	0.00005
ERR6913276	Dolichospermum flos-aquae	1166	S	5	34	39	0.00004
ERR6913276	Scytonema sp. HK-05	1137095	S	12	17	29	0.00003
ERR6913276	Scytonema sp. NIES-4073	2005464	S	5	7	12	0.00001
ERR6913276	Fischerella sp. NIES-3754	1752063	S	6	5	11	0.00001
ERR6913276	Tolypothrix sp. PCC 7910	2099387	S	5	3	8	0.00001
ERR6913276	Rivularia sp. PCC 7116	373994	S	7	0	7	0.00001
ERR6913276	Leptolyngbya sp. 7M	2812896	S	80	9	89	0.00010
ERR6913276	Leptolyngbya sp. NIES-3755	1752064	S	22	25	47	0.00005
ERR6913276	Leptolyngbya sp. BL0902	1115757	S	19	5	24	0.00003
ERR6913276	Leptolyngbya sp. PCC 7376	111781	S	16	2	18	0.00002
ERR6913276	Leptolyngbya sp. PKUAC-SCTB231	2016064	S	11	8	19	0.00002
ERR6913276	Kovacikia minuta	2931930	S	38	10	48	0.00005
ERR6913276	Leptothermofonsia sichuanensis	2917832	S	10	14	24	0.00003
ERR6913276	Pseudanabaena sp. PCC 7367	82654	S	64	7	71	0.00008
ERR6913276	Pseudanabaena sp. Chao 1811	2963092	S	7	25	32	0.00004
ERR6913276	Pseudanabaena sp. ABRG5-3	685565	S	6	15	21	0.00002
ERR6913276	Thermosynechococcus vestitus	146786	S	7	2	9	0.00001
ERR6913276	Gloeomargarita lithophora	1188228	S	213	14	227	0.00025
ERR6913276	Chroococcidiopsis sp. CCMEE 29	155894	S	141	56	197	0.00022
ERR6913276	Chroococcidiopsis thermalis	54299	S	8	30	38	0.00004
ERR6913276	Gloeobacter morelensis	2907343	S	8	92	100	0.00011
ERR6913276	Anthocerotibacter panamensis	2857077	S	26	39	65	0.00007
ERR6913276	Stanieria cyanosphaera	102116	S	12	7	19	0.00002
ERR6913276	Stanieria sp. NIES-3757	1807358	S	8	3	11	0.00001
ERR6913276	Pleurocapsa sp. PCC 7327	118163	S	10	1	11	0.00001
ERR6913276	cyanobacterium endosymbiont of Epithemia turgida	718217	S	82	39	121	0.00013
ERR6913276	Mycoplasma sp. (ex Biomphalaria glabrata)	1749074	S	24	0	24	0.00003
ERR6913276	Mycoplasma mycoides	2102	S	11	86	97	0.00011
ERR6913276	Mycoplasma wenyonii	65123	S	7	0	7	0.00001
ERR6913276	Mycoplasma nasistruthionis	353852	S	6	0	6	0.00001
ERR6913276	Mycoplasmopsis synoviae	2109	S	5	4	9	0.00001
ERR6913276	Mycoplasmopsis columbinasalis	114880	S	5	0	5	0.00001
ERR6913276	Mesomycoplasma hyopneumoniae	2099	S	8	4	12	0.00001
ERR6913276	Candidatus Phytoplasma luffae	35773	S	10	6	16	0.00002
ERR6913276	Paracholeplasma brassicae	61635	S	15	26	41	0.00005
ERR6913276	Acholeplasma hippikon	264636	S	9	5	14	0.00002
ERR6913276	Alteracholeplasma palmae	38986	S	6	4	10	0.00001
ERR6913276	Spiroplasma platyhelix	301585	S	17	1	18	0.00002
ERR6913276	Spiroplasma chinense	216932	S	12	19	31	0.00003
ERR6913276	Williamsoniiplasma luminosum	214888	S	7	1	8	0.00001
ERR6913276	Metamycoplasma anseris	92400	S	5	2	7	0.00001
ERR6913276	Mycoplasmoides gallisepticum	2096	S	7	2	9	0.00001
ERR6913276	Brevefilum fermentans	1986204	S	109	10	119	0.00013
ERR6913276	Pelolinea submarina	913107	S	15	1	16	0.00002
ERR6913276	Anaerolinea thermophila	167964	S	14	2	16	0.00002
ERR6913276	Roseiflexus sp. RS-1	357808	S	23	15	38	0.00004
ERR6913276	Roseiflexus castenholzii	120962	S	7	5	12	0.00001
ERR6913276	Chloroflexus aggregans	152260	S	10	14	24	0.00003
ERR6913276	Phototrophicus methaneseepsis	2710758	S	56	1	57	0.00006
ERR6913276	Candidatus Promineofilum breve	1806508	S	33	1	34	0.00004
ERR6913276	Dehalococcoides mccartyi	61435	S	6	9	15	0.00002
ERR6913276	Tepidiforma bonchosmolovskayae	2601677	S	7	14	21	0.00002
ERR6913276	Caldilinea aerophila	133453	S	22	4	26	0.00003
ERR6913276	Ktedonosporobacter rubrisoli	2509675	S	6	0	6	0.00001
ERR6913276	Deinococcus wulumuqiensis	980427	S	44	17	61	0.00007
ERR6913276	Deinococcus sp. NW-56	2080419	S	11	1	12	0.00001
ERR6913276	Deinococcus sp. QL22	2939437	S	8	0	8	0.00001
ERR6913276	Deinococcus sp. AJ005	2652443	S	7	0	7	0.00001
ERR6913276	Deinococcus sp. TS-293	2737050	S	6	0	6	0.00001
ERR6913276	Deinococcus gobiensis	502394	S	28	3	31	0.00003
ERR6913276	Deinococcus peraridilitoris	432329	S	26	0	26	0.00003
ERR6913276	Deinococcus ficus	317577	S	17	1	18	0.00002
ERR6913276	Deinococcus aetherius	200252	S	13	1	14	0.00002
ERR6913276	Deinococcus metallilatus	1211322	S	13	2	15	0.00002
ERR6913276	Deinococcus proteolyticus	55148	S	12	2	14	0.00002
ERR6913276	Deinococcus maricopensis	309887	S	9	0	9	0.00001
ERR6913276	Deinococcus radiophilus	32062	S	9	1	10	0.00001
ERR6913276	Deinococcus radiodurans	1299	S	8	2	10	0.00001
ERR6913276	Deinococcus aquaticus	328692	S	7	1	8	0.00001
ERR6913276	Deinococcus puniceus	1182568	S	7	1	8	0.00001
ERR6913276	Deinococcus geothermalis	68909	S	5	0	5	0.00001
ERR6913276	Thermus sp. NEB1569	2918899	S	8	6	14	0.00002
ERR6913276	Thermus thermophilus	274	S	8	2	10	0.00001
ERR6913276	Thermus scotoductus	37636	S	7	8	15	0.00002
ERR6913276	Thermus brockianus	56956	S	5	0	5	0.00001
ERR6913276	Meiothermus ruber	277	S	24	0	24	0.00003
ERR6913276	Meiothermus taiwanensis	172827	S	7	0	7	0.00001
ERR6913276	Oceanithermus profundus	187137	S	13	0	13	0.00001
ERR6913276	Allomeiothermus silvanus	52022	S	6	0	6	0.00001
ERR6913276	Truepera radiovictrix	332249	S	5	0	5	0.00001
ERR6913276	Fimbriimonas ginsengisoli	1005039	S	22	0	22	0.00002
ERR6913276	Chthonomonas calidirosea	454171	S	10	0	10	0.00001
ERR6913276	Sphaerobacter thermophilus	2057	S	16	0	16	0.00002
ERR6913276	Acinetobacter lwoffii	28090	S	3142	2772	5914	0.00650
ERR6913276	Acinetobacter johnsonii	40214	S	1997	1290	3287	0.00362
ERR6913276	Acinetobacter sp. WCHA45	2004644	S	234	101	335	0.00037
ERR6913276	Acinetobacter sp. WY4	2708348	S	94	129	223	0.00025
ERR6913276	Acinetobacter sp. NEB 394	2743575	S	83	130	213	0.00023
ERR6913276	Acinetobacter sp. F9	2853158	S	75	80	155	0.00017
ERR6913276	Acinetobacter sp. TR11	3003393	S	65	82	147	0.00016
ERR6913276	Acinetobacter sp. WCHA55	2004646	S	65	24	89	0.00010
ERR6913276	Acinetobacter sp. NEB149	2725684	S	62	165	227	0.00025
ERR6913276	Acinetobacter sp. Z1	2953738	S	62	5	67	0.00007
ERR6913276	Acinetobacter sp. NyZ410	2929509	S	57	29	86	0.00009
ERR6913276	Acinetobacter sp. 10FS3-1	2563897	S	53	11	64	0.00007
ERR6913276	Acinetobacter sp. TR3	3003392	S	49	65	114	0.00013
ERR6913276	Acinetobacter sp. TTH0-4	1646498	S	44	3	47	0.00005
ERR6913276	Acinetobacter sp. CS-2	2798861	S	39	6	45	0.00005
ERR6913276	Acinetobacter sp. C16S1	2609668	S	35	8	43	0.00005
ERR6913276	Acinetobacter sp. LUNF3	2925837	S	29	102	131	0.00014
ERR6913276	Acinetobacter sp. WCHAc010034	1879049	S	25	2	27	0.00003
ERR6913276	Acinetobacter sp. SCLZS86	2908637	S	25	11	36	0.00004
ERR6913276	Acinetobacter sp. NCu2D-2	1608473	S	23	1	24	0.00003
ERR6913276	Acinetobacter sp. C32I	2950074	S	22	2	24	0.00003
ERR6913276	Acinetobacter sp. PK01	2930198	S	21	17	38	0.00004
ERR6913276	Acinetobacter sp. TGL-Y2	1407071	S	20	0	20	0.00002
ERR6913276	Acinetobacter sp. MYb10	1827285	S	19	13	32	0.00004
ERR6913276	Acinetobacter sp. LoGeW2-3	1808001	S	19	1	20	0.00002
ERR6913276	Acinetobacter sp. ACNIH2	1758189	S	19	16	35	0.00004
ERR6913276	Acinetobacter sp. GSS19	3020716	S	18	0	18	0.00002
ERR6913276	Acinetobacter sp. SWBY1	2079596	S	18	24	42	0.00005
ERR6913276	Acinetobacter sp. Colony158	2810070	S	15	20	35	0.00004
ERR6913276	Acinetobacter sp. Marseille-Q1620	2714110	S	12	0	12	0.00001
ERR6913276	Acinetobacter sp. ASP199	2773709	S	12	1	13	0.00001
ERR6913276	Acinetobacter sp. FDAARGOS_724	2545797	S	8	24	32	0.00004
ERR6913276	Acinetobacter sp. YH16056_T	2929514	S	7	7	14	0.00002
ERR6913276	Acinetobacter sp. YH12138	2601122	S	5	6	11	0.00001
ERR6913276	Acinetobacter junii	40215	S	708	92	800	0.00088
ERR6913276	Acinetobacter ursingii	108980	S	589	538	1127	0.00124
ERR6913276	Acinetobacter baumannii	470	S	311	1415	1726	0.00190
ERR6913276	Acinetobacter pittii	48296	S	86	75	161	0.00018
ERR6913276	Acinetobacter nosocomialis	106654	S	47	50	97	0.00011
ERR6913276	Acinetobacter seifertii	1530123	S	27	5	32	0.00004
ERR6913276	Acinetobacter calcoaceticus	471	S	12	1	13	0.00001
ERR6913276	Acinetobacter lactucae	1785128	S	5	4	9	0.00001
ERR6913276	Acinetobacter schindleri	108981	S	288	55	343	0.00038
ERR6913276	Acinetobacter indicus	756892	S	156	18	174	0.00019
ERR6913276	Acinetobacter haemolyticus	29430	S	110	25	135	0.00015
ERR6913276	Acinetobacter pseudolwoffii	2053287	S	110	88	198	0.00022
ERR6913276	Acinetobacter towneri	202956	S	103	89	192	0.00021
ERR6913276	Acinetobacter radioresistens	40216	S	98	8	106	0.00012
ERR6913276	Acinetobacter variabilis	70346	S	86	69	155	0.00017
ERR6913276	Acinetobacter lanii	2715163	S	72	2	74	0.00008
ERR6913276	Acinetobacter septicus	465797	S	64	114	178	0.00020
ERR6913276	Acinetobacter gyllenbergii	134534	S	53	6	59	0.00006
ERR6913276	Acinetobacter guillouiae	106649	S	51	23	74	0.00008
ERR6913276	Acinetobacter tandoii	202954	S	50	2	52	0.00006
ERR6913276	Acinetobacter venetianus	52133	S	48	5	53	0.00006
ERR6913276	Acinetobacter colistiniresistens	280145	S	43	3	46	0.00005
ERR6913276	Acinetobacter soli	487316	S	37	1	38	0.00004
ERR6913276	Acinetobacter dispersus	70348	S	37	3	40	0.00004
ERR6913276	Acinetobacter vivianii	1776742	S	37	1	38	0.00004
ERR6913276	Acinetobacter portensis	1839785	S	35	7	42	0.00005
ERR6913276	Acinetobacter wuhouensis	1879050	S	35	4	39	0.00004
ERR6913276	Acinetobacter defluvii	1871111	S	35	5	40	0.00004
ERR6913276	Acinetobacter shaoyimingii	2715164	S	30	0	30	0.00003
ERR6913276	Acinetobacter tibetensis	2943497	S	28	2	30	0.00003
ERR6913276	Acinetobacter larvae	1789224	S	23	0	23	0.00003
ERR6913276	Acinetobacter wanghuae	2662362	S	22	0	22	0.00002
ERR6913276	Acinetobacter bereziniae	106648	S	19	14	33	0.00004
ERR6913276	Acinetobacter piscicola	2006115	S	16	1	17	0.00002
ERR6913276	Acinetobacter bouvetii	202951	S	11	1	12	0.00001
ERR6913276	Acinetobacter cumulans	2136182	S	10	0	10	0.00001
ERR6913276	Acinetobacter equi	1324350	S	7	0	7	0.00001
ERR6913276	Acinetobacter baylyi	202950	S	7	0	7	0.00001
ERR6913276	Acinetobacter chinensis	2004650	S	6	2	8	0.00001
ERR6913276	Moraxella osloensis	34062	S	4455	176	4631	0.00509
ERR6913276	Moraxella nonliquefaciens	478	S	375	39	414	0.00046
ERR6913276	Moraxella bovis	476	S	34	4	38	0.00004
ERR6913276	Moraxella catarrhalis	480	S	14	1	15	0.00002
ERR6913276	Psychrobacter sp. WY6	2708350	S	49	14	63	0.00007
ERR6913276	Psychrobacter sp. P11F6	1699621	S	49	14	63	0.00007
ERR6913276	Psychrobacter sp. DAB_AL43B	1028416	S	35	1	36	0.00004
ERR6913276	Psychrobacter sp.	56811	S	21	2	23	0.00003
ERR6913276	Psychrobacter sp. KCTC 72983	2733866	S	21	16	37	0.00004
ERR6913276	Psychrobacter sp. AntiMn-1	1720344	S	18	37	55	0.00006
ERR6913276	Psychrobacter sp. G	571800	S	16	28	44	0.00005
ERR6913276	Psychrobacter sp. 28M-43	2772254	S	15	2	17	0.00002
ERR6913276	Psychrobacter sp. P2G3	1699622	S	14	9	23	0.00003
ERR6913276	Psychrobacter sp. P11G3	1699623	S	13	1	14	0.00002
ERR6913276	Psychrobacter sp. P11G5	1699624	S	12	7	19	0.00002
ERR6913276	Psychrobacter sp. PraFG1	2565531	S	11	8	19	0.00002
ERR6913276	Psychrobacter sp. SC65A.3	2983299	S	10	17	27	0.00003
ERR6913276	Psychrobacter sp. KH172YL61	2517899	S	8	13	21	0.00002
ERR6913276	Psychrobacter sp. YP14	2203895	S	7	6	13	0.00001
ERR6913276	Psychrobacter sanguinis	861445	S	316	32	348	0.00038
ERR6913276	Psychrobacter arenosus	256326	S	23	0	23	0.00003
ERR6913276	Psychrobacter arcticus	334543	S	22	2	24	0.00003
ERR6913276	Psychrobacter urativorans	45610	S	11	0	11	0.00001
ERR6913276	Psychrobacter cryohalolentis	330922	S	11	20	31	0.00003
ERR6913276	Aquirhabdus parva	2283318	S	114	0	114	0.00013
ERR6913276	Pseudomonas sp. LTJR-52	2479392	S	175	14	189	0.00021
ERR6913276	Pseudomonas sp. NIBR-H-19	2901380	S	114	13	127	0.00014
ERR6913276	Pseudomonas sp. OE 28.3	2745519	S	65	7	72	0.00008
ERR6913276	Pseudomonas sp. NIBRBAC000502773	2590776	S	63	12	75	0.00008
ERR6913276	Pseudomonas sp. phDV1	253237	S	52	35	87	0.00010
ERR6913276	Pseudomonas sp. LG1E9	2219057	S	40	6	46	0.00005
ERR6913276	Pseudomonas sp. AO-1	2855434	S	37	31	68	0.00007
ERR6913276	Pseudomonas sp. PDNC002	2811422	S	31	4	35	0.00004
ERR6913276	Pseudomonas sp. GXZC	3003351	S	29	8	37	0.00004
ERR6913276	Pseudomonas sp. NS1(2017)	2025658	S	29	5	34	0.00004
ERR6913276	Pseudomonas sp. SDM007	2812000	S	27	11	38	0.00004
ERR6913276	Pseudomonas sp. BT-42-2	2986927	S	25	1	26	0.00003
ERR6913276	Pseudomonas sp. AN-B15	2697023	S	25	66	91	0.00010
ERR6913276	Pseudomonas sp. FDAARGOS_380	2018067	S	24	7	31	0.00003
ERR6913276	Pseudomonas sp. J380	2605424	S	24	23	47	0.00005
ERR6913276	Pseudomonas sp. S35	1573719	S	23	3	26	0.00003
ERR6913276	Pseudomonas sp. ATCC 13867	1294143	S	23	4	27	0.00003
ERR6913276	Pseudomonas sp. MM227	3019968	S	23	1	24	0.00003
ERR6913276	Pseudomonas sp. Q1-7	3020843	S	23	1	24	0.00003
ERR6913276	Pseudomonas sp. ZM23	2961893	S	22	3	25	0.00003
ERR6913276	Pseudomonas sp. MTM4	2705472	S	22	1	23	0.00003
ERR6913276	Pseudomonas sp. GCEP-101	2974552	S	21	3	24	0.00003
ERR6913276	Pseudomonas sp. MM213	2866807	S	20	2	22	0.00002
ERR6913276	Pseudomonas sp. S09G 359	2054919	S	18	2	20	0.00002
ERR6913276	Pseudomonas sp. J452	2898441	S	18	1	19	0.00002
ERR6913276	Pseudomonas sp. TMW 2.1634	1886807	S	18	9	27	0.00003
ERR6913276	Pseudomonas sp. Lz4W	1206777	S	17	7	24	0.00003
ERR6913276	Pseudomonas sp. NY11382	2939495	S	16	25	41	0.00005
ERR6913276	Pseudomonas sp. PIA16	2931382	S	16	0	16	0.00002
ERR6913276	Pseudomonas sp. ADAK18	2730848	S	16	1	17	0.00002
ERR6913276	Pseudomonas sp. BSw22131	3002903	S	16	0	16	0.00002
ERR6913276	Pseudomonas sp. KNUC1026	2893890	S	16	0	16	0.00002
ERR6913276	Pseudomonas sp. URMO17WK12:I11	1283291	S	15	3	18	0.00002
ERR6913276	Pseudomonas sp. TCU-HL1	1856685	S	15	1	16	0.00002
ERR6913276	Pseudomonas sp. CC6-YY-74	1930532	S	15	0	15	0.00002
ERR6913276	Pseudomonas sp. ADAK13	2730847	S	15	2	17	0.00002
ERR6913276	Pseudomonas sp. SL4(2022)	2994661	S	15	0	15	0.00002
ERR6913276	Pseudomonas sp. HLS-6	2049589	S	14	0	14	0.00002
ERR6913276	Pseudomonas sp. 15A4	2804761	S	14	1	15	0.00002
ERR6913276	Pseudomonas sp. 7SR1	1881017	S	14	1	15	0.00002
ERR6913276	Pseudomonas sp. ABC1	2748080	S	14	0	14	0.00002
ERR6913276	Pseudomonas sp. DTU12.3	2073078	S	13	1	14	0.00002
ERR6913276	Pseudomonas sp. SCB32	2653853	S	13	1	14	0.00002
ERR6913276	Pseudomonas sp. B21-036	2895485	S	13	5	18	0.00002
ERR6913276	Pseudomonas sp. S34	1573718	S	13	1	14	0.00002
ERR6913276	Pseudomonas sp. Ost2	2678260	S	13	0	13	0.00001
ERR6913276	Pseudomonas sp. TUM22785	3019098	S	13	16	29	0.00003
ERR6913276	Pseudomonas sp. BW7P1	2973088	S	13	1	14	0.00002
ERR6913276	Pseudomonas sp. C27(2019)	2604941	S	12	0	12	0.00001
ERR6913276	Pseudomonas sp. CMR5c	658630	S	12	2	14	0.00002
ERR6913276	Pseudomonas sp. GOM7	2998079	S	12	0	12	0.00001
ERR6913276	Pseudomonas sp. B21-040	2895486	S	11	1	12	0.00001
ERR6913276	Pseudomonas sp. LS1212	2972478	S	11	0	11	0.00001
ERR6913276	Pseudomonas sp. CIP-10	2892442	S	11	20	31	0.00003
ERR6913276	Pseudomonas sp. WJP1	2986947	S	11	1	12	0.00001
ERR6913276	Pseudomonas sp. LG1D9	2083054	S	11	46	57	0.00006
ERR6913276	Pseudomonas sp. T1-3-2	2908006	S	10	0	10	0.00001
ERR6913276	Pseudomonas sp. OIL-1	2706126	S	10	0	10	0.00001
ERR6913276	Pseudomonas sp. CFSAN084952	2664899	S	10	8	18	0.00002
ERR6913276	Pseudomonas sp. S49	1573720	S	10	28	38	0.00004
ERR6913276	Pseudomonas sp. MSPm1	2726956	S	10	1	11	0.00001
ERR6913276	Pseudomonas sp. MPC6	2498848	S	9	0	9	0.00001
ERR6913276	Pseudomonas sp. p1(2021b)	2874628	S	9	1	10	0.00001
ERR6913276	Pseudomonas sp. So3.2b	2864101	S	9	7	16	0.00002
ERR6913276	Pseudomonas sp. MYb193	1827300	S	9	7	16	0.00002
ERR6913276	Pseudomonas sp. BIOMIG1BAC	1758730	S	9	9	18	0.00002
ERR6913276	Pseudomonas sp. 7-41	2898483	S	9	10	19	0.00002
ERR6913276	Pseudomonas sp. CBS	2971912	S	9	1	10	0.00001
ERR6913276	Pseudomonas sp. KU26590	2991051	S	9	0	9	0.00001
ERR6913276	Pseudomonas sp. B21-047	2895489	S	9	5	14	0.00002
ERR6913276	Pseudomonas sp. B21-051	2895491	S	8	2	10	0.00001
ERR6913276	Pseudomonas sp. HN11	1344094	S	8	0	8	0.00001
ERR6913276	Pseudomonas sp. MM211	2866808	S	8	0	8	0.00001
ERR6913276	Pseudomonas sp. N3-W	2975049	S	8	0	8	0.00001
ERR6913276	Pseudomonas sp. B11D7D	2735906	S	8	0	8	0.00001
ERR6913276	Pseudomonas sp. B21-017	2895474	S	7	24	31	0.00003
ERR6913276	Pseudomonas sp. HS-18	2879114	S	7	3	10	0.00001
ERR6913276	Pseudomonas sp. B21-010	2895471	S	7	1	8	0.00001
ERR6913276	Pseudomonas sp. DG56-2	2320270	S	7	0	7	0.00001
ERR6913276	Pseudomonas sp. ADAK22	2730851	S	7	21	28	0.00003
ERR6913276	Pseudomonas sp. JBR1	3020907	S	7	1	8	0.00001
ERR6913276	Pseudomonas sp. LRP2-20	2944234	S	7	0	7	0.00001
ERR6913276	Pseudomonas sp. ACM7	2052956	S	7	0	7	0.00001
ERR6913276	Pseudomonas sp. Z8(2022)	2962597	S	7	0	7	0.00001
ERR6913276	Pseudomonas sp. StFLB209	1028989	S	7	0	7	0.00001
ERR6913276	Pseudomonas sp. CYM-20-01	2870750	S	6	1	7	0.00001
ERR6913276	Pseudomonas sp. Leaf58	1736226	S	6	0	6	0.00001
ERR6913276	Pseudomonas sp. Seg1	2678259	S	6	0	6	0.00001
ERR6913276	Pseudomonas sp. Tri1	2823875	S	6	0	6	0.00001
ERR6913276	Pseudomonas sp. LS.1a	2920387	S	6	1	7	0.00001
ERR6913276	Pseudomonas sp. R76	1573711	S	6	1	7	0.00001
ERR6913276	Pseudomonas sp. B21-053	2895493	S	6	0	6	0.00001
ERR6913276	Pseudomonas sp. Y5-11	2749808	S	6	16	22	0.00002
ERR6913276	Pseudomonas sp. SWI36	2083052	S	6	7	13	0.00001
ERR6913276	Pseudomonas sp. 02C 26	2054914	S	6	17	23	0.00003
ERR6913276	Pseudomonas sp. PSKL.D1	3029060	S	6	0	6	0.00001
ERR6913276	Pseudomonas sp. HD6515	2856556	S	5	11	16	0.00002
ERR6913276	Pseudomonas sp. LTGT-11-2Z	2479393	S	5	20	25	0.00003
ERR6913276	Pseudomonas sp. Z003-0.4C(8344-21)	1855380	S	5	1	6	0.00001
ERR6913276	Pseudomonas sp. B21-048	2895490	S	5	0	5	0.00001
ERR6913276	Pseudomonas sp. R84	1573712	S	5	1	6	0.00001
ERR6913276	Pseudomonas sp. Sm006	2731552	S	5	7	12	0.00001
ERR6913276	Pseudomonas sp. NC02	2067572	S	5	8	13	0.00001
ERR6913276	Pseudomonas sp. SK3(2021)	2841064	S	5	1	6	0.00001
ERR6913276	Pseudomonas sp. DY-1	1755504	S	5	0	5	0.00001
ERR6913276	Pseudomonas fluorescens	294	S	480	86	566	0.00062
ERR6913276	Pseudomonas azotoformans	47878	S	180	41	221	0.00024
ERR6913276	Pseudomonas rhodesiae	76760	S	91	7	98	0.00011
ERR6913276	Pseudomonas synxantha	47883	S	47	14	61	0.00007
ERR6913276	Pseudomonas migulae	78543	S	40	24	64	0.00007
ERR6913276	Pseudomonas veronii	76761	S	37	22	59	0.00006
ERR6913276	Pseudomonas brenneri	129817	S	30	2	32	0.00004
ERR6913276	Pseudomonas orientalis	76758	S	23	2	25	0.00003
ERR6913276	Pseudomonas protegens	380021	S	22	5	27	0.00003
ERR6913276	Pseudomonas moraviensis	321662	S	22	8	30	0.00003
ERR6913276	Pseudomonas poae	200451	S	22	3	25	0.00003
ERR6913276	Pseudomonas trivialis	200450	S	19	3	22	0.00002
ERR6913276	Pseudomonas tolaasii	29442	S	18	1	19	0.00002
ERR6913276	Pseudomonas libanensis	75588	S	15	8	23	0.00003
ERR6913276	Pseudomonas koreensis	198620	S	11	2	13	0.00001
ERR6913276	Pseudomonas mucidolens	46679	S	10	0	10	0.00001
ERR6913276	Pseudomonas cedrina	651740	S	10	1	11	0.00001
ERR6913276	Pseudomonas corrugata	47879	S	9	0	9	0.00001
ERR6913276	Pseudomonas granadensis	1421430	S	8	1	9	0.00001
ERR6913276	Pseudomonas mediterranea	183795	S	6	0	6	0.00001
ERR6913276	Pseudomonas extremorientalis	169669	S	5	3	8	0.00001
ERR6913276	Pseudomonas congelans	200452	S	5	0	5	0.00001
ERR6913276	Pseudomonas putida	303	S	375	96	471	0.00052
ERR6913276	Pseudomonas oryzihabitans	47885	S	323	31	354	0.00039
ERR6913276	Pseudomonas monteilii	76759	S	37	14	51	0.00006
ERR6913276	Pseudomonas fulva	47880	S	25	5	30	0.00003
ERR6913276	Pseudomonas sp. SGAir0191	2217867	S	17	2	19	0.00002
ERR6913276	Pseudomonas mosselii	78327	S	13	10	23	0.00003
ERR6913276	Pseudomonas plecoglossicida	70775	S	9	1	10	0.00001
ERR6913276	Pseudomonas fragi	296	S	396	44	440	0.00048
ERR6913276	Pseudomonas lundensis	86185	S	101	2	103	0.00011
ERR6913276	Pseudomonas chlororaphis	587753	S	47	18	65	0.00007
ERR6913276	Pseudomonas aeruginosa	287	S	208	3547	3755	0.00413
ERR6913276	Pseudomonas alcaligenes	43263	S	82	7	89	0.00010
ERR6913276	Pseudomonas oleovorans	301	S	55	35	90	0.00010
ERR6913276	Pseudomonas furukawaii	1149133	S	12	0	12	0.00001
ERR6913276	Pseudomonas mendocina	300	S	63	9	72	0.00008
ERR6913276	Pseudomonas multiresinivorans	95301	S	26	2	28	0.00003
ERR6913276	Pseudomonas nitroreducens	46680	S	10	2	12	0.00001
ERR6913276	Pseudomonas citronellolis	53408	S	19	5	24	0.00003
ERR6913276	Pseudomonas resinovorans	53412	S	14	0	14	0.00002
ERR6913276	Pseudomonas luteola	47886	S	287	24	311	0.00034
ERR6913276	Pseudomonas psychrotolerans	237610	S	240	14	254	0.00028
ERR6913276	Pseudomonas lurida	244566	S	157	9	166	0.00018
ERR6913276	Pseudomonas syringae	317	S	56	28	84	0.00009
ERR6913276	Pseudomonas viridiflava	33069	S	29	1	30	0.00003
ERR6913276	Pseudomonas asturiensis	1190415	S	12	0	12	0.00001
ERR6913276	Pseudomonas coronafaciens	53409	S	9	12	21	0.00002
ERR6913276	Pseudomonas psychrophila	122355	S	132	3	135	0.00015
ERR6913276	Pseudomonas simiae	321846	S	99	6	105	0.00012
ERR6913276	Pseudomonas wenzhouensis	2906062	S	93	9	102	0.00011
ERR6913276	Pseudomonas atacamensis	2565368	S	48	13	61	0.00007
ERR6913276	Pseudomonas extremaustralis	359110	S	45	3	48	0.00005
ERR6913276	Pseudomonas palleroniana	191390	S	32	1	33	0.00004
ERR6913276	Pseudomonas prosekii	1148509	S	30	1	31	0.00003
ERR6913276	Pseudomonas knackmussii	65741	S	28	3	31	0.00003
ERR6913276	Pseudomonas versuta	1788301	S	23	0	23	0.00003
ERR6913276	Pseudomonas kielensis	2762577	S	23	11	34	0.00004
ERR6913276	Pseudomonas yamanorum	515393	S	23	1	24	0.00003
ERR6913276	Pseudomonas taetrolens	47884	S	23	0	23	0.00003
ERR6913276	Pseudomonas phenolilytica	2746321	S	22	7	29	0.00003
ERR6913276	Pseudomonas sihuiensis	1274359	S	22	8	30	0.00003
ERR6913276	Pseudomonas qingdaonensis	2056231	S	21	7	28	0.00003
ERR6913276	Pseudomonas shahriarae	2745512	S	21	17	38	0.00004
ERR6913276	Pseudomonas rhizosphaerae	216142	S	19	0	19	0.00002
ERR6913276	Pseudomonas siliginis	2842346	S	19	5	24	0.00003
ERR6913276	Pseudomonas otitidis	319939	S	19	1	20	0.00002
ERR6913276	Pseudomonas seleniipraecipitans	640205	S	18	0	18	0.00002
ERR6913276	Pseudomonas chengduensis	489632	S	18	6	24	0.00003
ERR6913276	Pseudomonas tritici	2745518	S	17	1	18	0.00002
ERR6913276	Pseudomonas asgharzadehiana	2842349	S	17	0	17	0.00002
ERR6913276	Pseudomonas alcaliphila	101564	S	16	4	20	0.00002
ERR6913276	Pseudomonas alkylphenolica	237609	S	16	0	16	0.00002
ERR6913276	Pseudomonas lalkuanensis	2604832	S	15	0	15	0.00002
ERR6913276	Pseudomonas lactis	1615674	S	15	2	17	0.00002
ERR6913276	Pseudomonas oryzae	1392877	S	14	1	15	0.00002
ERR6913276	Pseudomonas cremoricolorata	157783	S	14	0	14	0.00002
ERR6913276	Pseudomonas sediminis	1691904	S	13	1	14	0.00002
ERR6913276	Pseudomonas promysalinigenes	485898	S	13	0	13	0.00001
ERR6913276	Pseudomonas umsongensis	198618	S	13	0	13	0.00001
ERR6913276	Pseudomonas tructae	2518644	S	13	0	13	0.00001
ERR6913276	Pseudomonas thivervalensis	86265	S	12	0	12	0.00001
ERR6913276	Pseudomonas silesiensis	1853130	S	12	0	12	0.00001
ERR6913276	Pseudomonas campi	2731681	S	12	0	12	0.00001
ERR6913276	Pseudomonas saudiphocaensis	1499686	S	11	0	11	0.00001
ERR6913276	Pseudomonas juntendi	2666183	S	11	11	22	0.00002
ERR6913276	Pseudomonas muyukensis	2842357	S	11	0	11	0.00001
ERR6913276	Pseudomonas xanthosomae	2842356	S	11	0	11	0.00001
ERR6913276	Pseudomonas entomophila	312306	S	10	0	10	0.00001
ERR6913276	Pseudomonas eucalypticola	2599595	S	10	0	10	0.00001
ERR6913276	Pseudomonas brassicacearum	930166	S	10	4	14	0.00002
ERR6913276	Pseudomonas hydrolytica	2493633	S	10	3	13	0.00001
ERR6913276	Pseudomonas laurylsulfatiphila	2011015	S	10	0	10	0.00001
ERR6913276	Pseudomonas phytophila	2867264	S	9	0	9	0.00001
ERR6913276	Pseudomonas graminis	158627	S	9	0	9	0.00001
ERR6913276	Pseudomonas salmasensis	2745514	S	9	1	10	0.00001
ERR6913276	Pseudomonas frederiksbergensis	104087	S	9	0	9	0.00001
ERR6913276	Pseudomonas zeae	2745510	S	8	1	9	0.00001
ERR6913276	Pseudomonas parafulva	157782	S	8	0	8	0.00001
ERR6913276	Pseudomonas pohangensis	364197	S	8	0	8	0.00001
ERR6913276	Pseudomonas cavernae	2320867	S	8	0	8	0.00001
ERR6913276	Pseudomonas marincola	437900	S	8	0	8	0.00001
ERR6913276	Pseudomonas guangdongensis	1245526	S	8	0	8	0.00001
ERR6913276	Pseudomonas monsensis	2745509	S	7	1	8	0.00001
ERR6913276	Pseudomonas tensinigenes	2745511	S	6	0	6	0.00001
ERR6913276	Pseudomonas antarctica	219572	S	6	0	6	0.00001
ERR6913276	Pseudomonas iranensis	2745503	S	5	1	6	0.00001
ERR6913276	Pseudomonas vanderleydeniana	2745495	S	5	0	5	0.00001
ERR6913276	Pseudomonas xantholysinigenes	2745490	S	5	0	5	0.00001
ERR6913276	Pseudomonas sessilinigenes	658629	S	5	3	8	0.00001
ERR6913276	Pseudomonas nanhaiensis	2830842	S	5	0	5	0.00001
ERR6913276	Pseudomonas argentinensis	289370	S	5	0	5	0.00001
ERR6913276	Stutzerimonas stutzeri	316	S	346	109	455	0.00050
ERR6913276	Stutzerimonas kunmingensis	1211807	S	28	26	54	0.00006
ERR6913276	Stutzerimonas chloritidismutans	203192	S	20	21	41	0.00005
ERR6913276	Stutzerimonas balearica	74829	S	26	4	30	0.00003
ERR6913276	Stutzerimonas frequens	2968969	S	19	15	34	0.00004
ERR6913276	Stutzerimonas degradans	2968968	S	8	3	11	0.00001
ERR6913276	[Pseudomonas] zhaodongensis	1176257	S	9	2	11	0.00001
ERR6913276	Stutzerimonas xanthomarina	271420	S	6	0	6	0.00001
ERR6913276	Halopseudomonas sp. RR6	2918528	S	10	13	23	0.00003
ERR6913276	Halopseudomonas sabulinigri	472181	S	8	4	12	0.00001
ERR6913276	Halopseudomonas xinjiangensis	487184	S	5	0	5	0.00001
ERR6913276	Halopseudomonas salegens	1434072	S	5	0	5	0.00001
ERR6913276	Permianibacter aggregans	1510150	S	45	0	45	0.00005
ERR6913276	Azotobacter salinestris	69964	S	13	5	18	0.00002
ERR6913276	Azotobacter chroococcum	353	S	8	3	11	0.00001
ERR6913276	Denitrificimonas caeni	521720	S	6	0	6	0.00001
ERR6913276	Thiopseudomonas alkaliphila	1697053	S	5	0	5	0.00001
ERR6913276	Marinobacter sp. AN1	2886046	S	20	2	22	0.00002
ERR6913276	Marinobacter sp. CA1	2817656	S	9	0	9	0.00001
ERR6913276	Marinobacter sp. LQ44	1749259	S	7	10	17	0.00002
ERR6913276	Marinobacter sp. Arc7-DN-1	2304594	S	7	0	7	0.00001
ERR6913276	Marinobacter sp. JH2	2547598	S	5	0	5	0.00001
ERR6913276	Marinobacter sp. LPB0319	2769486	S	5	0	5	0.00001
ERR6913276	Marinobacter nauticus	2743	S	11	1	12	0.00001
ERR6913276	Marinobacter salarius	1420917	S	8	0	8	0.00001
ERR6913276	Xanthomonas campestris	339	S	3581	420	4001	0.00440
ERR6913276	Xanthomonas arboricola	56448	S	64	31	95	0.00010
ERR6913276	Xanthomonas citri	346	S	50	95	145	0.00016
ERR6913276	Xanthomonas sp. AM6	2982531	S	26	8	34	0.00004
ERR6913276	Xanthomonas sp. CFBP 8443	2971235	S	9	2	11	0.00001
ERR6913276	Xanthomonas sp. CFBP 8445	2971236	S	5	0	5	0.00001
ERR6913276	Xanthomonas hortorum	56454	S	35	10	45	0.00005
ERR6913276	Xanthomonas translucens	343	S	31	35	66	0.00007
ERR6913276	Xanthomonas sacchari	56458	S	20	2	22	0.00002
ERR6913276	Xanthomonas euroxanthea	2259622	S	19	13	32	0.00004
ERR6913276	Xanthomonas theicola	56464	S	12	1	13	0.00001
ERR6913276	Xanthomonas fragariae	48664	S	10	0	10	0.00001
ERR6913276	Xanthomonas cucurbitae	56453	S	9	0	9	0.00001
ERR6913276	Xanthomonas hyacinthi	56455	S	9	1	10	0.00001
ERR6913276	Xanthomonas vesicatoria	56460	S	9	1	10	0.00001
ERR6913276	Xanthomonas cassavae	56450	S	7	0	7	0.00001
ERR6913276	Xanthomonas phaseoli	1985254	S	6	46	52	0.00006
ERR6913276	Xanthomonas oryzae	347	S	6	0	6	0.00001
ERR6913276	Luteimonas sp. YGD11-2	2508168	S	2025	170	2195	0.00241
ERR6913276	Luteimonas sp. MC1750	2799326	S	113	8	121	0.00013
ERR6913276	Luteimonas sp. JM171	1896164	S	42	1	43	0.00005
ERR6913276	Luteimonas sp. S4-F44	2925842	S	24	1	25	0.00003
ERR6913276	Luteimonas sp. MC1825	2761107	S	17	2	19	0.00002
ERR6913276	Luteimonas sp. MC1572	2799325	S	15	1	16	0.00002
ERR6913276	Luteimonas yindakuii	2565782	S	90	7	97	0.00011
ERR6913276	Luteimonas granuli	1176533	S	41	2	43	0.00005
ERR6913276	Luteimonas chenhongjianii	2006110	S	26	1	27	0.00003
ERR6913276	Luteimonas fraxinea	2901869	S	9	0	9	0.00001
ERR6913276	Stenotrophomonas maltophilia	40324	S	580	284	864	0.00095
ERR6913276	Stenotrophomonas sp. SAU14A_NAIMI4_5	2072413	S	62	20	82	0.00009
ERR6913276	Stenotrophomonas sp. ZAC14A_NAIMI4_1	2072412	S	8	13	21	0.00002
ERR6913276	Stenotrophomonas sp. ZAC14D2_NAIMI4_6	2072406	S	6	7	13	0.00001
ERR6913276	Stenotrophomonas sp. YAU14D1_LEIMI4_1	2072407	S	5	5	10	0.00001
ERR6913276	Stenotrophomonas sp. LM091	1904944	S	536	52	588	0.00065
ERR6913276	Stenotrophomonas sp. CW117	2775920	S	29	106	135	0.00015
ERR6913276	Stenotrophomonas sp. 169	2770322	S	29	1	30	0.00003
ERR6913276	Stenotrophomonas sp. 364	2691571	S	26	3	29	0.00003
ERR6913276	Stenotrophomonas sp. MYb57	1827305	S	9	13	22	0.00002
ERR6913276	Stenotrophomonas sp. DFS-20110405	2871169	S	7	7	14	0.00002
ERR6913276	Stenotrophomonas sp. NA06056	2742129	S	5	0	5	0.00001
ERR6913276	Stenotrophomonas rhizophila	216778	S	284	23	307	0.00034
ERR6913276	Stenotrophomonas acidaminiphila	128780	S	41	19	60	0.00007
ERR6913276	Lysobacter sp. 5GHs7-4	2904253	S	21	1	22	0.00002
ERR6913276	Lysobacter sp. H23M47	2781024	S	14	32	46	0.00005
ERR6913276	Lysobacter sp. CW239	2762611	S	13	1	14	0.00002
ERR6913276	Lysobacter sp. TY2-98	2290922	S	9	0	9	0.00001
ERR6913276	Lysobacter sp. CJ11	2764185	S	7	0	7	0.00001
ERR6913276	Lysobacter sp. H21R4	2781021	S	7	7	14	0.00002
ERR6913276	Lysobacter sp. K5869	2820808	S	6	1	7	0.00001
ERR6913276	Lysobacter sp. KIS68-7	2904252	S	5	0	5	0.00001
ERR6913276	Lysobacter capsici	435897	S	37	15	52	0.00006
ERR6913276	Lysobacter oculi	2698682	S	32	1	33	0.00004
ERR6913276	Lysobacter terrestris	2865112	S	26	2	28	0.00003
ERR6913276	Lysobacter soli	453783	S	25	1	26	0.00003
ERR6913276	Lysobacter arenosi	2795387	S	23	3	26	0.00003
ERR6913276	Lysobacter alkalisoli	2591633	S	21	1	22	0.00002
ERR6913276	Lysobacter enzymogenes	69	S	20	3	23	0.00003
ERR6913276	Lysobacter solisilvae	2763317	S	18	0	18	0.00002
ERR6913276	Lysobacter antibioticus	84531	S	16	1	17	0.00002
ERR6913276	Lysobacter lycopersici	1324796	S	15	0	15	0.00002
ERR6913276	Lysobacter maris	1605891	S	13	0	13	0.00001
ERR6913276	Lysobacter luteus	2822368	S	6	0	6	0.00001
ERR6913276	Pseudoxanthomonas suwonensis	314722	S	50	4	54	0.00006
ERR6913276	Pseudoxanthomonas mexicana	128785	S	46	25	71	0.00008
ERR6913276	Pseudoxanthomonas sp. X-1	2571115	S	18	3	21	0.00002
ERR6913276	Pseudoxanthomonas sp. SL93	2995142	S	6	0	6	0.00001
ERR6913276	Pseudoxanthomonas daejeonensis	266062	S	12	0	12	0.00001
ERR6913276	Pseudoxanthomonas spadix	415229	S	12	0	12	0.00001
ERR6913276	Thermomonas sp. HDW16	2714945	S	20	2	22	0.00002
ERR6913276	Thermomonas sp. XSG	2771436	S	17	2	19	0.00002
ERR6913276	Thermomonas paludicola	2884874	S	22	2	24	0.00003
ERR6913276	Thermomonas brevis	215691	S	16	2	18	0.00002
ERR6913276	Thermomonas carbonis	1463158	S	14	1	15	0.00002
ERR6913276	Thermomonas aquatica	2202149	S	11	1	12	0.00001
ERR6913276	Pseudolysobacter antarcticus	2511995	S	11	0	11	0.00001
ERR6913276	Dyella terrae	522259	S	12	0	12	0.00001
ERR6913276	Dyella thiooxydans	445710	S	11	2	13	0.00001
ERR6913276	Dyella caseinilytica	1849581	S	7	0	7	0.00001
ERR6913276	Dyella sp. M7H15-1	2501295	S	7	0	7	0.00001
ERR6913276	Dyella telluris	2763498	S	5	0	5	0.00001
ERR6913276	Luteibacter sp. 335	2911538	S	12	2	14	0.00002
ERR6913276	Luteibacter sp. 353	2911539	S	5	0	5	0.00001
ERR6913276	Luteibacter rhizovicinus	242606	S	7	1	8	0.00001
ERR6913276	Rhodanobacter glycinis	582702	S	8	1	9	0.00001
ERR6913276	Rhodanobacter denitrificans	666685	S	8	3	11	0.00001
ERR6913276	Rhodanobacter sp. FDAARGOS 1247	2778082	S	7	1	8	0.00001
ERR6913276	Rhodanobacter thiooxydans	416169	S	6	3	9	0.00001
ERR6913276	Frateuria soli	1542730	S	9	1	10	0.00001
ERR6913276	Frateuria edaphi	2898793	S	8	1	9	0.00001
ERR6913276	Frateuria aurantia	81475	S	6	0	6	0.00001
ERR6913276	Aerosticca soli	2010829	S	14	3	17	0.00002
ERR6913276	Dokdonella koreensis	323415	S	9	0	9	0.00001
ERR6913276	Ahniella affigens	2021234	S	5	0	5	0.00001
ERR6913276	Klebsiella grimontii	2058152	S	196	569	765	0.00084
ERR6913276	Klebsiella michiganensis	1134687	S	95	326	421	0.00046
ERR6913276	Klebsiella pneumoniae	573	S	93	1094	1187	0.00131
ERR6913276	Klebsiella quasipneumoniae	1463165	S	72	91	163	0.00018
ERR6913276	Klebsiella oxytoca	571	S	31	6	37	0.00004
ERR6913276	Klebsiella aerogenes	548	S	16	2	18	0.00002
ERR6913276	Klebsiella variicola	244366	S	10	20	30	0.00003
ERR6913276	Klebsiella sp. WP3-W18-ESBL-02	2675710	S	6	16	22	0.00002
ERR6913276	Raoultella planticola	575	S	8	1	9	0.00001
ERR6913276	Raoultella terrigena	577	S	6	0	6	0.00001
ERR6913276	Raoultella ornithinolytica	54291	S	5	15	20	0.00002
ERR6913276	Enterobacter asburiae	61645	S	74	153	227	0.00025
ERR6913276	Enterobacter cloacae	550	S	36	33	69	0.00008
ERR6913276	Enterobacter roggenkampii	1812935	S	31	68	99	0.00011
ERR6913276	Enterobacter hormaechei	158836	S	27	154	181	0.00020
ERR6913276	Enterobacter kobei	208224	S	11	44	55	0.00006
ERR6913276	Enterobacter cancerogenus	69218	S	10	1	11	0.00001
ERR6913276	Enterobacter ludwigii	299767	S	10	16	26	0.00003
ERR6913276	Enterobacter chengduensis	2494701	S	7	3	10	0.00001
ERR6913276	Enterobacter sp. RHBSTW-00994	2742676	S	7	5	12	0.00001
ERR6913276	Enterobacter mori	539813	S	8	4	12	0.00001
ERR6913276	Enterobacter soli	885040	S	6	1	7	0.00001
ERR6913276	Citrobacter freundii	546	S	28	69	97	0.00011
ERR6913276	Citrobacter portucalensis	1639133	S	21	134	155	0.00017
ERR6913276	Citrobacter pasteurii	1563222	S	6	5	11	0.00001
ERR6913276	Citrobacter amalonaticus	35703	S	5	19	24	0.00003
ERR6913276	Escherichia coli	562	S	170	531	701	0.00077
ERR6913276	Escherichia albertii	208962	S	8	0	8	0.00001
ERR6913276	Escherichia sp. E4742	2044467	S	7	0	7	0.00001
ERR6913276	Escherichia marmotae	1499973	S	6	0	6	0.00001
ERR6913276	Kosakonia cowanii	208223	S	85	19	104	0.00011
ERR6913276	Kosakonia sp. CCTCC M2018092	2492396	S	38	13	51	0.00006
ERR6913276	Kosakonia sp. SMBL-WEM22	2725560	S	21	3	24	0.00003
ERR6913276	Kosakonia sp. ML.JS2a	2980557	S	9	0	9	0.00001
ERR6913276	Kosakonia arachidis	551989	S	5	0	5	0.00001
ERR6913276	Leclercia adecarboxylata	83655	S	60	21	81	0.00009
ERR6913276	Leclercia pneumoniae	2815358	S	46	2	48	0.00005
ERR6913276	Candidatus Mikella endobia	1778264	S	20	0	20	0.00002
ERR6913276	Blochmannia endosymbiont of Colobopsis nipponica	2681987	S	5	0	5	0.00001
ERR6913276	Candidatus Hamiltonella defensa	138072	S	8	0	8	0.00001
ERR6913276	Candidatus Tachikawaea gelatinosa	1410383	S	5	0	5	0.00001
ERR6913276	Pseudescherichia vulneris	566	S	57	1	58	0.00006
ERR6913276	Lelliottia amnigena	61646	S	54	3	57	0.00006
ERR6913276	Salmonella enterica	28901	S	43	1225	1268	0.00139
ERR6913276	Pluralibacter gergoviae	61647	S	39	2	41	0.00005
ERR6913276	Cedecea neteri	158822	S	22	0	22	0.00002
ERR6913276	Cedecea lapagei	158823	S	8	0	8	0.00001
ERR6913276	Cronobacter sakazakii	28141	S	10	6	16	0.00002
ERR6913276	Cronobacter dublinensis	413497	S	10	1	11	0.00001
ERR6913276	Atlantibacter hermannii	565	S	20	0	20	0.00002
ERR6913276	Plesiomonas shigelloides	703	S	14	0	14	0.00002
ERR6913276	Phytobacter ursingii	1972431	S	8	4	12	0.00001
ERR6913276	Candidatus Schneideria nysicola	1081631	S	7	0	7	0.00001
ERR6913276	Shimwellia blattae	563	S	7	0	7	0.00001
ERR6913276	Siccibacter colletis	1505757	S	6	0	6	0.00001
ERR6913276	Pantoea agglomerans	549	S	565	51	616	0.00068
ERR6913276	Pantoea sp. SO10	2575375	S	21	2	23	0.00003
ERR6913276	Pantoea sp. Z09	2886821	S	20	2	22	0.00002
ERR6913276	Pantoea sp. CCBC3-3-1	2490851	S	11	0	11	0.00001
ERR6913276	Pantoea sp. SOD02	2970818	S	11	1	12	0.00001
ERR6913276	Pantoea sp. MT58	2768165	S	7	19	26	0.00003
ERR6913276	Pantoea dispersa	59814	S	45	2	47	0.00005
ERR6913276	Pantoea eucrina	472693	S	45	2	47	0.00005
ERR6913276	Pantoea vagans	470934	S	27	12	39	0.00004
ERR6913276	Pantoea anthophila	470931	S	24	1	25	0.00003
ERR6913276	Pantoea deleyi	470932	S	13	0	13	0.00001
ERR6913276	Pantoea rwandensis	1076550	S	12	0	12	0.00001
ERR6913276	Pantoea ananatis	553	S	9	0	9	0.00001
ERR6913276	Pantoea eucalypti	470933	S	8	17	25	0.00003
ERR6913276	Candidatus Pantoea carbekii	1235990	S	8	0	8	0.00001
ERR6913276	Pantoea alhagi	1891675	S	7	0	7	0.00001
ERR6913276	Duffyella gerundensis	1619313	S	360	13	373	0.00041
ERR6913276	Candidatus Erwinia haradaeae	1922217	S	41	0	41	0.00005
ERR6913276	Erwinia persicina	55211	S	27	6	33	0.00004
ERR6913276	Erwinia rhapontici	55212	S	12	3	15	0.00002
ERR6913276	Erwinia sp. E602	2675378	S	6	0	6	0.00001
ERR6913276	Erwinia tracheiphila	65700	S	9	0	9	0.00001
ERR6913276	Erwinia amylovora	552	S	8	4	12	0.00001
ERR6913276	Erwinia tasmaniensis	338565	S	7	1	8	0.00001
ERR6913276	Buchnera aphidicola	9	S	90	-1	89	0.00010
ERR6913276	Mixta calida	665913	S	63	5	68	0.00007
ERR6913276	Mixta sp. X22927	2872648	S	6	0	6	0.00001
ERR6913276	Mixta gaviniae	665914	S	5	0	5	0.00001
ERR6913276	Kalamiella piersonii	2364647	S	35	3	38	0.00004
ERR6913276	Tatumella ptyseos	82987	S	20	0	20	0.00002
ERR6913276	Wigglesworthia glossinidia	51229	S	8	0	8	0.00001
ERR6913276	Serratia marcescens	615	S	43	48	91	0.00010
ERR6913276	Serratia liquefaciens	614	S	26	23	49	0.00005
ERR6913276	Serratia plymuthica	82996	S	19	7	26	0.00003
ERR6913276	Serratia odorifera	618	S	11	0	11	0.00001
ERR6913276	Serratia proteamaculans	28151	S	6	2	8	0.00001
ERR6913276	Serratia fonticola	47917	S	5	3	8	0.00001
ERR6913276	Yersinia intermedia	631	S	10	40	50	0.00005
ERR6913276	Yersinia ruckeri	29486	S	10	0	10	0.00001
ERR6913276	Yersinia enterocolitica	630	S	9	2	11	0.00001
ERR6913276	Yersinia mollaretii	33060	S	7	1	8	0.00001
ERR6913276	Rahnella inusitata	58169	S	23	2	25	0.00003
ERR6913276	Rahnella aquatilis	34038	S	12	25	37	0.00004
ERR6913276	Ewingella americana	41202	S	28	1	29	0.00003
ERR6913276	Rouxiella badensis	1646377	S	20	1	21	0.00002
ERR6913276	Nissabacter sp. SGAir0207	2126321	S	8	0	8	0.00001
ERR6913276	Chania multitudinisentens	1639108	S	5	0	5	0.00001
ERR6913276	Providencia heimbachae	333962	S	12	0	12	0.00001
ERR6913276	Providencia sneebia	516075	S	9	0	9	0.00001
ERR6913276	Providencia rettgeri	587	S	7	7	14	0.00002
ERR6913276	Providencia alcalifaciens	126385	S	6	0	6	0.00001
ERR6913276	Providencia sp. R33	2828763	S	6	0	6	0.00001
ERR6913276	Morganella morganii	582	S	31	3	34	0.00004
ERR6913276	Proteus mirabilis	584	S	10	3	13	0.00001
ERR6913276	Proteus hauseri	183417	S	6	2	8	0.00001
ERR6913276	Xenorhabdus doucetiae	351671	S	9	0	9	0.00001
ERR6913276	Xenorhabdus bovienii	40576	S	8	1	9	0.00001
ERR6913276	Pectobacterium parmentieri	1905730	S	11	1	12	0.00001
ERR6913276	Pectobacterium carotovorum	554	S	9	12	21	0.00002
ERR6913276	Pectobacterium aroidearum	1201031	S	6	9	15	0.00002
ERR6913276	Dickeya zeae	204042	S	10	13	23	0.00003
ERR6913276	Dickeya dadantii	204038	S	8	1	9	0.00001
ERR6913276	Brenneria goodwinii	1109412	S	6	0	6	0.00001
ERR6913276	Brenneria rubrifaciens	55213	S	5	0	5	0.00001
ERR6913276	Sodalis ligni	2697027	S	15	0	15	0.00002
ERR6913276	Sodalis glossinidius	63612	S	5	0	5	0.00001
ERR6913276	Haemophilus parainfluenzae	729	S	2875	132	3007	0.00331
ERR6913276	Haemophilus haemolyticus	726	S	202	23	225	0.00025
ERR6913276	Haemophilus influenzae	727	S	121	91	212	0.00023
ERR6913276	Haemophilus parahaemolyticus	735	S	107	3	110	0.00012
ERR6913276	Haemophilus sp. oral taxon 036	712310	S	50	7	57	0.00006
ERR6913276	[Haemophilus] ducreyi	730	S	41	1	42	0.00005
ERR6913276	Haemophilus pittmaniae	249188	S	12	0	12	0.00001
ERR6913276	Aggregatibacter sp. 2125159857	2820817	S	260	23	283	0.00031
ERR6913276	Aggregatibacter sp. Marseille-P9115	2866570	S	107	20	127	0.00014
ERR6913276	Aggregatibacter sp. oral taxon 513	712150	S	86	18	104	0.00011
ERR6913276	Aggregatibacter aphrophilus	732	S	205	16	221	0.00024
ERR6913276	Aggregatibacter segnis	739	S	112	26	138	0.00015
ERR6913276	Aggregatibacter actinomycetemcomitans	714	S	6	0	6	0.00001
ERR6913276	Pasteurella multocida	747	S	160	150	310	0.00034
ERR6913276	Pasteurella canis	753	S	9	0	9	0.00001
ERR6913276	Mannheimia granulomatis	85402	S	9	1	10	0.00001
ERR6913276	Mannheimia varigena	85404	S	6	3	9	0.00001
ERR6913276	Actinobacillus pleuropneumoniae	715	S	5	2	7	0.00001
ERR6913276	Actinobacillus porcitonsillarum	189834	S	5	0	5	0.00001
ERR6913276	Rodentibacter heylii	1906744	S	8	0	8	0.00001
ERR6913276	Rodentibacter haemolyticus	2778911	S	7	0	7	0.00001
ERR6913276	Avibacterium sp. 20-132	2911526	S	5	2	7	0.00001
ERR6913276	Otariodibacter oris	1032623	S	7	0	7	0.00001
ERR6913276	Frederiksenia canicola	123824	S	7	0	7	0.00001
ERR6913276	Shewanella sp. WE21	2029986	S	259	47	306	0.00034
ERR6913276	Shewanella sp. Pdp11	2059264	S	10	8	18	0.00002
ERR6913276	Shewanella sp. DAU305	2991940	S	6	11	17	0.00002
ERR6913276	Shewanella baltica	62322	S	194	99	293	0.00032
ERR6913276	Shewanella putrefaciens	24	S	37	26	63	0.00007
ERR6913276	Shewanella oneidensis	70863	S	11	0	11	0.00001
ERR6913276	Shewanella xiamenensis	332186	S	10	9	19	0.00002
ERR6913276	Shewanella algae	38313	S	9	1	10	0.00001
ERR6913276	Shewanella decolorationis	256839	S	8	2	10	0.00001
ERR6913276	Shewanella marisflavi	260364	S	7	0	7	0.00001
ERR6913276	Shewanella denitrificans	192073	S	6	0	6	0.00001
ERR6913276	Shewanella glacialimarina	2590884	S	5	0	5	0.00001
ERR6913276	Shewanella khirikhana	1965282	S	5	0	5	0.00001
ERR6913276	Shewanella cyperi	2814292	S	5	0	5	0.00001
ERR6913276	Pseudoalteromonas sp. R3	1709477	S	8	0	8	0.00001
ERR6913276	Pseudoalteromonas sp. SCSIO 43101	2822847	S	7	5	12	0.00001
ERR6913276	Pseudoalteromonas sp. LC2018020214	2799564	S	5	10	15	0.00002
ERR6913276	Pseudoalteromonas sp. GCY	2003316	S	5	3	8	0.00001
ERR6913276	Pseudoalteromonas arctica	394751	S	23	7	30	0.00003
ERR6913276	Pseudoalteromonas prydzensis	182141	S	15	1	16	0.00002
ERR6913276	Pseudoalteromonas distincta	77608	S	14	18	32	0.00004
ERR6913276	Pseudoalteromonas agarivorans	176102	S	13	17	30	0.00003
ERR6913276	Pseudoalteromonas translucida	166935	S	13	14	27	0.00003
ERR6913276	Pseudoalteromonas rubra	43658	S	12	0	12	0.00001
ERR6913276	Pseudoalteromonas carrageenovora	227	S	11	2	13	0.00001
ERR6913276	Pseudoalteromonas aliena	247523	S	9	1	10	0.00001
ERR6913276	Pseudoalteromonas luteoviolacea	43657	S	8	0	8	0.00001
ERR6913276	Pseudoalteromonas arabiensis	874454	S	7	14	21	0.00002
ERR6913276	Pseudoalteromonas nigrifaciens	28109	S	7	11	18	0.00002
ERR6913276	Pseudoalteromonas piratica	1348114	S	6	0	6	0.00001
ERR6913276	Pseudoalteromonas spongiae	298657	S	6	0	6	0.00001
ERR6913276	Pseudoalteromonas tunicata	314281	S	5	0	5	0.00001
ERR6913276	Alteromonas mediterranea	314275	S	14	9	23	0.00003
ERR6913276	Alteromonas pelagimontana	1858656	S	8	0	8	0.00001
ERR6913276	Alteromonas macleodii	28108	S	6	5	11	0.00001
ERR6913276	Salinimonas marina	2785918	S	7	0	7	0.00001
ERR6913276	Paraglaciecola sp. L3A3	2686358	S	6	2	8	0.00001
ERR6913276	Lacimicrobium alkaliphilum	1526571	S	6	0	6	0.00001
ERR6913276	Paraneptunicella aestuarii	2831148	S	5	0	5	0.00001
ERR6913276	Colwellia sp. 20A7	2689569	S	7	8	15	0.00002
ERR6913276	Colwellia sp. MT41	58049	S	6	5	11	0.00001
ERR6913276	Thalassotalea sp. PS06	2594005	S	6	2	8	0.00001
ERR6913276	Thalassotalea sp. LPB0316	2769490	S	6	4	10	0.00001
ERR6913276	Ferrimonas sp. SCSIO 43195	2822844	S	10	0	10	0.00001
ERR6913276	Idiomarina loihiensis	135577	S	7	0	7	0.00001
ERR6913276	Psychromonas sp. CNPT3	314282	S	5	1	6	0.00001
ERR6913276	Halomonas sp. JS92-SW72	2306583	S	561	114	675	0.00074
ERR6913276	Halomonas sp. GFAJ-1	1118153	S	22	1	23	0.00003
ERR6913276	Halomonas sp. M4R1S46	2982692	S	17	2	19	0.00002
ERR6913276	Halomonas sp. LR3S48	2982694	S	11	1	12	0.00001
ERR6913276	Halomonas sp. GD1P12	2982691	S	9	0	9	0.00001
ERR6913276	Halomonas sp. THAF12	2587849	S	7	1	8	0.00001
ERR6913276	Halomonas sp. DN3	2953657	S	7	0	7	0.00001
ERR6913276	Halomonas sp. HG01	1609967	S	5	0	5	0.00001
ERR6913276	Halomonas sp. 3H	2952527	S	5	0	5	0.00001
ERR6913276	Halomonas sp. 1513	1883416	S	5	0	5	0.00001
ERR6913276	Halomonas meridiana	29570	S	24	8	32	0.00004
ERR6913276	Halomonas elongata	2746	S	13	0	13	0.00001
ERR6913276	Halomonas sulfidivorans	2733488	S	6	1	7	0.00001
ERR6913276	Halomonas huangheensis	1178482	S	6	0	6	0.00001
ERR6913276	Halomonas chromatireducens	507626	S	5	0	5	0.00001
ERR6913276	Chromohalobacter salexigens	158080	S	36	1	37	0.00004
ERR6913276	Candidatus Carsonella ruddii	114186	S	22	1	23	0.00003
ERR6913276	Cobetia sp. AM6	2661553	S	7	8	15	0.00002
ERR6913276	Kushneria marisflavi	157779	S	5	3	8	0.00001
ERR6913276	Pistricoccus aurantiacus	1883414	S	6	0	6	0.00001
ERR6913276	Bacterioplanes sanyensis	1249553	S	41	1	42	0.00005
ERR6913276	Marinomonas primoryensis	178399	S	10	3	13	0.00001
ERR6913276	Marinobacterium georgiense	48076	S	16	0	16	0.00002
ERR6913276	Marinobacterium aestuarii	1821621	S	5	0	5	0.00001
ERR6913276	Thalassolituus oleivorans	187493	S	8	3	11	0.00001
ERR6913276	Nitrincola iocasae	2614693	S	12	0	12	0.00001
ERR6913276	Venatorbacter cucullus	2661630	S	5	0	5	0.00001
ERR6913276	Alcanivorax sp. N3-2A	2014542	S	47	21	68	0.00007
ERR6913276	Alcanivorax sp. ALC70	2259335	S	13	4	17	0.00002
ERR6913276	Gynuella sunshinyii	1445505	S	8	0	8	0.00001
ERR6913276	Endozoicomonas sp. SCSIO W0465	2918516	S	5	4	9	0.00001
ERR6913276	Litorivicinus lipolyticus	418701	S	7	0	7	0.00001
ERR6913276	Aeromonas sp. CU5	2033033	S	59	13	72	0.00008
ERR6913276	Aeromonas sp. ASNIH3	1636608	S	7	97	104	0.00011
ERR6913276	Aeromonas caviae	648	S	57	200	257	0.00028
ERR6913276	Aeromonas veronii	654	S	39	43	82	0.00009
ERR6913276	Aeromonas salmonicida	645	S	36	36	72	0.00008
ERR6913276	Aeromonas media	651	S	33	13	46	0.00005
ERR6913276	Aeromonas hydrophila	644	S	17	24	41	0.00005
ERR6913276	Aeromonas rivuli	648794	S	7	0	7	0.00001
ERR6913276	Aeromonas enteropelogenes	29489	S	6	3	9	0.00001
ERR6913276	Aeromonas sanarellii	633415	S	6	10	16	0.00002
ERR6913276	Aeromonas encheleia	73010	S	5	0	5	0.00001
ERR6913276	Aeromonas dhakensis	196024	S	5	7	12	0.00001
ERR6913276	Aeromonas schubertii	652	S	5	0	5	0.00001
ERR6913276	Oceanisphaera avium	1903694	S	5	4	9	0.00001
ERR6913276	Tolumonas auensis	43948	S	10	0	10	0.00001
ERR6913276	Oceanimonas sp. GK1	511062	S	7	2	9	0.00001
ERR6913276	Rheinheimera sp. MM224	3019969	S	62	14	76	0.00008
ERR6913276	Rheinheimera sp. D18	2545632	S	29	1	30	0.00003
ERR6913276	Rheinheimera sp. F8	1763998	S	11	1	12	0.00001
ERR6913276	Rheinheimera mangrovi	2498451	S	64	9	73	0.00008
ERR6913276	Marichromatium purpuratum	37487	S	18	4	22	0.00002
ERR6913276	Thiocapsa bogorovii	521689	S	14	1	15	0.00002
ERR6913276	Candidatus Thiodictyon syntrophicum	1166950	S	14	0	14	0.00002
ERR6913276	Candidatus Nitrosacidococcus tergens	553981	S	9	3	12	0.00001
ERR6913276	Thiocystis violascens	73141	S	11	1	12	0.00001
ERR6913276	Thermochromatium tepidum	1050	S	7	5	12	0.00001
ERR6913276	Thioflavicoccus mobilis	80679	S	7	0	7	0.00001
ERR6913276	Caldichromatium japonicum	2699430	S	6	0	6	0.00001
ERR6913276	Acidihalobacter ferrooxydans	1765967	S	41	4	45	0.00005
ERR6913276	Acidihalobacter aeolianus	2792603	S	10	2	12	0.00001
ERR6913276	Acidihalobacter yilgarnensis	2819280	S	7	0	7	0.00001
ERR6913276	Thioalkalivibrio sulfidiphilus	1033854	S	9	1	10	0.00001
ERR6913276	Thioalkalivibrio paradoxus	108010	S	6	4	10	0.00001
ERR6913276	Thioalkalivibrio sp. K90mix	396595	S	6	0	6	0.00001
ERR6913276	Spiribacter sp. E85	2182432	S	6	2	8	0.00001
ERR6913276	Alkalilimnicola ehrlichii	351052	S	13	0	13	0.00001
ERR6913276	Guyparkeria halophila	47960	S	35	5	40	0.00004
ERR6913276	Halothiobacillus neapolitanus	927	S	19	0	19	0.00002
ERR6913276	Granulosicoccus antarcticus	437505	S	16	0	16	0.00002
ERR6913276	Sulfuriflexus mobilis	1811807	S	6	0	6	0.00001
ERR6913276	Wenzhouxiangella marina	1579979	S	11	0	11	0.00001
ERR6913276	Wenzhouxiangella sp. AB-CW3	2771012	S	6	0	6	0.00001
ERR6913276	Sulfurivermis fontis	1972068	S	13	2	15	0.00002
ERR6913276	Woeseia oceani	1548547	S	8	0	8	0.00001
ERR6913276	Vibrio parahaemolyticus	670	S	14	3	17	0.00002
ERR6913276	Vibrio campbellii	680	S	7	7	14	0.00002
ERR6913276	Vibrio harveyi	669	S	5	7	12	0.00001
ERR6913276	Vibrio natriegens	691	S	5	3	8	0.00001
ERR6913276	Vibrio azureus	512649	S	5	0	5	0.00001
ERR6913276	Vibrio sp. SCSIO 43135	2819096	S	12	0	12	0.00001
ERR6913276	Vibrio cholerae	666	S	18	10	28	0.00003
ERR6913276	Vibrio coralliilyticus	190893	S	17	7	24	0.00003
ERR6913276	Vibrio spartinae	1918945	S	14	1	15	0.00002
ERR6913276	Vibrio rumoiensis	76258	S	13	1	14	0.00002
ERR6913276	Vibrio celticus	446372	S	11	6	17	0.00002
ERR6913276	Vibrio sinaloensis	379097	S	6	1	7	0.00001
ERR6913276	Vibrio porteresiae	435912	S	6	0	6	0.00001
ERR6913276	Vibrio furnissii	29494	S	6	1	7	0.00001
ERR6913276	Vibrio mimicus	674	S	5	0	5	0.00001
ERR6913276	Vibrio casei	673372	S	5	0	5	0.00001
ERR6913276	Photobacterium damselae	38293	S	10	6	16	0.00002
ERR6913276	Photobacterium toruni	1935446	S	6	0	6	0.00001
ERR6913276	Photobacterium atrarenae	865757	S	5	2	7	0.00001
ERR6913276	Salinivibrio kushneri	1908198	S	14	3	17	0.00002
ERR6913276	Cardiobacterium hominis	2718	S	205	9	214	0.00024
ERR6913276	Cardiobacterium sp. Marseille-Q4385	2866573	S	80	3	83	0.00009
ERR6913276	Dichelobacter nodosus	870	S	10	0	10	0.00001
ERR6913276	Thiomicrospira cyclica	147268	S	24	11	35	0.00004
ERR6913276	Thiomicrospira microaerophila	406020	S	7	7	14	0.00002
ERR6913276	Methylophaga frappieri	754477	S	7	3	10	0.00001
ERR6913276	Methylophaga pinxianii	2881052	S	6	23	29	0.00003
ERR6913276	Thiosulfatimonas sediminis	2675054	S	21	19	40	0.00004
ERR6913276	Piscirickettsia salmonis	1238	S	13	0	13	0.00001
ERR6913276	Hydrogenovibrio marinus	28885	S	8	5	13	0.00001
ERR6913276	Thiothrix litoralis	2891210	S	11	4	15	0.00002
ERR6913276	Thiothrix unzii	111769	S	6	21	27	0.00003
ERR6913276	Thiothrix subterranea	2735563	S	6	11	17	0.00002
ERR6913276	Beggiatoa leptomitoformis	288004	S	30	0	30	0.00003
ERR6913276	Cellvibrio sp. KY-GH-1	2303332	S	16	6	22	0.00002
ERR6913276	Cellvibrio sp. QJXJ	2964606	S	16	33	49	0.00005
ERR6913276	Cellvibrio sp. PSBB023	1945512	S	9	2	11	0.00001
ERR6913276	Cellvibrio sp. PSBB006	1987723	S	5	1	6	0.00001
ERR6913276	Agarilytica rhodophyticola	1737490	S	22	1	23	0.00003
ERR6913276	Teredinibacter haidensis	2731755	S	8	3	11	0.00001
ERR6913276	Teredinibacter purpureus	2731756	S	7	0	7	0.00001
ERR6913276	Simiduia agarivorans	447471	S	7	1	8	0.00001
ERR6913276	Simiduia sp. 21SJ11W-1	2909669	S	6	1	7	0.00001
ERR6913276	Saccharophagus degradans	86304	S	8	1	9	0.00001
ERR6913276	Marinagarivorans cellulosilyticus	2721545	S	5	2	7	0.00001
ERR6913276	Microbulbifer celer	435905	S	15	5	20	0.00002
ERR6913276	Microbulbifer aggregans	1769779	S	11	2	13	0.00001
ERR6913276	Microbulbifer sp. A4B17	359370	S	5	1	6	0.00001
ERR6913276	Microbulbifer thermotolerans	252514	S	5	0	5	0.00001
ERR6913276	Halioglobus japonicus	930805	S	8	2	10	0.00001
ERR6913276	Congregibacter litoralis	393662	S	9	3	12	0.00001
ERR6913276	Kineobactrum salinum	2708301	S	7	0	7	0.00001
ERR6913276	Spongiibacter sp. IMCC21906	1620392	S	5	6	11	0.00001
ERR6913276	Oceanicoccus sagamiensis	716816	S	6	0	6	0.00001
ERR6913276	Methylomonas methanica	421	S	8	7	15	0.00002
ERR6913276	Methylomonas rhizoryzae	2608981	S	7	5	12	0.00001
ERR6913276	Methylobacter sp. S3L5C	2839024	S	27	2	29	0.00003
ERR6913276	Methylobacter sp. YRD-M1	2911520	S	6	0	6	0.00001
ERR6913276	Methylococcus sp. Mc7	2860258	S	10	3	13	0.00001
ERR6913276	Methylococcus sp. EFPC2	2812648	S	8	0	8	0.00001
ERR6913276	Methylovulum psychrotolerans	1704499	S	23	0	23	0.00003
ERR6913276	Methylocaldum marinum	1432792	S	22	1	23	0.00003
ERR6913276	Methylogaea oryzae	1295382	S	16	1	17	0.00002
ERR6913276	Methylomicrobium album	39775	S	6	0	6	0.00001
ERR6913276	Methylomicrobium sp. wino1	2049332	S	5	21	26	0.00003
ERR6913276	Candidatus Methylospira mobilis	1808979	S	8	0	8	0.00001
ERR6913276	Methylomagnum ishizawai	1760988	S	7	0	7	0.00001
ERR6913276	Legionella sp. MW5194	2662448	S	11	6	17	0.00002
ERR6913276	Legionella lytica	96232	S	13	0	13	0.00001
ERR6913276	Legionella pneumophila	446	S	12	36	48	0.00005
ERR6913276	Legionella adelaidensis	45056	S	12	0	12	0.00001
ERR6913276	Legionella fallonii	96230	S	11	1	12	0.00001
ERR6913276	Legionella antarctica	2708020	S	9	0	9	0.00001
ERR6913276	Legionella clemsonensis	1867846	S	9	1	10	0.00001
ERR6913276	Legionella sainthelensi	28087	S	7	4	11	0.00001
ERR6913276	Legionella jordanis	456	S	7	1	8	0.00001
ERR6913276	Legionella lansingensis	45067	S	6	0	6	0.00001
ERR6913276	Coxiella endosymbiont of Amblyomma nuttalli	2749996	S	6	1	7	0.00001
ERR6913276	Candidatus Coxiella mudrowiae	2054173	S	5	0	5	0.00001
ERR6913276	Aquicella siphonis	254247	S	9	5	14	0.00002
ERR6913276	Candidatus Rickettsiella viridis	676208	S	5	1	6	0.00001
ERR6913276	Candidatus Endoriftia persephone	393765	S	44	0	44	0.00005
ERR6913276	Bathymodiolus septemdierum thioautotrophic gill symbiont	113267	S	5	0	5	0.00001
ERR6913276	Candidatus Baumannia cicadellinicola	186490	S	11	0	11	0.00001
ERR6913276	Candidatus Nardonella dryophthoridicola	1971485	S	9	0	9	0.00001
ERR6913276	Celerinatantimonas diazotrophica	412034	S	9	0	9	0.00001
ERR6913276	Candidatus Thioglobus sp. NP1	2508687	S	6	0	6	0.00001
ERR6913276	Sedimenticola thiotaurini	1543721	S	5	0	5	0.00001
ERR6913276	Solimonas sp. K1W22B-7	2303331	S	34	1	35	0.00004
ERR6913276	Flagellatimonas centrodinii	2806210	S	19	0	19	0.00002
ERR6913276	Sinimarinibacterium sp. NLF-5-8	2698684	S	11	0	11	0.00001
ERR6913276	Steroidobacter denitrificans	465721	S	11	0	11	0.00001
ERR6913276	Acidiferrobacter sp. SPIII_3	1281578	S	5	2	7	0.00001
ERR6913276	Sulfurifustis variabilis	1675686	S	7	0	7	0.00001
ERR6913276	Sulfuricaulis limicola	1620215	S	7	0	7	0.00001
ERR6913276	Gilliamella sp. B3022	2817969	S	5	1	6	0.00001
ERR6913276	Immundisolibacter cernigliae	1810504	S	17	0	17	0.00002
ERR6913276	Candidatus Comchoanobacter bicostacola	2919598	S	14	0	14	0.00002
ERR6913276	Kangiella koreensis	261964	S	6	1	7	0.00001
ERR6913276	Isorropodon fossajaponicum symbiont	883811	S	6	0	6	0.00001
ERR6913276	Mesorhizobium terrae	2725666	S	3419	2104	5523	0.00607
ERR6913276	Mesorhizobium sp. L-2-11	2744521	S	22	54	76	0.00008
ERR6913276	Mesorhizobium sp. Pch-S	2082387	S	20	5	25	0.00003
ERR6913276	Mesorhizobium sp. B2-8-5	2589903	S	17	15	32	0.00004
ERR6913276	Mesorhizobium sp. M4B.F.Ca.ET.058.02.1.1	2493675	S	17	26	43	0.00005
ERR6913276	Mesorhizobium sp. M3A.F.Ca.ET.080.04.2.1	2493676	S	16	18	34	0.00004
ERR6913276	Mesorhizobium sp. 8	2584466	S	14	6	20	0.00002
ERR6913276	Mesorhizobium sp. DCY119	2108445	S	14	7	21	0.00002
ERR6913276	Mesorhizobium sp. M1E.F.Ca.ET.045.02.1.1	2493672	S	14	20	34	0.00004
ERR6913276	Mesorhizobium sp. AR07	2865838	S	13	28	41	0.00005
ERR6913276	Mesorhizobium sp. NBSH29	2654249	S	12	3	15	0.00002
ERR6913276	Mesorhizobium sp. B1-1-8	2589976	S	12	9	21	0.00002
ERR6913276	Mesorhizobium sp. 131-3-5	2744520	S	12	456	468	0.00051
ERR6913276	Mesorhizobium sp. 113-3-9	2744517	S	11	60	71	0.00008
ERR6913276	Mesorhizobium sp. 113-3-3	2744516	S	10	37	47	0.00005
ERR6913276	Mesorhizobium sp. 113-1-2	2744515	S	10	43	53	0.00006
ERR6913276	Mesorhizobium sp. M9A.F.Ca.ET.002.03.1.2	2493668	S	9	20	29	0.00003
ERR6913276	Mesorhizobium sp. J8	2777475	S	9	7	16	0.00002
ERR6913276	Mesorhizobium sp. B2-1-8	2589967	S	9	14	23	0.00003
ERR6913276	Mesorhizobium sp. AR02	2865837	S	8	26	34	0.00004
ERR6913276	Mesorhizobium sp. PAMC28654	2880934	S	8	6	14	0.00002
ERR6913276	Mesorhizobium sp. M1A.F.Ca.IN.022.06.1.1	2493680	S	8	10	18	0.00002
ERR6913276	Mesorhizobium sp. M6A.T.Cr.TU.016.01.1.1	2493677	S	8	19	27	0.00003
ERR6913276	Mesorhizobium sp. M2A.F.Ca.ET.046.03.2.1	2493674	S	8	35	43	0.00005
ERR6913276	Mesorhizobium sp. B4-1-4	2589888	S	7	9	16	0.00002
ERR6913276	Mesorhizobium sp. L-8-10	2744523	S	7	28	35	0.00004
ERR6913276	Mesorhizobium sp. NZP2298	2483403	S	7	32	39	0.00004
ERR6913276	Mesorhizobium sp. B2-1-1	2589974	S	6	6	12	0.00001
ERR6913276	Mesorhizobium sp. INR15	2654248	S	6	3	9	0.00001
ERR6913276	Mesorhizobium sp. AR10	2865839	S	6	8	14	0.00002
ERR6913276	Mesorhizobium sp. 131-2-1	2744518	S	6	10	16	0.00002
ERR6913276	Mesorhizobium sp. 131-2-5	2744519	S	6	312	318	0.00035
ERR6913276	Mesorhizobium sp. M8A.F.Ca.ET.057.01.1.1	2493679	S	5	12	17	0.00002
ERR6913276	Mesorhizobium sp. M7D.F.Ca.US.005.01.1.1	2493678	S	5	13	18	0.00002
ERR6913276	Mesorhizobium sp. NZP2077	2483404	S	5	12	17	0.00002
ERR6913276	Mesorhizobium huakuii	28104	S	11	120	131	0.00014
ERR6913276	Mesorhizobium erdmanii	1777866	S	11	35	46	0.00005
ERR6913276	Mesorhizobium opportunistum	593909	S	9	34	43	0.00005
ERR6913276	Mesorhizobium japonicum	2066070	S	9	71	80	0.00009
ERR6913276	Mesorhizobium onobrychidis	2775404	S	6	20	26	0.00003
ERR6913276	Aminobacter sp. MSH1	374606	S	15	17	32	0.00004
ERR6913276	Aminobacter sp. SR38	2774562	S	11	35	46	0.00005
ERR6913276	Aminobacter sp. NyZ550	2979870	S	9	47	56	0.00006
ERR6913276	Aminobacter aminovorans	83263	S	5	17	22	0.00002
ERR6913276	Phyllobacterium sp. T1293	555317	S	10	3	13	0.00001
ERR6913276	Phyllobacterium sp. T1018	555316	S	9	2	11	0.00001
ERR6913276	Phyllobacterium sp. 628	2718938	S	5	1	6	0.00001
ERR6913276	Phyllobacterium zundukense	1867719	S	15	4	19	0.00002
ERR6913276	Aquibium oceanicum	1670800	S	27	12	39	0.00004
ERR6913276	Aquibium microcysteis	675281	S	14	7	21	0.00002
ERR6913276	Nitratireductor sp. SY7	2599600	S	16	7	23	0.00003
ERR6913276	Nitratireductor sp. OM-1	1756988	S	12	8	20	0.00002
ERR6913276	Salaquimonas pukyongi	2712698	S	20	1	21	0.00002
ERR6913276	Hoeflea sp. IMCC20628	1620421	S	9	1	10	0.00001
ERR6913276	Hoeflea phototrophica	244596	S	8	1	9	0.00001
ERR6913276	Oricola thermophila	2742145	S	10	2	12	0.00001
ERR6913276	Rhizobium sp. ACO-34A	1571470	S	46	5	51	0.00006
ERR6913276	Rhizobium sp. WL3	2603277	S	42	5	47	0.00005
ERR6913276	Rhizobium sp. X9	2815360	S	40	35	75	0.00008
ERR6913276	Rhizobium sp. TH2	2775403	S	36	2	38	0.00004
ERR6913276	Rhizobium sp. SL42	2806346	S	35	3	38	0.00004
ERR6913276	Rhizobium sp. BG4	2613770	S	29	3	32	0.00004
ERR6913276	Rhizobium sp. 11515TR	2028343	S	24	7	31	0.00003
ERR6913276	Rhizobium sp. CIAT894	2020312	S	23	7	30	0.00003
ERR6913276	Rhizobium sp. ZX09	2291939	S	17	26	43	0.00005
ERR6913276	Rhizobium sp. WYJ-E13	2849093	S	16	1	17	0.00002
ERR6913276	Rhizobium sp. SSM4.3	2919917	S	15	1	16	0.00002
ERR6913276	Rhizobium sp. AB2/73	2795216	S	13	5	18	0.00002
ERR6913276	Rhizobium sp. Pop5	1223565	S	13	3	16	0.00002
ERR6913276	Rhizobium sp. C104	2917727	S	9	4	13	0.00001
ERR6913276	Rhizobium sp. K102	2918527	S	9	4	13	0.00001
ERR6913276	Rhizobium sp. NIBRBAC000502774	2590777	S	7	5	12	0.00001
ERR6913276	Rhizobium sp. TRM96650	2979863	S	7	1	8	0.00001
ERR6913276	Rhizobium sp. Kim5	2020311	S	6	9	15	0.00002
ERR6913276	Rhizobium sp. 007	2785056	S	6	3	9	0.00001
ERR6913276	Rhizobium sp. L51/94	2819999	S	6	12	18	0.00002
ERR6913276	Rhizobium sp. S41	1869170	S	5	383	388	0.00043
ERR6913276	Rhizobium sp. B230/85	2819994	S	5	62	67	0.00007
ERR6913276	Rhizobium pusense	648995	S	410	539	949	0.00104
ERR6913276	Rhizobium leguminosarum	384	S	161	79	240	0.00026
ERR6913276	Rhizobium oryzihabitans	2267833	S	59	40	99	0.00011
ERR6913276	Rhizobium rosettiformans	1368430	S	43	8	51	0.00006
ERR6913276	Rhizobium pseudoryzae	379684	S	34	3	37	0.00004
ERR6913276	Rhizobium tropici	398	S	33	9	42	0.00005
ERR6913276	Rhizobium rhizoryzae	451876	S	33	1	34	0.00004
ERR6913276	Rhizobium gallicum	56730	S	21	6	27	0.00003
ERR6913276	Rhizobium etli	29449	S	18	7	25	0.00003
ERR6913276	Rhizobium bangladeshense	1138189	S	18	2	20	0.00002
ERR6913276	Rhizobium phaseoli	396	S	17	11	28	0.00003
ERR6913276	Rhizobium jaguaris	1312183	S	15	1	16	0.00002
ERR6913276	Rhizobium daejeonense	240521	S	15	2	17	0.00002
ERR6913276	Rhizobium lentis	1138194	S	11	1	12	0.00001
ERR6913276	Rhizobium indicum	2583231	S	11	4	15	0.00002
ERR6913276	Rhizobium sullae	50338	S	9	0	9	0.00001
ERR6913276	Rhizobium anhuiense	1184720	S	8	1	9	0.00001
ERR6913276	Rhizobium freirei	1353277	S	5	3	8	0.00001
ERR6913276	Agrobacterium tumefaciens	358	S	254	94	348	0.00038
ERR6913276	Agrobacterium fabrum	1176649	S	26	24	50	0.00005
ERR6913276	Agrobacterium fabacearum	1183401	S	25	79	104	0.00011
ERR6913276	Agrobacterium larrymoorei	160699	S	80	5	85	0.00009
ERR6913276	Agrobacterium vitis	373	S	63	14	77	0.00008
ERR6913276	Agrobacterium sp. MA01	2664893	S	14	11	25	0.00003
ERR6913276	Agrobacterium sp. T29	2580515	S	7	3	10	0.00001
ERR6913276	Agrobacterium sp. CGMCC 11546	2579248	S	6	7	13	0.00001
ERR6913276	Agrobacterium sp. RAC06	1842536	S	5	4	9	0.00001
ERR6913276	Agrobacterium vaccinii	2735528	S	38	2	40	0.00004
ERR6913276	Agrobacterium rubi	28099	S	32	3	35	0.00004
ERR6913276	Agrobacterium salinitolerans	1183413	S	17	3	20	0.00002
ERR6913276	Agrobacterium rhizogenes	359	S	8	9	17	0.00002
ERR6913276	Neorhizobium sp. SOG26	2060726	S	94	9	103	0.00011
ERR6913276	Neorhizobium sp. NCHU2750	1825976	S	73	7	80	0.00009
ERR6913276	Neorhizobium galegae	399	S	119	14	133	0.00015
ERR6913276	Pararhizobium sp. YC-54	2986920	S	153	42	195	0.00021
ERR6913276	Pararhizobium sp. BT-229	2986923	S	92	19	111	0.00012
ERR6913276	Pseudorhizobium banfieldiae	1125847	S	36	20	56	0.00006
ERR6913276	Pseudorhizobium flavum	1335061	S	21	10	31	0.00003
ERR6913276	Shinella zoogloeoides	352475	S	182	92	274	0.00030
ERR6913276	Shinella sp. PSBB067	2715959	S	54	21	75	0.00008
ERR6913276	Shinella sp. HZN7	879274	S	50	19	69	0.00008
ERR6913276	Shinella sp. XGS7	2877941	S	21	2	23	0.00003
ERR6913276	Shinella sp. H4-D48	2925841	S	6	7	13	0.00001
ERR6913276	Shinella oryzae	2871820	S	16	3	19	0.00002
ERR6913276	Ensifer adhaerens	106592	S	58	12	70	0.00008
ERR6913276	Ensifer sp. PDNC004	2811423	S	23	8	31	0.00003
ERR6913276	Ensifer sp. T173	555315	S	7	17	24	0.00003
ERR6913276	Ensifer mexicanus	375549	S	23	2	25	0.00003
ERR6913276	Ensifer alkalisoli	1752398	S	14	2	16	0.00002
ERR6913276	Ensifer sojae	716925	S	12	4	16	0.00002
ERR6913276	Sinorhizobium meliloti	382	S	45	45	90	0.00010
ERR6913276	Sinorhizobium fredii	380	S	31	24	55	0.00006
ERR6913276	Sinorhizobium sp. BG8	2613773	S	13	1	14	0.00002
ERR6913276	Sinorhizobium sp. M14	430451	S	11	8	19	0.00002
ERR6913276	Sinorhizobium medicae	110321	S	22	8	30	0.00003
ERR6913276	Sinorhizobium americanum	194963	S	20	7	27	0.00003
ERR6913276	Candidatus Liberibacter americanus	309868	S	27	1	28	0.00003
ERR6913276	Candidatus Liberibacter solanacearum	556287	S	8	0	8	0.00001
ERR6913276	Georhizobium profundi	2341112	S	14	1	15	0.00002
ERR6913276	Peteryoungia desertarenae	1813451	S	13	1	14	0.00002
ERR6913276	Bradyrhizobium sp. SK17	2057741	S	1544	391	1935	0.00213
ERR6913276	Bradyrhizobium sp. BTAi1	288000	S	55	8	63	0.00007
ERR6913276	Bradyrhizobium sp. I71	2590772	S	54	39	93	0.00010
ERR6913276	Bradyrhizobium sp. CCBAU 51753	1325100	S	35	6	41	0.00005
ERR6913276	Bradyrhizobium sp. 200	2782665	S	32	6	38	0.00004
ERR6913276	Bradyrhizobium sp. CB1024	2976823	S	29	10	39	0.00004
ERR6913276	Bradyrhizobium sp. A19	2898149	S	27	3	30	0.00003
ERR6913276	Bradyrhizobium sp. 170	2782641	S	24	5	29	0.00003
ERR6913276	Bradyrhizobium sp. CCBAU 051011	858422	S	23	4	27	0.00003
ERR6913276	Bradyrhizobium sp. WD16	1521768	S	22	2	24	0.00003
ERR6913276	Bradyrhizobium sp. CCBAU 53421	1325120	S	22	6	28	0.00003
ERR6913276	Bradyrhizobium sp. 1(2017)	1404888	S	21	6	27	0.00003
ERR6913276	Bradyrhizobium sp. 195	2782662	S	20	6	26	0.00003
ERR6913276	Bradyrhizobium sp. 41S5	1404443	S	20	11	31	0.00003
ERR6913276	Bradyrhizobium sp. CCBAU 51765	1325102	S	19	14	33	0.00004
ERR6913276	Bradyrhizobium sp. CCBAU 53351	1325114	S	19	10	29	0.00003
ERR6913276	Bradyrhizobium sp. 191	2782659	S	17	13	30	0.00003
ERR6913276	Bradyrhizobium sp. CCGE-LA001	1223566	S	16	5	21	0.00002
ERR6913276	Bradyrhizobium sp. 186	2782654	S	14	3	17	0.00002
ERR6913276	Bradyrhizobium sp. ORS 278	114615	S	14	2	16	0.00002
ERR6913276	Bradyrhizobium sp. CB1015	2976822	S	13	5	18	0.00002
ERR6913276	Bradyrhizobium sp. ORS 285	115808	S	13	2	15	0.00002
ERR6913276	Bradyrhizobium sp. 14AB	2736875	S	11	3	14	0.00002
ERR6913276	Bradyrhizobium sp. 4	2782678	S	11	19	30	0.00003
ERR6913276	Bradyrhizobium sp. 6(2017)	1197460	S	11	4	15	0.00002
ERR6913276	Bradyrhizobium sp. LCT2	2493093	S	9	16	25	0.00003
ERR6913276	Bradyrhizobium sp. CCBAU 53340	1325112	S	9	3	12	0.00001
ERR6913276	Bradyrhizobium sp. CB3035	2976824	S	7	2	9	0.00001
ERR6913276	Bradyrhizobium sp. C-145	574727	S	7	5	12	0.00001
ERR6913276	Bradyrhizobium sp. 192	2782660	S	5	8	13	0.00001
ERR6913276	Bradyrhizobium diazoefficiens	1355477	S	66	65	131	0.00014
ERR6913276	Bradyrhizobium erythrophlei	1437360	S	62	4	66	0.00007
ERR6913276	Bradyrhizobium lablabi	722472	S	36	25	61	0.00007
ERR6913276	Bradyrhizobium betae	244734	S	35	44	79	0.00009
ERR6913276	Bradyrhizobium japonicum	375	S	33	32	65	0.00007
ERR6913276	Bradyrhizobium genosp. L	83637	S	31	5	36	0.00004
ERR6913276	Bradyrhizobium arachidis	858423	S	29	25	54	0.00006
ERR6913276	Bradyrhizobium icense	1274631	S	25	3	28	0.00003
ERR6913276	Bradyrhizobium sediminis	2840469	S	22	3	25	0.00003
ERR6913276	Bradyrhizobium canariense	255045	S	21	19	40	0.00004
ERR6913276	Bradyrhizobium oligotrophicum	44255	S	20	2	22	0.00002
ERR6913276	Bradyrhizobium daqingense	993502	S	17	8	25	0.00003
ERR6913276	Bradyrhizobium vignae	1549949	S	16	3	19	0.00002
ERR6913276	Bradyrhizobium genosp. B	83627	S	16	3	19	0.00002
ERR6913276	Bradyrhizobium guangzhouense	1325095	S	16	6	22	0.00002
ERR6913276	Bradyrhizobium paxllaeri	190148	S	15	2	17	0.00002
ERR6913276	Bradyrhizobium amphicarpaeae	1404768	S	15	6	21	0.00002
ERR6913276	Bradyrhizobium quebecense	2748629	S	14	7	21	0.00002
ERR6913276	Bradyrhizobium septentrionale	1404411	S	13	6	19	0.00002
ERR6913276	Bradyrhizobium guangxiense	1325115	S	11	5	16	0.00002
ERR6913276	Bradyrhizobium symbiodeficiens	1404367	S	11	13	24	0.00003
ERR6913276	Bradyrhizobium cosmicum	1404864	S	11	3	14	0.00002
ERR6913276	Bradyrhizobium guangdongense	1325090	S	8	3	11	0.00001
ERR6913276	Bradyrhizobium zhanjiangense	1325107	S	7	5	12	0.00001
ERR6913276	Bradyrhizobium ottawaense	931866	S	6	19	25	0.00003
ERR6913276	Bradyrhizobium elkanii	29448	S	5	9	14	0.00002
ERR6913276	Rhodopseudomonas palustris	1076	S	83	14	97	0.00011
ERR6913276	Rhodopseudomonas sp. SK50-23	340268	S	28	7	35	0.00004
ERR6913276	Rhodopseudomonas sp. P2A-2r	2991972	S	23	5	28	0.00003
ERR6913276	Rhodopseudomonas boonkerdii	475937	S	20	4	24	0.00003
ERR6913276	Afipia sp. NBIMC_P1-C1	1320552	S	30	20	50	0.00005
ERR6913276	Afipia sp. GAS231	1882747	S	13	6	19	0.00002
ERR6913276	Afipia carboxidovorans	40137	S	13	-13	0	0.00000
ERR6913276	Nitrobacter hamburgensis	912	S	24	2	26	0.00003
ERR6913276	Nitrobacter winogradskyi	913	S	11	1	12	0.00001
ERR6913276	Tardiphaga robiniae	943830	S	5	14	19	0.00002
ERR6913276	Variibacter gotjawalensis	1333996	S	21	1	22	0.00002
ERR6913276	Methylorubrum extorquens	408	S	571	597	1168	0.00128
ERR6913276	Methylorubrum populi	223967	S	157	52	209	0.00023
ERR6913276	Methylorubrum sp. B1-46	2897334	S	56	16	72	0.00008
ERR6913276	Methylorubrum zatmanii	29429	S	9	46	55	0.00006
ERR6913276	Methylobacterium sp. FF17	2984843	S	246	26	272	0.00030
ERR6913276	Methylobacterium sp. 4-46	426117	S	33	4	37	0.00004
ERR6913276	Methylobacterium sp. WL1	2603276	S	32	5	37	0.00004
ERR6913276	Methylobacterium sp. 17Sr1-1	2202826	S	18	7	25	0.00003
ERR6913276	Methylobacterium sp. NMS14P	2894310	S	17	11	28	0.00003
ERR6913276	Methylobacterium sp.	409	S	12	0	12	0.00001
ERR6913276	Methylobacterium sp. XJLW	739141	S	6	49	55	0.00006
ERR6913276	Methylobacterium brachiatum	269660	S	252	72	324	0.00036
ERR6913276	Methylobacterium aquaticum	270351	S	67	24	91	0.00010
ERR6913276	Methylobacterium organophilum	410	S	64	19	83	0.00009
ERR6913276	Methylobacterium tardum	374432	S	36	9	45	0.00005
ERR6913276	Methylobacterium durans	2202825	S	34	3	37	0.00004
ERR6913276	Methylobacterium radiodurans	2202828	S	33	5	38	0.00004
ERR6913276	Methylobacterium currus	2051553	S	28	9	37	0.00004
ERR6913276	Methylobacterium nodulans	114616	S	24	2	26	0.00003
ERR6913276	Methylobacterium indicum	1775910	S	20	7	27	0.00003
ERR6913276	Methylobacterium phyllosphaerae	418223	S	18	53	71	0.00008
ERR6913276	Methylobacterium mesophilicum	39956	S	17	3	20	0.00002
ERR6913276	Methylobacterium radiotolerans	31998	S	13	27	40	0.00004
ERR6913276	Methylobacterium terrae	2202827	S	13	5	18	0.00002
ERR6913276	Methylobacterium oryzae	334852	S	5	22	27	0.00003
ERR6913276	Microvirga sp. VF16	2807101	S	18	3	21	0.00002
ERR6913276	Microvirga sp. 17 mud 1-3	2082949	S	15	3	18	0.00002
ERR6913276	Microvirga sp. R24	2740529	S	13	4	17	0.00002
ERR6913276	Microvirga ossetica	1882682	S	26	3	29	0.00003
ERR6913276	Microvirga thermotolerans	2651334	S	14	2	16	0.00002
ERR6913276	Aureimonas altamirensis	370622	S	1167	140	1307	0.00144
ERR6913276	Aureimonas sp. OT7	2816454	S	261	64	325	0.00036
ERR6913276	Aureimonas sp. SA4125	2826993	S	24	3	27	0.00003
ERR6913276	Aureimonas sp. AU20	1349819	S	21	3	24	0.00003
ERR6913276	Aureimonas populi	1701758	S	30	3	33	0.00004
ERR6913276	Martelella sp. AD-3	686597	S	9	21	30	0.00003
ERR6913276	Martelella mediterranea	293089	S	7	2	9	0.00001
ERR6913276	Martelella endophytica	1486262	S	5	0	5	0.00001
ERR6913276	Jiella sp. HL-NP1	2986949	S	23	2	25	0.00003
ERR6913276	Aurantimonas sp. HBX-1	2906072	S	21	3	24	0.00003
ERR6913276	Xanthobacter dioxanivorans	2528964	S	133	44	177	0.00019
ERR6913276	Xanthobacter sp. YC-JY1	2419844	S	42	44	86	0.00009
ERR6913276	Xanthobacter autotrophicus	280	S	33	37	70	0.00008
ERR6913276	Ancylobacter sp. SL191	2995166	S	24	5	29	0.00003
ERR6913276	Ancylobacter sp. TS-1	1850374	S	18	6	24	0.00003
ERR6913276	Ancylobacter polymorphus	223390	S	12	4	16	0.00002
ERR6913276	Pseudolabrys sp. FHR47	2562284	S	20	2	22	0.00002
ERR6913276	Pseudolabrys taiwanensis	331696	S	15	1	16	0.00002
ERR6913276	Azorhizobium caulinodans	7	S	30	4	34	0.00004
ERR6913276	Starkeya sp. ORNL1	2709380	S	20	3	23	0.00003
ERR6913276	Starkeya novella	921	S	10	3	13	0.00001
ERR6913276	Aquabacter sp. L1I39	2820278	S	27	3	30	0.00003
ERR6913276	Labrys sp. KNU-23	2789216	S	15	1	16	0.00002
ERR6913276	Brucella sp. MAB-22	2986424	S	31	35	66	0.00007
ERR6913276	Brucella sp. 2716	2975052	S	13	16	29	0.00003
ERR6913276	Brucella sp. HL-2	2986924	S	9	0	9	0.00001
ERR6913276	Brucella sp. JSBI001	2886044	S	8	5	13	0.00001
ERR6913276	Brucella sp. BTU1	2840456	S	7	0	7	0.00001
ERR6913276	Brucella intermedia	94625	S	62	7	69	0.00008
ERR6913276	Brucella anthropi	529	S	47	37	84	0.00009
ERR6913276	Brucella pseudintermedia	370111	S	27	4	31	0.00003
ERR6913276	[Ochrobactrum] quorumnocens	271865	S	22	2	24	0.00003
ERR6913276	Brucella pseudogrignonensis	419475	S	15	2	17	0.00002
ERR6913276	Brucella pituitosa	571256	S	7	1	8	0.00001
ERR6913276	Brucella inopinata	1218315	S	6	4	10	0.00001
ERR6913276	Brucella melitensis	29459	S	5	342	347	0.00038
ERR6913276	Pseudochrobactrum sp. Wa41.01b-1	2864102	S	27	9	36	0.00004
ERR6913276	Pseudochrobactrum sp. XF203	2879116	S	23	6	29	0.00003
ERR6913276	Pseudochrobactrum algeriensis	2834768	S	20	4	24	0.00003
ERR6913276	Devosia sp. 1566	2499144	S	32	3	35	0.00004
ERR6913276	Devosia sp. A16	1736675	S	23	2	25	0.00003
ERR6913276	Devosia sp. MC521	2759954	S	22	1	23	0.00003
ERR6913276	Devosia sp. I507	2083786	S	13	4	17	0.00002
ERR6913276	Devosia sp. SL43	2806348	S	13	3	16	0.00002
ERR6913276	Devosia sp. JXJ CY 41	2917991	S	13	3	16	0.00002
ERR6913276	Devosia salina	2860336	S	25	10	35	0.00004
ERR6913276	Devosia neptuniae	191302	S	22	4	26	0.00003
ERR6913276	Devosia rhizoryzae	2774137	S	21	3	24	0.00003
ERR6913276	Devosia ginsengisoli	400770	S	16	5	21	0.00002
ERR6913276	Devosia beringensis	2657486	S	11	2	13	0.00001
ERR6913276	Devosia oryziradicis	2801335	S	9	3	12	0.00001
ERR6913276	Pelagibacterium halotolerans	531813	S	11	3	14	0.00002
ERR6913276	Pelagibacterium sp. YIM 151497	2984530	S	10	3	13	0.00001
ERR6913276	Youhaiella tibetensis	1447062	S	15	1	16	0.00002
ERR6913276	Maritalea myrionectae	454601	S	9	0	9	0.00001
ERR6913276	Paradevosia shaoguanensis	1335043	S	5	0	5	0.00001
ERR6913276	Hyphomicrobium sp. DMF-1	3019544	S	26	12	38	0.00004
ERR6913276	Hyphomicrobium sp. MC1	717785	S	25	9	34	0.00004
ERR6913276	Hyphomicrobium nitrativorans	1427356	S	38	23	61	0.00007
ERR6913276	Hyphomicrobium denitrificans	53399	S	27	5	32	0.00004
ERR6913276	Rhodoplanes sp. Z2-YC6860	674703	S	48	4	52	0.00006
ERR6913276	Candidatus Filomicrobium marinum	1608628	S	16	0	16	0.00002
ERR6913276	Methyloceanibacter caenitepidi	1384459	S	7	2	9	0.00001
ERR6913276	Methyloceanibacter sp. wino2	2170729	S	6	2	8	0.00001
ERR6913276	Rhodomicrobium vannielii	1069	S	7	0	7	0.00001
ERR6913276	Bosea sp. Tri-49	1867715	S	64	16	80	0.00009
ERR6913276	Bosea sp. RAC05	1842539	S	28	8	36	0.00004
ERR6913276	Bosea sp. F3-2	2599640	S	19	7	26	0.00003
ERR6913276	Bosea sp. AS-1	2015316	S	17	6	23	0.00003
ERR6913276	Bosea sp. NBC_00550	2969621	S	17	7	24	0.00003
ERR6913276	Bosea sp. NBC_00436	2969620	S	16	9	25	0.00003
ERR6913276	Bosea sp. ANAM02	2020412	S	12	6	18	0.00002
ERR6913276	Bosea sp. PAMC 26642	1792307	S	9	2	11	0.00001
ERR6913276	Bosea vaviloviae	1526658	S	13	5	18	0.00002
ERR6913276	Candidatus Hodgkinia cicadicola	573658	S	79	0	79	0.00009
ERR6913276	Nordella sp. HKS 07	2712222	S	33	1	34	0.00004
ERR6913276	Pseudorhodoplanes sinuspersici	1235591	S	20	1	21	0.00002
ERR6913276	Terrihabitans soli	708113	S	7	0	7	0.00001
ERR6913276	Pannonibacter phragmitetus	121719	S	54	15	69	0.00008
ERR6913276	Roseibium aggregatum	187304	S	16	1	17	0.00002
ERR6913276	Roseibium sp. Sym1	3016006	S	9	2	11	0.00001
ERR6913276	Roseibium alexandrii	388408	S	5	0	5	0.00001
ERR6913276	Stappia indica	538381	S	12	1	13	0.00001
ERR6913276	Stappia sp. ES.058	1881061	S	5	0	5	0.00001
ERR6913276	Labrenzia sp. THAF82	2587861	S	7	0	7	0.00001
ERR6913276	Labrenzia sp. VG12	2021862	S	5	0	5	0.00001
ERR6913276	Chenggangzhangella methanolivorans	1437009	S	57	7	64	0.00007
ERR6913276	Methylocystis sp. MJC1	2654282	S	8	5	13	0.00001
ERR6913276	Methylocystis heyeri	391905	S	10	3	13	0.00001
ERR6913276	Methylocystis parvus	134	S	7	3	10	0.00001
ERR6913276	Methylocystis bryophila	655015	S	6	1	7	0.00001
ERR6913276	Methylosinus trichosporium	426	S	10	3	13	0.00001
ERR6913276	Methylocella silvestris	199596	S	20	8	28	0.00003
ERR6913276	Methylocella tundrae	227605	S	16	6	22	0.00002
ERR6913276	Chelatococcus daeguensis	444444	S	42	19	61	0.00007
ERR6913276	Chelatococcus sp. CO-6	1702325	S	8	3	11	0.00001
ERR6913276	Phreatobacter stygius	1940610	S	22	4	26	0.00003
ERR6913276	Phreatobacter cathodiphilus	1868589	S	18	5	23	0.00003
ERR6913276	Phreatobacter sp. NMCR1094	2570229	S	16	4	20	0.00002
ERR6913276	Candidatus Phaeomarinobacter ectocarpi	1458461	S	17	0	17	0.00002
ERR6913276	Kaustia mangrovi	2593653	S	13	1	14	0.00002
ERR6913276	Parvibaculum lavamentivorans	256618	S	12	1	13	0.00001
ERR6913276	Lichenihabitans psoromatis	2528642	S	16	14	30	0.00003
ERR6913276	Bartonella vinsonii	33047	S	6	5	11	0.00001
ERR6913276	Blastochloris tepida	2233851	S	14	2	16	0.00002
ERR6913276	Blastochloris viridis	1079	S	8	1	9	0.00001
ERR6913276	Acuticoccus sp. I52.16.1	2928472	S	19	1	20	0.00002
ERR6913276	Kaistia sp. 32K	2795690	S	16	2	18	0.00002
ERR6913276	Breoghania sp. L-A4	2304600	S	15	1	16	0.00002
ERR6913276	Hartmannibacter diazotrophicus	1482074	S	7	0	7	0.00001
ERR6913276	Paracoccus yeei	147645	S	5326	2328	7654	0.00842
ERR6913276	Paracoccus sanguinis	1545044	S	1855	236	2091	0.00230
ERR6913276	Paracoccus sp. MC1862	2760307	S	392	40	432	0.00048
ERR6913276	Paracoccus sp. AK26	2589076	S	160	15	175	0.00019
ERR6913276	Paracoccus sp. Arc7-R13	2500532	S	107	65	172	0.00019
ERR6913276	Paracoccus sp. MA	2895796	S	63	16	79	0.00009
ERR6913276	Paracoccus sp. SCSIO 76264	3017783	S	46	10	56	0.00006
ERR6913276	Paracoccus sp. SCSIO 80058	3017784	S	29	5	34	0.00004
ERR6913276	Paracoccus sp. SCSIO 75233	3017782	S	24	9	33	0.00004
ERR6913276	Paracoccus sp. SCSIO 75817	3017781	S	21	8	29	0.00003
ERR6913276	Paracoccus marcusii	59779	S	359	143	502	0.00055
ERR6913276	Paracoccus mutanolyticus	1499308	S	197	229	426	0.00047
ERR6913276	Paracoccus contaminans	1945662	S	148	16	164	0.00018
ERR6913276	Paracoccus aestuarii	453842	S	111	11	122	0.00013
ERR6913276	Paracoccus everestensis	2903900	S	103	7	110	0.00012
ERR6913276	Paracoccus liaowanqingii	2560053	S	74	4	78	0.00009
ERR6913276	Paracoccus stylophorae	659350	S	64	10	74	0.00008
ERR6913276	Paracoccus alcaliphilus	34002	S	59	6	65	0.00007
ERR6913276	Paracoccus denitrificans	266	S	59	11	70	0.00008
ERR6913276	Paracoccus zhejiangensis	1077935	S	58	6	64	0.00007
ERR6913276	Paracoccus pantotrophus	82367	S	57	13	70	0.00008
ERR6913276	Paracoccus suum	2259340	S	55	4	59	0.00006
ERR6913276	Paracoccus aminovorans	34004	S	46	6	52	0.00006
ERR6913276	Paracoccus aminophilus	34003	S	41	2	43	0.00005
ERR6913276	Paracoccus methylovorus	2812658	S	34	2	36	0.00004
ERR6913276	Paracoccus kondratievae	135740	S	30	2	32	0.00004
ERR6913276	Paracoccus tegillarcae	1529068	S	26	1	27	0.00003
ERR6913276	Paracoccus fistulariae	658446	S	24	2	26	0.00003
ERR6913276	Paracoccus saliphilus	405559	S	19	0	19	0.00002
ERR6913276	Paracoccus jeotgali	2065379	S	19	1	20	0.00002
ERR6913276	Paracoccus seriniphilus	184748	S	14	0	14	0.00002
ERR6913276	Paracoccus haeundaensis	225362	S	8	0	8	0.00001
ERR6913276	Rhodobacter sp. LPB0142	1850250	S	52	12	64	0.00007
ERR6913276	Rhodobacter sp. CZR27	2033869	S	26	3	29	0.00003
ERR6913276	Rhodobacter capsulatus	1061	S	51	5	56	0.00006
ERR6913276	Cereibacter sphaeroides	1063	S	84	15	99	0.00011
ERR6913276	Cereibacter azotoformans	43057	S	13	23	36	0.00004
ERR6913276	Gemmobacter aquarius	2169400	S	65	4	69	0.00008
ERR6913276	Gemmobacter fulva	2840474	S	41	3	44	0.00005
ERR6913276	Haematobacter massiliensis	195105	S	70	11	81	0.00009
ERR6913276	Neotabrizicola shimadae	2807096	S	66	4	70	0.00008
ERR6913276	Pseudorhodobacter turbinis	2500533	S	51	1	52	0.00006
ERR6913276	Rhodovulum sp. MB263	308754	S	13	2	15	0.00002
ERR6913276	Rhodovulum sp. P5	1564506	S	11	0	11	0.00001
ERR6913276	Rhodovulum sulfidophilum	35806	S	15	9	24	0.00003
ERR6913276	Frigidibacter mobilis	1335048	S	43	7	50	0.00005
ERR6913276	Fuscovulum blasticum	1075	S	37	3	40	0.00004
ERR6913276	Polymorphum gilvum	991904	S	36	4	40	0.00004
ERR6913276	Aliiroseovarius sp. M344	2867010	S	20	0	20	0.00002
ERR6913276	Aliiroseovarius crassostreae	154981	S	14	0	14	0.00002
ERR6913276	Tabrizicola piscis	2494374	S	30	1	31	0.00003
ERR6913276	Pikeienuella piscinae	2748098	S	29	1	30	0.00003
ERR6913276	Pseudooceanicola algae	1537215	S	17	0	17	0.00002
ERR6913276	Pseudooceanicola atlanticus	1461694	S	9	0	9	0.00001
ERR6913276	Falsirhodobacter sp. PG104	2692330	S	23	1	24	0.00003
ERR6913276	Silicimonas algicola	1826607	S	19	0	19	0.00002
ERR6913276	Roseicitreum antarcticum	564137	S	19	0	19	0.00002
ERR6913276	Abyssibius alkaniclasticus	2881234	S	18	0	18	0.00002
ERR6913276	Paroceanicella profunda	2579971	S	18	2	20	0.00002
ERR6913276	Thioclava electrotropha	1549850	S	11	2	13	0.00001
ERR6913276	Pukyongiella litopenaei	2605946	S	17	2	19	0.00002
ERR6913276	Profundibacter amoris	2171755	S	16	0	16	0.00002
ERR6913276	Pelagovum pacificum	2588711	S	11	0	11	0.00001
ERR6913276	Rhodobaca barguzinensis	441209	S	11	0	11	0.00001
ERR6913276	Rhodophyticola sp. CCM32	2916397	S	10	0	10	0.00001
ERR6913276	Parasedimentitalea marina	2483033	S	10	0	10	0.00001
ERR6913276	Pacificitalea manganoxidans	1411902	S	10	1	11	0.00001
ERR6913276	Pseudopuniceibacterium antarcticum	2613965	S	9	0	9	0.00001
ERR6913276	Pontivivens ytuae	2789856	S	8	0	8	0.00001
ERR6913276	Yoonia vestfoldensis	245188	S	7	1	8	0.00001
ERR6913276	Brevirhabdus pacifica	1267768	S	6	1	7	0.00001
ERR6913276	Cognatishimia activa	1715691	S	5	0	5	0.00001
ERR6913276	Sulfitobacter sp. JL08	2070369	S	13	0	13	0.00001
ERR6913276	Sulfitobacter sp. W002	2867024	S	8	8	16	0.00002
ERR6913276	Sulfitobacter sp. S190	2867022	S	6	0	6	0.00001
ERR6913276	Sulfitobacter sp. SK012	1389005	S	5	0	5	0.00001
ERR6913276	Sulfitobacter sp. JK7-1	2829501	S	5	0	5	0.00001
ERR6913276	Sulfitobacter dubius	218673	S	32	22	54	0.00006
ERR6913276	Sulfitobacter alexandrii	1917485	S	17	7	24	0.00003
ERR6913276	Sulfitobacter faviae	1775881	S	8	2	10	0.00001
ERR6913276	Leisingera sp. BMJM1	2930199	S	10	2	12	0.00001
ERR6913276	Leisingera sp. S132	2867016	S	9	1	10	0.00001
ERR6913276	Leisingera sp. NJS201	2508306	S	6	7	13	0.00001
ERR6913276	Leisingera sp. M523	2867013	S	5	7	12	0.00001
ERR6913276	Leisingera aquaemixtae	1396826	S	17	5	22	0.00002
ERR6913276	Leisingera caerulea	506591	S	12	3	15	0.00002
ERR6913276	Leisingera methylohalidivorans	133924	S	6	1	7	0.00001
ERR6913276	Roseovarius sp. TM1035	391613	S	7	6	13	0.00001
ERR6913276	Roseovarius sp. THAF9	2587847	S	5	8	13	0.00001
ERR6913276	Roseovarius faecimaris	2494550	S	19	1	20	0.00002
ERR6913276	Roseovarius tolerans	74031	S	15	1	16	0.00002
ERR6913276	Roseovarius indicus	540747	S	11	3	14	0.00002
ERR6913276	Ruegeria sp. B32	2867020	S	19	2	21	0.00002
ERR6913276	Ruegeria sp. TM1040	292414	S	9	1	10	0.00001
ERR6913276	Ruegeria sp. THAF33	2587853	S	5	2	7	0.00001
ERR6913276	Ruegeria pomeroyi	89184	S	5	0	5	0.00001
ERR6913276	Pseudosulfitobacter pseudonitzschiae	1402135	S	33	12	45	0.00005
ERR6913276	Pseudosulfitobacter sp. DSM 107133	2883100	S	5	2	7	0.00001
ERR6913276	Ketogulonicigenium vulgare	92945	S	21	10	31	0.00003
ERR6913276	Ketogulonicigenium robustum	92947	S	6	3	9	0.00001
ERR6913276	Jannaschia sp. W003	2867012	S	17	1	18	0.00002
ERR6913276	Jannaschia sp. M317	2867011	S	15	0	15	0.00002
ERR6913276	Salipiger profundus	1229727	S	12	3	15	0.00002
ERR6913276	Salipiger sp. CCB-MM3	1792508	S	10	1	11	0.00001
ERR6913276	Salipiger abyssi	1250539	S	9	2	11	0.00001
ERR6913276	Phaeobacter inhibens	221822	S	16	5	21	0.00002
ERR6913276	Phaeobacter piscinae	1580596	S	5	4	9	0.00001
ERR6913276	Celeribacter indicus	1208324	S	21	6	27	0.00003
ERR6913276	Roseivivax marinus	1379903	S	10	1	11	0.00001
ERR6913276	Actibacterium sp. EMB200-NS6	1609966	S	20	8	28	0.00003
ERR6913276	Octadecabacter arcticus	53946	S	10	0	10	0.00001
ERR6913276	Maribius sp. THAF1	2587842	S	18	0	18	0.00002
ERR6913276	Yangia pacifica	311180	S	16	2	18	0.00002
ERR6913276	Thalassococcus sp. S3	2017482	S	15	0	15	0.00002
ERR6913276	Mameliella alba	561184	S	14	2	16	0.00002
ERR6913276	Sagittula sp. P11	2009329	S	14	5	19	0.00002
ERR6913276	Ponticoccus alexandrii	1943633	S	13	1	14	0.00002
ERR6913276	Roseobacter litoralis	42443	S	6	1	7	0.00001
ERR6913276	Roseibacterium elongatum	159346	S	9	0	9	0.00001
ERR6913276	Antarctobacter heliothermus	74033	S	9	0	9	0.00001
ERR6913276	Thalassobius gelatinovorus	53501	S	7	0	7	0.00001
ERR6913276	Dinoroseobacter shibae	215813	S	6	2	8	0.00001
ERR6913276	Loktanella salsilacus	195913	S	6	0	6	0.00001
ERR6913276	Sphingomonas sp. NBWT7	2596913	S	269	54	323	0.00036
ERR6913276	Sphingomonas sp. FARSPH	2219696	S	97	32	129	0.00014
ERR6913276	Sphingomonas sp. CL5.1	2653203	S	96	19	115	0.00013
ERR6913276	Sphingomonas sp. SUN019	2937788	S	72	8	80	0.00009
ERR6913276	Sphingomonas sp. R1	399176	S	67	11	78	0.00009
ERR6913276	Sphingomonas sp. HMP6	1517551	S	63	10	73	0.00008
ERR6913276	Sphingomonas sp. HMP9	1517554	S	63	22	85	0.00009
ERR6913276	Sphingomonas sp. AP4-R1	2735134	S	57	4	61	0.00007
ERR6913276	Sphingomonas sp. LK11	1390395	S	56	21	77	0.00008
ERR6913276	Sphingomonas sp. AAP5	1523415	S	54	10	64	0.00007
ERR6913276	Sphingomonas sp. NIC1	1961362	S	51	61	112	0.00012
ERR6913276	Sphingomonas sp. SUN039	2937787	S	47	2	49	0.00005
ERR6913276	Sphingomonas sp. QA11	2950605	S	46	4	50	0.00005
ERR6913276	Sphingomonas sp. NIBR 02145	3014784	S	46	7	53	0.00006
ERR6913276	Sphingomonas sp. PAMC26645	2565555	S	45	13	58	0.00006
ERR6913276	Sphingomonas sp. S2-65	2903960	S	40	5	45	0.00005
ERR6913276	Sphingomonas sp. IC081	304378	S	39	107	146	0.00016
ERR6913276	Sphingomonas sp. BT-65	2989821	S	36	7	43	0.00005
ERR6913276	Sphingomonas sp. CV7422	3018036	S	35	9	44	0.00005
ERR6913276	Sphingomonas sp. ZFBP2030	2972485	S	33	3	36	0.00004
ERR6913276	Sphingomonas sp. J315	2898433	S	32	6	38	0.00004
ERR6913276	Sphingomonas sp. MM-1	745310	S	32	22	54	0.00006
ERR6913276	Sphingomonas sp. S1-29	2991074	S	31	15	46	0.00005
ERR6913276	Sphingomonas sp. RMG20	2949093	S	30	4	34	0.00004
ERR6913276	Sphingomonas sp. PAMB00755	3012344	S	27	2	29	0.00003
ERR6913276	Sphingomonas sp. So64.6b	2997354	S	26	3	29	0.00003
ERR6913276	Sphingomonas sp. LM7	1938607	S	24	5	29	0.00003
ERR6913276	Sphingomonas sp. KRR8	2942996	S	20	1	21	0.00002
ERR6913276	Sphingomonas sp. 7/4-4	3018446	S	19	4	23	0.00003
ERR6913276	Sphingomonas sp. H160509	2955313	S	18	1	19	0.00002
ERR6913276	Sphingomonas sp. KC8	1030157	S	14	1	15	0.00002
ERR6913276	Sphingomonas sp. S6-11	2991075	S	13	2	15	0.00002
ERR6913276	Sphingomonas sp. HDW15A	2714942	S	5	0	5	0.00001
ERR6913276	Sphingomonas paucimobilis	13689	S	1513	384	1897	0.00209
ERR6913276	Sphingomonas radiodurans	2890321	S	150	10	160	0.00018
ERR6913276	Sphingomonas melonis	152682	S	149	361	510	0.00056
ERR6913276	Sphingomonas hankookensis	563996	S	148	30	178	0.00020
ERR6913276	Sphingomonas aliaeris	2759526	S	103	6	109	0.00012
ERR6913276	Sphingomonas aerolata	185951	S	101	11	112	0.00012
ERR6913276	Sphingomonas koreensis	93064	S	78	29	107	0.00012
ERR6913276	Sphingomonas sanxanigenens	397260	S	78	17	95	0.00010
ERR6913276	Sphingomonas insulae	424800	S	67	8	75	0.00008
ERR6913276	Sphingomonas hengshuiensis	1609977	S	53	4	57	0.00006
ERR6913276	Sphingomonas taxi	1549858	S	51	8	59	0.00006
ERR6913276	Sphingomonas morindae	1541170	S	46	3	49	0.00005
ERR6913276	Sphingomonas panacis	1560345	S	44	3	47	0.00005
ERR6913276	Sphingomonas profundi	2681549	S	40	3	43	0.00005
ERR6913276	Sphingomonas sanguinis	33051	S	38	11	49	0.00005
ERR6913276	Sphingomonas naphthae	1813468	S	37	6	43	0.00005
ERR6913276	Sphingomonas glaciei	2938948	S	36	2	38	0.00004
ERR6913276	Sphingomonas nostoxanthinifaciens	2872652	S	32	2	34	0.00004
ERR6913276	Sphingomonas panacisoli	1813879	S	26	2	28	0.00003
ERR6913276	Sphingomonas qomolangmaensis	2918765	S	24	10	34	0.00004
ERR6913276	Sphingomonas cannabina	2899123	S	23	3	26	0.00003
ERR6913276	Sphingomonas changnyeongensis	2698679	S	20	1	21	0.00002
ERR6913276	Sphingomonas suaedae	2599297	S	19	1	20	0.00002
ERR6913276	Sphingomonas psychrotolerans	1327635	S	19	1	20	0.00002
ERR6913276	Sphingomonas sabuli	2764186	S	19	1	20	0.00002
ERR6913276	Sphingomonas alpina	653931	S	19	1	20	0.00002
ERR6913276	Sphingomonas rhizophila	2071607	S	15	1	16	0.00002
ERR6913276	Sphingomonas sinipercae	2714944	S	13	0	13	0.00001
ERR6913276	Sphingomonas bisphenolicum	296544	S	12	6	18	0.00002
ERR6913276	Sphingomonas paeninsulae	2319844	S	10	0	10	0.00001
ERR6913276	Sphingomonas xanthus	2594473	S	9	0	9	0.00001
ERR6913276	Sphingomonas lutea	1045317	S	8	0	8	0.00001
ERR6913276	Sphingomonas daechungensis	1176646	S	8	0	8	0.00001
ERR6913276	Sphingomonas sediminicola	386874	S	7	0	7	0.00001
ERR6913276	Sphingomonas piscis	2714943	S	7	0	7	0.00001
ERR6913276	Sphingomonas ginsengisoli An et al. 2013	363835	S	7	0	7	0.00001
ERR6913276	Sphingomonas lacunae	2698828	S	6	0	6	0.00001
ERR6913276	Sphingobium sp. YG1	2082188	S	54	13	67	0.00007
ERR6913276	Sphingobium sp. AntQ-1	2930091	S	32	9	41	0.00005
ERR6913276	Sphingobium sp. SYK-6	627192	S	29	4	33	0.00004
ERR6913276	Sphingobium sp. CAP-1	2676077	S	25	8	33	0.00004
ERR6913276	Sphingobium sp. TKS	1315974	S	23	10	33	0.00004
ERR6913276	Sphingobium sp. Cam5-1	2789327	S	18	4	22	0.00002
ERR6913276	Sphingobium sp. YBL2	484429	S	16	76	92	0.00010
ERR6913276	Sphingobium sp. SCG-1	2072936	S	15	0	15	0.00002
ERR6913276	Sphingobium sp. EP60837	1855519	S	13	1	14	0.00002
ERR6913276	Sphingobium sp. MI1205	407020	S	12	7	19	0.00002
ERR6913276	Sphingobium sp. KCTC 72723	2733867	S	9	0	9	0.00001
ERR6913276	Sphingobium sp. PAMC28499	2565554	S	7	7	14	0.00002
ERR6913276	Sphingobium sp. RSMS	520734	S	7	20	27	0.00003
ERR6913276	Sphingobium sp. JS3065	2970925	S	7	2	9	0.00001
ERR6913276	Sphingobium sp. RAC03	1843368	S	5	0	5	0.00001
ERR6913276	Sphingobium sp. CFD-1	2878545	S	5	9	14	0.00002
ERR6913276	Sphingobium yanoikuyae	13690	S	156	122	278	0.00031
ERR6913276	Sphingobium amiense	135719	S	72	44	116	0.00013
ERR6913276	Sphingobium xenophagum	121428	S	43	16	59	0.00006
ERR6913276	Sphingobium cloacae	120107	S	34	24	58	0.00006
ERR6913276	Sphingobium phenoxybenzoativorans	1592790	S	30	4	34	0.00004
ERR6913276	Sphingobium baderi	1332080	S	19	31	50	0.00005
ERR6913276	Sphingobium indicum	332055	S	18	7	25	0.00003
ERR6913276	Sphingobium herbicidovorans	76947	S	10	2	12	0.00001
ERR6913276	Sphingobium fuliginis	336203	S	10	19	29	0.00003
ERR6913276	Sphingobium chlorophenolicum	46429	S	5	1	6	0.00001
ERR6913276	Sphingopyxis sp. BSN-002	2911495	S	167	23	190	0.00021
ERR6913276	Sphingopyxis sp. 113P3	292913	S	52	10	62	0.00007
ERR6913276	Sphingopyxis sp. EG6	1874061	S	51	13	64	0.00007
ERR6913276	Sphingopyxis sp. PAMC25046	2565556	S	38	10	48	0.00005
ERR6913276	Sphingopyxis sp. YF1	2482763	S	36	7	43	0.00005
ERR6913276	Sphingopyxis sp. DBS4	2968500	S	34	13	47	0.00005
ERR6913276	Sphingopyxis sp. QXT-31	1357916	S	31	6	37	0.00004
ERR6913276	Sphingopyxis sp. USTB-05	2830667	S	29	5	34	0.00004
ERR6913276	Sphingopyxis sp. FD7	1914525	S	26	7	33	0.00004
ERR6913276	Sphingopyxis sp. OPL5	2486273	S	25	3	28	0.00003
ERR6913276	Sphingopyxis sp. PET50	2976533	S	24	4	28	0.00003
ERR6913276	Sphingopyxis macrogoltabida	33050	S	75	19	94	0.00010
ERR6913276	Sphingopyxis lindanitolerans	2054227	S	29	9	38	0.00004
ERR6913276	Sphingopyxis granuli	267128	S	25	40	65	0.00007
ERR6913276	Sphingopyxis fribergensis	1515612	S	25	6	31	0.00003
ERR6913276	Sphingopyxis alaskensis	117207	S	18	3	21	0.00002
ERR6913276	Sphingopyxis terrae	33052	S	12	24	36	0.00004
ERR6913276	Novosphingobium sp. EMRT-2	2571749	S	247	59	306	0.00034
ERR6913276	Novosphingobium sp. KA1	164608	S	51	115	166	0.00018
ERR6913276	Novosphingobium sp. P6W	1609758	S	33	2	35	0.00004
ERR6913276	Novosphingobium sp. 9	2025349	S	33	3	36	0.00004
ERR6913276	Novosphingobium sp. Sx8-5	2896849	S	31	4	35	0.00004
ERR6913276	Novosphingobium sp. KACC 22771	3025670	S	20	4	24	0.00003
ERR6913276	Novosphingobium sp. THN1	1016987	S	17	4	21	0.00002
ERR6913276	Novosphingobium sp. ES2-1	2780074	S	13	4	17	0.00002
ERR6913276	Novosphingobium sp. Gsoil 351	2675225	S	12	0	12	0.00001
ERR6913276	Novosphingobium sp. PP1Y	702113	S	11	10	21	0.00002
ERR6913276	Novosphingobium aromaticivorans	48935	S	47	14	61	0.00007
ERR6913276	Novosphingobium resinovorum	158500	S	35	9	44	0.00005
ERR6913276	Novosphingobium pentaromativorans	205844	S	22	30	52	0.00006
ERR6913276	Novosphingobium humi	2282397	S	18	3	21	0.00002
ERR6913276	Novosphingobium ginsenosidimutans	1176536	S	14	1	15	0.00002
ERR6913276	Novosphingobium decolorationis	2698673	S	13	3	16	0.00002
ERR6913276	Sphingorhabdus lacus	392610	S	54	0	54	0.00006
ERR6913276	Sphingorhabdus lutea	1913578	S	19	0	19	0.00002
ERR6913276	Sphingorhabdus sp. YGSMI21	2077182	S	6	0	6	0.00001
ERR6913276	Rhizorhabdus wittichii	160791	S	25	7	32	0.00004
ERR6913276	Rhizorhabdus dicambivorans	1850238	S	18	8	26	0.00003
ERR6913276	Rhizorhabdus phycosphaerae	2711156	S	12	0	12	0.00001
ERR6913276	Blastomonas fulva	1550728	S	10	10	20	0.00002
ERR6913276	Blastomonas sp. RAC04	1842535	S	6	4	10	0.00001
ERR6913276	Sphingosinithalassobacter sp. CS137	2762748	S	14	2	16	0.00002
ERR6913276	Sphingosinithalassobacter tenebrarum	2711215	S	13	2	15	0.00002
ERR6913276	Parasphingopyxis algicola	2026624	S	17	0	17	0.00002
ERR6913276	Parasphingopyxis sp. CP4	2724527	S	7	0	7	0.00001
ERR6913276	Parasphingorhabdus litoris	394733	S	10	0	10	0.00001
ERR6913276	Parasphingorhabdus halotolerans	2725558	S	6	0	6	0.00001
ERR6913276	Allosphingosinicella indica	941907	S	17	1	18	0.00002
ERR6913276	Sphingomicrobium aestuariivivum	1582356	S	11	0	11	0.00001
ERR6913276	Novosphingopyxis iocasae	2762729	S	14	3	17	0.00002
ERR6913276	Tardibacter chloracetimidivorans	1921510	S	13	5	18	0.00002
ERR6913276	Aquisediminimonas profunda	1550733	S	12	0	12	0.00001
ERR6913276	Citromicrobium sp. JL477	1634516	S	9	2	11	0.00001
ERR6913276	Hankyongella ginsenosidimutans	1763828	S	7	0	7	0.00001
ERR6913276	Erythrobacter sp. 3-20A1M	2653850	S	11	6	17	0.00002
ERR6913276	Erythrobacter sp. HL-111	1798193	S	10	2	12	0.00001
ERR6913276	Erythrobacter sp. SDW2	2907154	S	8	1	9	0.00001
ERR6913276	Erythrobacter sp. KY5	2011159	S	7	0	7	0.00001
ERR6913276	Erythrobacter sp. BLCC-B19	3025315	S	7	1	8	0.00001
ERR6913276	Erythrobacter neustonensis	1112	S	18	2	20	0.00002
ERR6913276	Erythrobacter aurantius	2909249	S	8	0	8	0.00001
ERR6913276	Erythrobacter aureus	2182384	S	7	0	7	0.00001
ERR6913276	Erythrobacter mangrovi	2739433	S	6	1	7	0.00001
ERR6913276	Porphyrobacter sp. CACIAM 03H1	2003315	S	11	2	13	0.00001
ERR6913276	Porphyrobacter sp. HT-58-2	2023229	S	11	2	13	0.00001
ERR6913276	Porphyrobacter sp. LM 6	1896196	S	9	2	11	0.00001
ERR6913276	Porphyrobacter sp. ULC335	2854260	S	8	1	9	0.00001
ERR6913276	Qipengyuania sediminis	1532023	S	24	2	26	0.00003
ERR6913276	Qipengyuania sp. PHS-Z21	2909673	S	14	4	18	0.00002
ERR6913276	Qipengyuania flava	192812	S	14	6	20	0.00002
ERR6913276	Qipengyuania aurantiaca	2867233	S	6	3	9	0.00001
ERR6913276	Qipengyuania gelatinilytica	2867231	S	5	3	8	0.00001
ERR6913276	Croceicoccus marinus	450378	S	29	8	37	0.00004
ERR6913276	Croceicoccus sp. YJ47	2798724	S	7	1	8	0.00001
ERR6913276	Croceicoccus sp. Ery15	1703338	S	6	8	14	0.00002
ERR6913276	Croceicoccus sp. Ery5	1703340	S	5	5	10	0.00001
ERR6913276	Croceicoccus naphthovorans	1348774	S	9	5	14	0.00002
ERR6913276	Altererythrobacter sp. BO-6	2604537	S	12	1	13	0.00001
ERR6913276	Altererythrobacter sp. B11	2060312	S	10	2	12	0.00001
ERR6913276	Altererythrobacter sp. ZODW24	2185142	S	9	0	9	0.00001
ERR6913276	Altererythrobacter sp. TH136	2067415	S	6	0	6	0.00001
ERR6913276	Altererythrobacter ishigakiensis	476157	S	6	0	6	0.00001
ERR6913276	Tsuneonella mangrovi	1982042	S	17	1	18	0.00002
ERR6913276	Tsuneonella amylolytica	2338327	S	9	1	10	0.00001
ERR6913276	Tsuneonella flava	2055955	S	6	0	6	0.00001
ERR6913276	Aurantiacibacter sp. MUD11	3003265	S	13	1	14	0.00002
ERR6913276	Aurantiacibacter atlanticus	1648404	S	9	1	10	0.00001
ERR6913276	Pelagerythrobacter marensis	543877	S	14	1	15	0.00002
ERR6913276	Croceibacterium atlanticum	1267766	S	13	2	15	0.00002
ERR6913276	Sphingosinicella microcystinivorans	335406	S	23	3	26	0.00003
ERR6913276	Sphingosinicella sp. BN140058	1892855	S	13	0	13	0.00001
ERR6913276	Sphingosinicella flava	2771430	S	6	0	6	0.00001
ERR6913276	Polymorphobacter megasporae	2835787	S	9	11	20	0.00002
ERR6913276	Sandaracinobacteroides saxicola	2759707	S	15	1	16	0.00002
ERR6913276	Brevundimonas sp. PAMC22021	2861285	S	1287	88	1375	0.00151
ERR6913276	Brevundimonas sp. 'scallop'	2562582	S	404	282	686	0.00075
ERR6913276	Brevundimonas sp. GW460-12-10-14-LB2	1827469	S	400	254	654	0.00072
ERR6913276	Brevundimonas sp. SGAir0440	2579977	S	337	139	476	0.00052
ERR6913276	Brevundimonas sp. BT-123	2986928	S	337	147	484	0.00053
ERR6913276	Brevundimonas sp. CS1	2813778	S	302	123	425	0.00047
ERR6913276	Brevundimonas sp. Bb-A	2560058	S	278	262	540	0.00059
ERR6913276	Brevundimonas sp. SL130	2995143	S	135	12	147	0.00016
ERR6913276	Brevundimonas sp. M20	2591463	S	94	4	98	0.00011
ERR6913276	Brevundimonas sp. MF30-B	2561924	S	85	5	90	0.00010
ERR6913276	Brevundimonas sp. DS20	1532555	S	82	80	162	0.00018
ERR6913276	Brevundimonas sp. NIBR10	3015997	S	80	3	83	0.00009
ERR6913276	Brevundimonas sp. NIBR11	3015999	S	60	3	63	0.00007
ERR6913276	Brevundimonas sp. LM2	1938605	S	46	2	48	0.00005
ERR6913276	Brevundimonas sp. AJA228-03	2752515	S	13	1	14	0.00002
ERR6913276	Brevundimonas vesicularis	41276	S	1017	475	1492	0.00164
ERR6913276	Brevundimonas diminuta	293	S	500	228	728	0.00080
ERR6913276	Brevundimonas albigilva	1312364	S	313	45	358	0.00039
ERR6913276	Brevundimonas naejangsanensis	588932	S	249	25	274	0.00030
ERR6913276	Brevundimonas nasdae	172043	S	209	20	229	0.00025
ERR6913276	Brevundimonas mediterranea	74329	S	125	15	140	0.00015
ERR6913276	Brevundimonas pondensis	2774189	S	105	9	114	0.00013
ERR6913276	Brevundimonas goettingensis	2774190	S	82	4	86	0.00009
ERR6913276	Brevundimonas vancanneytii	1325724	S	68	58	126	0.00014
ERR6913276	Brevundimonas subvibrioides	74313	S	50	4	54	0.00006
ERR6913276	Brevundimonas vitisensis	2800818	S	46	1	47	0.00005
ERR6913276	Phenylobacterium sp. NIBR 498073	3015177	S	189	15	204	0.00022
ERR6913276	Phenylobacterium sp. LH3H17	2903901	S	96	6	102	0.00011
ERR6913276	Phenylobacterium zucineum	284016	S	140	9	149	0.00016
ERR6913276	Phenylobacterium parvum	2201350	S	14	0	14	0.00002
ERR6913276	Caulobacter sp. S6	2823693	S	60	2	62	0.00007
ERR6913276	Caulobacter sp. FWC26	69665	S	44	12	56	0.00006
ERR6913276	Caulobacter sp. NIBR1757	3016000	S	33	2	35	0.00004
ERR6913276	Caulobacter sp. NIBR2454	3015996	S	27	2	29	0.00003
ERR6913276	Caulobacter segnis	88688	S	62	12	74	0.00008
ERR6913276	Caulobacter flavus	1679497	S	42	7	49	0.00005
ERR6913276	Caulobacter rhizosphaerae	2010972	S	38	8	46	0.00005
ERR6913276	Caulobacter mirabilis	69666	S	34	2	36	0.00004
ERR6913276	Caulobacter henricii	69395	S	25	2	27	0.00003
ERR6913276	Caulobacter soli	2708539	S	19	4	23	0.00003
ERR6913276	Caulobacter vibrioides	155892	S	18	5	23	0.00003
ERR6913276	Asticcacaulis excentricus	78587	S	18	7	25	0.00003
ERR6913276	Asticcacaulis sp. SL142	2995155	S	9	0	9	0.00001
ERR6913276	Terricaulis silvestris	2686094	S	9	0	9	0.00001
ERR6913276	Roseomonas mucosa	207340	S	244	537	781	0.00086
ERR6913276	Roseomonas sp. OT10	2897332	S	57	5	62	0.00007
ERR6913276	Roseomonas sp. S08	1750527	S	33	1	34	0.00004
ERR6913276	Roseomonas sp. FDAARGOS_362	2018065	S	8	70	78	0.00009
ERR6913276	Roseomonas gilardii	257708	S	74	11	85	0.00009
ERR6913276	Roseomonas cervicalis	204525	S	32	2	34	0.00004
ERR6913276	Roseomonas haemaphysalidis	2768162	S	31	1	32	0.00004
ERR6913276	Roseomonas marmotae	2768161	S	19	0	19	0.00002
ERR6913276	Gluconobacter frateurii	38308	S	61	6	67	0.00007
ERR6913276	Gluconobacter albidus	318683	S	16	1	17	0.00002
ERR6913276	Gluconobacter oxydans	442	S	10	7	17	0.00002
ERR6913276	Gluconobacter thailandicus	257438	S	5	2	7	0.00001
ERR6913276	Acetobacter aceti	435	S	18	2	20	0.00002
ERR6913276	Acetobacter senegalensis	446692	S	12	11	23	0.00003
ERR6913276	Acetobacter vaccinii	2592655	S	9	0	9	0.00001
ERR6913276	Acetobacter persici	1076596	S	8	0	8	0.00001
ERR6913276	Komagataeibacter xylinus	28448	S	11	11	22	0.00002
ERR6913276	Komagataeibacter nataicola	265960	S	5	2	7	0.00001
ERR6913276	Rhodovastum atsumiense	504468	S	18	0	18	0.00002
ERR6913276	Acidiphilium multivorum	62140	S	8	9	17	0.00002
ERR6913276	Acidibrevibacterium fodinaquatile	1969806	S	12	0	12	0.00001
ERR6913276	Lichenicola cladoniae	1484109	S	10	0	10	0.00001
ERR6913276	Formicincola oecophyllae	2558361	S	10	0	10	0.00001
ERR6913276	Acidocella sp. MX-AZ03	2697363	S	9	0	9	0.00001
ERR6913276	Roseococcus microcysteis	2771361	S	9	0	9	0.00001
ERR6913276	Sediminicoccus rosea	1225128	S	9	0	9	0.00001
ERR6913276	Gluconacetobacter diazotrophicus	33996	S	8	0	8	0.00001
ERR6913276	Kozakia baliensis	153496	S	7	1	8	0.00001
ERR6913276	Granulibacter bethesdensis	364410	S	6	0	6	0.00001
ERR6913276	Azospirillum sp. TSH100	652764	S	17	4	21	0.00002
ERR6913276	Azospirillum sp. B510	137722	S	8	1	9	0.00001
ERR6913276	Azospirillum sp. TSA2s	709810	S	8	4	12	0.00001
ERR6913276	Azospirillum sp. TSH58	664962	S	5	5	10	0.00001
ERR6913276	Azospirillum thiophilum	528244	S	37	9	46	0.00005
ERR6913276	Azospirillum thermophilum	2202148	S	33	4	37	0.00004
ERR6913276	Azospirillum argentinense	2970906	S	17	19	36	0.00004
ERR6913276	Azospirillum brasilense	192	S	14	12	26	0.00003
ERR6913276	Azospirillum oryzae	286727	S	9	5	14	0.00002
ERR6913276	Azospirillum ramasamyi	682998	S	9	3	12	0.00001
ERR6913276	Azospirillum humicireducens	1226968	S	7	3	10	0.00001
ERR6913276	Skermanella mucosa	1789672	S	27	5	32	0.00004
ERR6913276	Skermanella pratensis	2233999	S	16	3	19	0.00002
ERR6913276	Skermanella rosea	1817965	S	6	1	7	0.00001
ERR6913276	Skermanella sp. TT6	2775420	S	5	1	6	0.00001
ERR6913276	Niveispirillum cyanobacteriorum	1612173	S	12	0	12	0.00001
ERR6913276	Indioceanicola profundi	2220096	S	10	0	10	0.00001
ERR6913276	Nitrospirillum amazonense	28077	S	9	0	9	0.00001
ERR6913276	Magnetospirillum sp. ME-1	1639348	S	11	10	21	0.00002
ERR6913276	Magnetospirillum sp. XM-1	1663591	S	8	6	14	0.00002
ERR6913276	Magnetospirillum gryphiswaldense	55518	S	16	2	18	0.00002
ERR6913276	Magnetospirillum magneticum	84159	S	16	13	29	0.00003
ERR6913276	Rhodospirillum centenum	34018	S	19	1	20	0.00002
ERR6913276	Rhodospirillum rubrum	1085	S	14	0	14	0.00002
ERR6913276	Hypericibacter adhaerens	2602016	S	18	0	18	0.00002
ERR6913276	Hypericibacter terrae	2602015	S	8	0	8	0.00001
ERR6913276	Pararhodospirillum photometricum	1084	S	18	0	18	0.00002
ERR6913276	Defluviicoccus vanus	111831	S	10	0	10	0.00001
ERR6913276	Ferrovibrio terrae	2594003	S	8	0	8	0.00001
ERR6913276	Haematospirillum jordaniae	1549855	S	5	0	5	0.00001
ERR6913276	Thalassospira sp. B30-1	2785911	S	7	1	8	0.00001
ERR6913276	Thalassospira sp. GO-4	2946605	S	6	0	6	0.00001
ERR6913276	Thalassospira marina	2048283	S	10	0	10	0.00001
ERR6913276	Magnetospira sp. QH-2	1288970	S	5	0	5	0.00001
ERR6913276	Tistrella mobilis	171437	S	15	0	15	0.00002
ERR6913276	Elioraea tepida	2843330	S	15	0	15	0.00002
ERR6913276	Nisaea acidiphila	1862145	S	12	0	12	0.00001
ERR6913276	Aestuariispira ectoiniformans	2775080	S	6	0	6	0.00001
ERR6913276	Stella humosa	94	S	5	0	5	0.00001
ERR6913276	Wolbachia endosymbiont of Dipetalonema caudispina	1812112	S	14	21	35	0.00004
ERR6913276	Wolbachia endosymbiont of Dirofilaria (Dirofilaria) immitis	1812115	S	5	10	15	0.00002
ERR6913276	Wolbachia endosymbiont of Howardula sp.	2916816	S	5	3	8	0.00001
ERR6913276	Ehrlichia ruminantium	779	S	8	0	8	0.00001
ERR6913276	Ehrlichia muris	35795	S	8	1	9	0.00001
ERR6913276	Neoehrlichia mikurensis	89586	S	6	1	7	0.00001
ERR6913276	Rickettsia endosymbiont of Oedothorax gibbosus	931099	S	16	4	20	0.00002
ERR6913276	Rickettsia endosymbiont of Ixodes scapularis	444612	S	8	14	22	0.00002
ERR6913276	Candidatus Sneabacter namystus	2601646	S	11	0	11	0.00001
ERR6913276	Orientia tsutsugamushi	784	S	6	0	6	0.00001
ERR6913276	Candidatus Phycorickettsia trachydisci	2115978	S	7	0	7	0.00001
ERR6913276	endosymbiont of Acanthamoeba sp. UWC8	86106	S	14	0	14	0.00002
ERR6913276	Candidatus Cytomitobacter indipagum	2601575	S	9	5	14	0.00002
ERR6913276	Candidatus Hydrogenosomobacter endosymbioticus	2558174	S	7	0	7	0.00001
ERR6913276	Candidatus Gromoviella agglomerans	2806609	S	7	0	7	0.00001
ERR6913276	Candidatus Paracaedibacter acanthamoebae	91604	S	6	0	6	0.00001
ERR6913276	Candidatus Nucleicultrix amoebiphila	1509244	S	6	0	6	0.00001
ERR6913276	Candidatus Fonsibacter ubiquis	1925548	S	44	1	45	0.00005
ERR6913276	Hyphomonas sp. Mor2	1906738	S	8	0	8	0.00001
ERR6913276	Hyphomonas sp. CACIAM 19H1	1873716	S	7	5	12	0.00001
ERR6913276	Hyphomonas sp. KY3	2016196	S	5	3	8	0.00001
ERR6913276	Hirschia baltica	2724	S	10	1	11	0.00001
ERR6913276	Marinicauda algicola	2029849	S	9	0	9	0.00001
ERR6913276	Glycocaulis alkaliphilus	1434191	S	6	0	6	0.00001
ERR6913276	Luteithermobacter gelatinilyticus	2582913	S	9	0	9	0.00001
ERR6913276	Paremcibacter congregatus	2043170	S	6	0	6	0.00001
ERR6913276	Pseudemcibacter aquimaris	2857064	S	5	0	5	0.00001
ERR6913276	Kordiimonas sp. SCSIO 12603	2829596	S	6	3	9	0.00001
ERR6913276	Hyphococcus flavus	1866326	S	5	0	5	0.00001
ERR6913276	Comamonas testosteroni	285	S	876	664	1540	0.00169
ERR6913276	Comamonas aquatica	225991	S	321	153	474	0.00052
ERR6913276	Comamonas sp. B21-038	2918299	S	78	18	96	0.00011
ERR6913276	Comamonas sp. Y33R10-2	2853257	S	46	5	51	0.00006
ERR6913276	Comamonas sp. NLF-7-7	2597701	S	27	22	49	0.00005
ERR6913276	Comamonas sp. NLF-1-9	2853163	S	12	7	19	0.00002
ERR6913276	Comamonas sp. C11	2966554	S	7	15	22	0.00002
ERR6913276	Comamonas thiooxydans	363952	S	83	56	139	0.00015
ERR6913276	Comamonas odontotermitis	379895	S	43	8	51	0.00006
ERR6913276	Comamonas fluminis	2796366	S	30	6	36	0.00004
ERR6913276	Comamonas kerstersii	225992	S	24	4	28	0.00003
ERR6913276	Comamonas serinivorans	1082851	S	23	5	28	0.00003
ERR6913276	Comamonas piscis	1562974	S	23	4	27	0.00003
ERR6913276	Comamonas koreensis	160825	S	5	6	11	0.00001
ERR6913276	Acidovorax sp. KKS102	358220	S	301	161	462	0.00051
ERR6913276	Acidovorax sp. T1	1858609	S	66	82	148	0.00016
ERR6913276	Acidovorax sp. YS12	2738413	S	58	38	96	0.00011
ERR6913276	Acidovorax sp. JMULE5	2518343	S	57	21	78	0.00009
ERR6913276	Acidovorax sp. 1608163	2478662	S	46	14	60	0.00007
ERR6913276	Acidovorax sp. RAC01	1842533	S	42	18	60	0.00007
ERR6913276	Acidovorax sp. GBBC 1281	2940492	S	30	19	49	0.00005
ERR6913276	Acidovorax sp. HDW3	2714923	S	25	11	36	0.00004
ERR6913276	Acidovorax sp. NCPPB 2350	2940487	S	19	8	27	0.00003
ERR6913276	Acidovorax sp. NCPPB 3576	2940488	S	19	12	31	0.00003
ERR6913276	Acidovorax sp. 5MLIR	2949090	S	12	4	16	0.00002
ERR6913276	Acidovorax temperans	80878	S	349	286	635	0.00070
ERR6913276	Acidovorax carolinensis	553814	S	76	69	145	0.00016
ERR6913276	Acidovorax antarcticus	2743470	S	54	23	77	0.00008
ERR6913276	Acidovorax avenae	80867	S	37	88	125	0.00014
ERR6913276	Acidovorax monticola	1926868	S	37	22	59	0.00006
ERR6913276	Acidovorax radicis	758826	S	36	10	46	0.00005
ERR6913276	Acidovorax citrulli	80869	S	23	24	47	0.00005
ERR6913276	Acidovorax cattleyae	80868	S	13	12	25	0.00003
ERR6913276	Polaromonas naphthalenivorans	216465	S	601	541	1142	0.00126
ERR6913276	Polaromonas sp. JS666	296591	S	52	60	112	0.00012
ERR6913276	Polaromonas sp. H8N	1840297	S	8	94	102	0.00011
ERR6913276	Polaromonas vacuolata	37448	S	56	58	114	0.00013
ERR6913276	Variovorax sp. PAMC28562	2762323	S	61	7	68	0.00007
ERR6913276	Variovorax sp. PAMC 28711	1795631	S	50	12	62	0.00007
ERR6913276	Variovorax sp. PAMC26660	2762322	S	45	16	61	0.00007
ERR6913276	Variovorax sp. HW608	1034889	S	42	8	50	0.00005
ERR6913276	Variovorax sp. WDL1	207745	S	34	22	56	0.00006
ERR6913276	Variovorax sp. 38R	2774875	S	33	33	66	0.00007
ERR6913276	Variovorax sp. RKNM96	2681552	S	23	11	34	0.00004
ERR6913276	Variovorax sp. RA8	662548	S	21	10	31	0.00003
ERR6913276	Variovorax sp. PBS-H4	434008	S	19	7	26	0.00003
ERR6913276	Variovorax sp. SRS16	282217	S	12	19	31	0.00003
ERR6913276	Variovorax sp. PBL-H6	434009	S	12	9	21	0.00002
ERR6913276	Variovorax sp. WS11	1105204	S	11	0	11	0.00001
ERR6913276	Variovorax sp. PBL-E5	434014	S	9	19	28	0.00003
ERR6913276	Variovorax sp. PMC12	2126319	S	7	218	225	0.00025
ERR6913276	Variovorax paradoxus	34073	S	138	69	207	0.00023
ERR6913276	Variovorax boronicumulans	436515	S	57	48	105	0.00012
ERR6913276	Rhodoferax sp. AJA081-3	2752316	S	66	22	88	0.00010
ERR6913276	Rhodoferax sp. PAMC 29310	2822760	S	42	9	51	0.00006
ERR6913276	Rhodoferax sp. BAB1	2741720	S	39	20	59	0.00006
ERR6913276	Rhodoferax sp. MIZ03	2798804	S	24	5	29	0.00003
ERR6913276	Rhodoferax sediminis	2509614	S	61	27	88	0.00010
ERR6913276	Rhodoferax saidenbachensis	1484693	S	50	26	76	0.00008
ERR6913276	Rhodoferax antarcticus	81479	S	47	13	60	0.00007
ERR6913276	Rhodoferax koreense	1842727	S	36	17	53	0.00006
ERR6913276	Rhodoferax ferrireducens	192843	S	34	10	44	0.00005
ERR6913276	Rhodoferax aquaticus	2527691	S	34	7	41	0.00005
ERR6913276	Hydrogenophaga sp. PBL-H3	434010	S	38	23	61	0.00007
ERR6913276	Hydrogenophaga sp. BPS33	2651974	S	33	10	43	0.00005
ERR6913276	Hydrogenophaga sp. RAC07	1842537	S	27	13	40	0.00004
ERR6913276	Hydrogenophaga sp. YM1	2806262	S	27	16	43	0.00005
ERR6913276	Hydrogenophaga sp. SL48	2806347	S	26	9	35	0.00004
ERR6913276	Hydrogenophaga sp. NH-16	2184519	S	24	59	83	0.00009
ERR6913276	Hydrogenophaga sp. PAMC20947	2565558	S	17	1	18	0.00002
ERR6913276	Hydrogenophaga sp. PBC	795665	S	14	7	21	0.00002
ERR6913276	Hydrogenophaga crocea	2716225	S	36	19	55	0.00006
ERR6913276	Hydrogenophaga taeniospiralis	65656	S	28	9	37	0.00004
ERR6913276	Hydrogenophaga pseudoflava	47421	S	22	48	70	0.00008
ERR6913276	Hydrogenophaga crassostreae	1763535	S	16	1	17	0.00002
ERR6913276	Delftia lacustris	558537	S	74	346	420	0.00046
ERR6913276	Delftia acidovorans	80866	S	55	125	180	0.00020
ERR6913276	Delftia sp. Cs1-4	742013	S	14	52	66	0.00007
ERR6913276	Delftia sp. HK171	1920191	S	7	32	39	0.00004
ERR6913276	Delftia tsuruhatensis	180282	S	9	18	27	0.00003
ERR6913276	Limnohabitans sp. 103DPR2	1678129	S	252	34	286	0.00031
ERR6913276	Limnohabitans sp. 63ED37-2	1678128	S	104	23	127	0.00014
ERR6913276	Diaphorobacter sp. HDW4A	2714924	S	25	8	33	0.00004
ERR6913276	Diaphorobacter sp. HDW4B	2714925	S	19	3	22	0.00002
ERR6913276	Diaphorobacter sp. MNS-0	2866628	S	16	102	118	0.00013
ERR6913276	Diaphorobacter sp. ED-3	3016636	S	14	107	121	0.00013
ERR6913276	Diaphorobacter sp. JS3051	2792224	S	9	73	82	0.00009
ERR6913276	Diaphorobacter sp. JS3050	2735554	S	6	47	53	0.00006
ERR6913276	Diaphorobacter aerolatus	1288495	S	31	13	44	0.00005
ERR6913276	Diaphorobacter ruginosibacter	1715720	S	30	7	37	0.00004
ERR6913276	[Acidovorax] ebreus	721785	S	21	79	100	0.00011
ERR6913276	Diaphorobacter nitroreducens	164759	S	18	41	59	0.00006
ERR6913276	Ottowia oryzae	2109914	S	86	26	112	0.00012
ERR6913276	Ottowia testudinis	2816950	S	68	18	86	0.00009
ERR6913276	Ottowia sp. oral taxon 894	1658672	S	46	6	52	0.00006
ERR6913276	Curvibacter sp. AEP1-3	1844971	S	127	14	141	0.00016
ERR6913276	Ramlibacter tataouinensis	94132	S	123	43	166	0.00018
ERR6913276	Kinneretia sp. DAIF2	2714952	S	71	20	91	0.00010
ERR6913276	Kinneretia sp. XES5	2877940	S	19	3	22	0.00002
ERR6913276	Simplicispira suum	2109915	S	85	26	111	0.00012
ERR6913276	Serpentinimonas raichei	1458425	S	34	23	57	0.00006
ERR6913276	Serpentinimonas maccroryi	1458426	S	15	13	28	0.00003
ERR6913276	Alicycliphilus denitrificans	179636	S	63	149	212	0.00023
ERR6913276	Melaminivora suipulveris	2109913	S	23	22	45	0.00005
ERR6913276	Melaminivora jejuensis	1267217	S	21	16	37	0.00004
ERR6913276	Verminephrobacter eiseniae	364317	S	32	6	38	0.00004
ERR6913276	Candidatus Symbiobacter mobilis	1436290	S	24	0	24	0.00003
ERR6913276	Hylemonella gracilis	80880	S	21	4	25	0.00003
ERR6913276	Pulveribacter suum	2116657	S	7	5	12	0.00001
ERR6913276	Massilia sp. NP310	2861282	S	694	331	1025	0.00113
ERR6913276	Massilia sp. H6	2970464	S	126	31	157	0.00017
ERR6913276	Massilia sp. WG5	1707785	S	91	31	122	0.00013
ERR6913276	Massilia sp. LPB0304	2769491	S	87	28	115	0.00013
ERR6913276	Massilia sp. HC52	2852099	S	39	14	53	0.00006
ERR6913276	Massilia sp. PAMC28688	2861283	S	33	6	39	0.00004
ERR6913276	Massilia sp. DM-R-R2A-13	2899220	S	32	9	41	0.00005
ERR6913276	Massilia sp. erpn	2738142	S	30	37	67	0.00007
ERR6913276	Massilia sp. YMA4	1593482	S	10	7	17	0.00002
ERR6913276	Massilia sp. MB5	2919578	S	6	59	65	0.00007
ERR6913276	Massilia oculi	945844	S	304	136	440	0.00048
ERR6913276	Massilia forsythiae	2728020	S	80	23	103	0.00011
ERR6913276	Massilia violaceinigra	2045208	S	56	15	71	0.00008
ERR6913276	Massilia putida	1141883	S	40	9	49	0.00005
ERR6913276	Massilia antarctica	2765360	S	27	9	36	0.00004
ERR6913276	Pseudoduganella plicata	321984	S	34	12	46	0.00005
ERR6913276	Pseudoduganella lutea	321985	S	34	12	46	0.00005
ERR6913276	Pseudoduganella flava	871742	S	25	8	33	0.00004
ERR6913276	Pseudoduganella umbonata	864828	S	24	11	35	0.00004
ERR6913276	Pseudoduganella armeniaca	2072590	S	22	16	38	0.00004
ERR6913276	Pseudoduganella albidiflava	321983	S	18	8	26	0.00003
ERR6913276	Duganella dendranthematis	2728021	S	50	14	64	0.00007
ERR6913276	Collimonas fungivorans	158899	S	373	227	600	0.00066
ERR6913276	Collimonas arenae	279058	S	201	68	269	0.00030
ERR6913276	Collimonas pratensis	279113	S	135	88	223	0.00025
ERR6913276	Janthinobacterium sp. 1_2014MBL_MicDiv	1644131	S	61	42	103	0.00011
ERR6913276	Janthinobacterium sp. PAMC25594	2861284	S	59	65	124	0.00014
ERR6913276	Janthinobacterium sp. HH102	1537274	S	44	103	147	0.00016
ERR6913276	Janthinobacterium sp. LM6	1938606	S	44	46	90	0.00010
ERR6913276	Janthinobacterium sp. 17J80-10	2497863	S	33	7	40	0.00004
ERR6913276	Janthinobacterium sp. Marseille	375286	S	23	8	31	0.00003
ERR6913276	Janthinobacterium sp. B9-8	1236179	S	7	1	8	0.00001
ERR6913276	Janthinobacterium svalbardensis	368607	S	55	62	117	0.00013
ERR6913276	Janthinobacterium tructae	2590869	S	46	53	99	0.00011
ERR6913276	Janthinobacterium lividum	29581	S	41	137	178	0.00020
ERR6913276	Janthinobacterium agaricidamnosum	55508	S	40	68	108	0.00012
ERR6913276	Herbaspirillum frisingense	92645	S	25	12	37	0.00004
ERR6913276	Herbaspirillum seropedicae	964	S	22	12	34	0.00004
ERR6913276	Herbaspirillum hiltneri	341045	S	21	7	28	0.00003
ERR6913276	Herbaspirillum huttiense	863372	S	21	11	32	0.00004
ERR6913276	Herbaspirillum robiniae	2014887	S	21	11	32	0.00004
ERR6913276	Herbaspirillum rubrisubalbicans	80842	S	10	9	19	0.00002
ERR6913276	Herbaspirillum sp. meg3	2025949	S	9	1	10	0.00001
ERR6913276	Undibacterium parvum	401471	S	77	9	86	0.00009
ERR6913276	Undibacterium sp. YM2	2058625	S	11	9	20	0.00002
ERR6913276	Undibacterium sp. KW1	2058624	S	8	6	14	0.00002
ERR6913276	Noviherbaspirillum sp. UKPF54	2601898	S	60	16	76	0.00008
ERR6913276	Oxalobacter aliiformigenes	2946593	S	12	0	12	0.00001
ERR6913276	Oxalobacter vibrioformis	933080	S	8	0	8	0.00001
ERR6913276	Herminiimonas arsenitoxidans	1809410	S	14	5	19	0.00002
ERR6913276	Glaciimonas sp. PAMC28666	2807626	S	8	0	8	0.00001
ERR6913276	Burkholderia cenocepacia	95486	S	559	648	1207	0.00133
ERR6913276	Burkholderia vietnamiensis	60552	S	107	101	208	0.00023
ERR6913276	Burkholderia multivorans	87883	S	41	6	47	0.00005
ERR6913276	Burkholderia anthina	179879	S	23	6	29	0.00003
ERR6913276	Burkholderia cepacia	292	S	20	1136	1156	0.00127
ERR6913276	Burkholderia pyrrocinia	60550	S	19	4	23	0.00003
ERR6913276	Burkholderia contaminans	488447	S	17	3	20	0.00002
ERR6913276	Burkholderia territorii	1503055	S	14	3	17	0.00002
ERR6913276	Burkholderia stagnalis	1503054	S	9	1	10	0.00001
ERR6913276	Burkholderia ubonensis	101571	S	8	1	9	0.00001
ERR6913276	Burkholderia ambifaria	152480	S	8	2	10	0.00001
ERR6913276	Burkholderia lata	482957	S	8	2	10	0.00001
ERR6913276	Burkholderia stabilis	95485	S	6	1	7	0.00001
ERR6913276	Burkholderia seminalis	488731	S	5	1	6	0.00001
ERR6913276	Burkholderia pseudomallei	28450	S	37	1102	1139	0.00125
ERR6913276	Burkholderia thailandensis	57975	S	12	257	269	0.00030
ERR6913276	Burkholderia oklahomensis	342113	S	7	1	8	0.00001
ERR6913276	Burkholderia mayonis	1385591	S	5	0	5	0.00001
ERR6913276	Burkholderia sp. FERM BP-3421	1494466	S	9	0	9	0.00001
ERR6913276	Burkholderia sp. DHOD12	2571746	S	8	0	8	0.00001
ERR6913276	Burkholderia sp. LA-2-3-30-S1-D2	1637862	S	7	3	10	0.00001
ERR6913276	Burkholderia sp. KJ006	416344	S	5	13	18	0.00002
ERR6913276	Burkholderia sp. PAMC 28687	1795874	S	5	16	21	0.00002
ERR6913276	Burkholderia gladioli	28095	S	36	8	44	0.00005
ERR6913276	Burkholderia glumae	337	S	20	89	109	0.00012
ERR6913276	Cupriavidus metallidurans	119219	S	102	17	119	0.00013
ERR6913276	Cupriavidus taiwanensis	164546	S	67	54	121	0.00013
ERR6913276	Cupriavidus pauculus	82633	S	44	8	52	0.00006
ERR6913276	Cupriavidus sp. EM10	2839983	S	27	8	35	0.00004
ERR6913276	Cupriavidus sp. KK10	1478019	S	5	9	14	0.00002
ERR6913276	Cupriavidus oxalaticus	96344	S	25	8	33	0.00004
ERR6913276	Cupriavidus basilensis	68895	S	22	5	27	0.00003
ERR6913276	Cupriavidus gilardii	82541	S	19	41	60	0.00007
ERR6913276	Cupriavidus cauae	2608999	S	16	6	22	0.00002
ERR6913276	Cupriavidus necator	106590	S	15	8	23	0.00003
ERR6913276	Cupriavidus neocaledonicus	1040979	S	15	15	30	0.00003
ERR6913276	Cupriavidus campinensis	151783	S	8	1	9	0.00001
ERR6913276	Lautropia mirabilis	47671	S	434	41	475	0.00052
ERR6913276	Polynucleobacter sp. MWH-Aus1W21	1855880	S	34	11	45	0.00005
ERR6913276	Polynucleobacter sp. MWH-S4W17	1855910	S	15	14	29	0.00003
ERR6913276	Polynucleobacter sp. AP-Elch-400A-B2	2576930	S	11	10	21	0.00002
ERR6913276	Polynucleobacter sp. AP-Ainpum-60-G11	2576926	S	11	4	15	0.00002
ERR6913276	Polynucleobacter sp. MWH-CaK5	2689107	S	10	0	10	0.00001
ERR6913276	Polynucleobacter sp. MWH-UH35A	1855619	S	8	2	10	0.00001
ERR6913276	Polynucleobacter sp. MWH-Spelu-300-X4	2689109	S	7	0	7	0.00001
ERR6913276	Polynucleobacter sp. AP-Nino-20-G2	2576917	S	7	2	9	0.00001
ERR6913276	Polynucleobacter sp. Adler-ghost	2770234	S	6	5	11	0.00001
ERR6913276	Polynucleobacter sp. MG-Unter2-18	2081052	S	6	8	14	0.00002
ERR6913276	Polynucleobacter sp. MWH-Svant-W18	1855909	S	6	1	7	0.00001
ERR6913276	Polynucleobacter sp. AP-Sving-400A-A2	2081049	S	5	5	10	0.00001
ERR6913276	Polynucleobacter sp. MWH-UH24A	2689110	S	5	0	5	0.00001
ERR6913276	Polynucleobacter sp. JS-JIR-II-50	2576919	S	5	4	9	0.00001
ERR6913276	Polynucleobacter necessarius	576610	S	42	11	53	0.00006
ERR6913276	Polynucleobacter asymbioticus	576611	S	18	3	21	0.00002
ERR6913276	Polynucleobacter tropicus	1743174	S	8	2	10	0.00001
ERR6913276	Polynucleobacter arcticus	1743165	S	6	1	7	0.00001
ERR6913276	Polynucleobacter wuianus	1743168	S	5	2	7	0.00001
ERR6913276	Polynucleobacter paludilacus	1855895	S	5	8	13	0.00001
ERR6913276	Ralstonia insidiosa	190721	S	109	16	125	0.00014
ERR6913276	Ralstonia solanacearum	305	S	51	126	177	0.00019
ERR6913276	Ralstonia wenshanensis	2842456	S	15	2	17	0.00002
ERR6913276	Ralstonia pickettii	329	S	11	4	15	0.00002
ERR6913276	Ralstonia mannitolilytica	105219	S	5	3	8	0.00001
ERR6913276	Paraburkholderia aromaticivorans	2026199	S	50	16	66	0.00007
ERR6913276	Paraburkholderia fungorum	134537	S	24	4	28	0.00003
ERR6913276	Paraburkholderia sp. SOS3	1926494	S	14	1	15	0.00002
ERR6913276	Paraburkholderia sp. PGU19	2735434	S	9	6	15	0.00002
ERR6913276	Paraburkholderia acidisoli	2571748	S	15	1	16	0.00002
ERR6913276	Paraburkholderia edwinii	2861782	S	12	1	13	0.00001
ERR6913276	Paraburkholderia caledonica	134536	S	11	1	12	0.00001
ERR6913276	Paraburkholderia caribensis	75105	S	10	5	15	0.00002
ERR6913276	Paraburkholderia terricola	169427	S	9	2	11	0.00001
ERR6913276	Paraburkholderia dioscoreae	2604047	S	8	5	13	0.00001
ERR6913276	Paraburkholderia pallida	2547399	S	8	0	8	0.00001
ERR6913276	Paraburkholderia acidiphila	2571747	S	6	0	6	0.00001
ERR6913276	Paraburkholderia megapolitana	420953	S	6	0	6	0.00001
ERR6913276	Paraburkholderia xenovorans	36873	S	6	3	9	0.00001
ERR6913276	Paraburkholderia bryophila	420952	S	5	0	5	0.00001
ERR6913276	Paraburkholderia terrae	311230	S	5	5	10	0.00001
ERR6913276	Pandoraea thiooxydans	445709	S	16	0	16	0.00002
ERR6913276	Pandoraea faecigallinarum	656179	S	11	3	14	0.00002
ERR6913276	Pandoraea pnomenusa	93220	S	10	3	13	0.00001
ERR6913276	Pandoraea fibrosis	1891094	S	10	4	14	0.00002
ERR6913276	Pandoraea pulmonicola	93221	S	8	2	10	0.00001
ERR6913276	Pandoraea vervacti	656178	S	8	2	10	0.00001
ERR6913276	Pandoraea apista	93218	S	6	2	8	0.00001
ERR6913276	Pandoraea norimbergensis	93219	S	6	1	7	0.00001
ERR6913276	Caballeronia sp. TF1N1	2878153	S	15	9	24	0.00003
ERR6913276	Caballeronia sp. Lep1P3	2878150	S	5	9	14	0.00002
ERR6913276	Caballeronia grimmiae	1071679	S	14	1	15	0.00002
ERR6913276	Caballeronia insecticola	758793	S	7	0	7	0.00001
ERR6913276	Caballeronia zhejiangensis	871203	S	6	0	6	0.00001
ERR6913276	Chitinimonas koreensis	356302	S	20	2	22	0.00002
ERR6913276	Chitinimonas arctica	2594795	S	13	0	13	0.00001
ERR6913276	Limnobacter sp. SAORIC-580	2732163	S	14	0	14	0.00002
ERR6913276	Mycoavidus cysteinexigens	1553431	S	9	0	9	0.00001
ERR6913276	Candidatus Vallotia cooleyia	1177211	S	7	0	7	0.00001
ERR6913276	Ephemeroptericola cinctiostellae	2268024	S	9	0	9	0.00001
ERR6913276	Mycetohabitans rhizoxinica	412963	S	8	0	8	0.00001
ERR6913276	Alcaligenes faecalis	511	S	868	354	1222	0.00134
ERR6913276	Alcaligenes sp. SORT26	2813780	S	179	18	197	0.00022
ERR6913276	Alcaligenes sp. NLF5-7	2918755	S	52	165	217	0.00024
ERR6913276	Alcaligenes sp. DN25	1367435	S	34	95	129	0.00014
ERR6913276	Alcaligenes sp. 1735tsa3	2953809	S	15	34	49	0.00005
ERR6913276	Alcaligenes sp. SMD-FA	2991054	S	5	13	18	0.00002
ERR6913276	Alcaligenes aquatilis	323284	S	85	117	202	0.00022
ERR6913276	Alcaligenes ammonioxydans	2582914	S	19	61	80	0.00009
ERR6913276	Achromobacter xylosoxidans	85698	S	78	47	125	0.00014
ERR6913276	Achromobacter sp. 77	2756133	S	14	32	46	0.00005
ERR6913276	Achromobacter sp. MFA1 R4	1881016	S	11	8	19	0.00002
ERR6913276	Achromobacter sp. AONIH1	1758194	S	5	2	7	0.00001
ERR6913276	Achromobacter spanius	217203	S	41	8	49	0.00005
ERR6913276	Achromobacter denitrificans	32002	S	28	11	39	0.00004
ERR6913276	Achromobacter insolitus	217204	S	22	4	26	0.00003
ERR6913276	Achromobacter deleyi	1353891	S	19	7	26	0.00003
ERR6913276	Achromobacter mucicolens	1389922	S	15	13	28	0.00003
ERR6913276	Achromobacter pestifer	1353889	S	11	4	15	0.00002
ERR6913276	Bordetella holmesii	35814	S	23	3	26	0.00003
ERR6913276	Bordetella trematum	123899	S	23	3	26	0.00003
ERR6913276	Bordetella petrii	94624	S	22	8	30	0.00003
ERR6913276	Bordetella hinzii	103855	S	20	5	25	0.00003
ERR6913276	Bordetella genomosp. 13	463040	S	17	3	20	0.00002
ERR6913276	Bordetella flabilis	463014	S	16	1	17	0.00002
ERR6913276	Bordetella sp. N	1746199	S	10	0	10	0.00001
ERR6913276	Bordetella sp. H567	1697043	S	6	0	6	0.00001
ERR6913276	Bordetella bronchialis	463025	S	14	1	15	0.00002
ERR6913276	Bordetella genomosp. 9	1416803	S	7	0	7	0.00001
ERR6913276	Bordetella genomosp. 8	1416806	S	7	0	7	0.00001
ERR6913276	Bordetella parapertussis	519	S	5	49	54	0.00006
ERR6913276	Bordetella pseudohinzii	1331258	S	5	1	6	0.00001
ERR6913276	Pigmentiphaga aceris	1940612	S	22	1	23	0.00003
ERR6913276	Pigmentiphaga sp. H8	2488560	S	19	2	21	0.00002
ERR6913276	Pusillimonas thiosulfatoxidans	2028345	S	19	1	20	0.00002
ERR6913276	Pusillimonas sp. T7-7	1007105	S	7	0	7	0.00001
ERR6913276	Pusillimonas sp. DMV24BSW_D	2716226	S	5	0	5	0.00001
ERR6913276	Oligella ureolytica	90244	S	20	0	20	0.00002
ERR6913276	Oligella urethralis	90245	S	12	0	12	0.00001
ERR6913276	Orrella dioscoreae	1851544	S	12	2	14	0.00002
ERR6913276	Orrella sp. f23	2782176	S	8	0	8	0.00001
ERR6913276	Orrella marina	2163011	S	5	0	5	0.00001
ERR6913276	Paenalcaligenes faecalis	2980099	S	13	0	13	0.00001
ERR6913276	Paenalcaligenes hominis	643674	S	8	0	8	0.00001
ERR6913276	Paralcaligenes sp. KSB-10	2901142	S	14	0	14	0.00002
ERR6913276	Taylorella equigenitalis	29575	S	6	24	30	0.00003
ERR6913276	Basilea psittacipulmonis	1472345	S	6	0	6	0.00001
ERR6913276	Kerstersia gyiorum	206506	S	5	0	5	0.00001
ERR6913276	Castellaniella defragrans	75697	S	5	0	5	0.00001
ERR6913276	Schlegelella aquatica	376175	S	174	50	224	0.00025
ERR6913276	Sphaerotilus sp. FB-5	2914710	S	52	17	69	0.00008
ERR6913276	Sphaerotilus sulfidivorans	639200	S	48	19	67	0.00007
ERR6913276	Caldimonas thermodepolymerans	215580	S	67	32	99	0.00011
ERR6913276	Caldimonas brevitalea	413882	S	38	5	43	0.00005
ERR6913276	Aquincola tertiaricarbonis	391953	S	76	19	95	0.00010
ERR6913276	Methylibium petroleiphilum	105560	S	15	16	31	0.00003
ERR6913276	Methylibium sp. Pch-M	2082386	S	12	19	31	0.00003
ERR6913276	Roseateles sp. SL47	2995138	S	19	2	21	0.00002
ERR6913276	Roseateles sp. BIM B-1768	2978473	S	15	2	17	0.00002
ERR6913276	Roseateles depolymerans	76731	S	14	2	16	0.00002
ERR6913276	Rubrivivax gelatinosus	28068	S	44	10	54	0.00006
ERR6913276	Mitsuaria sp. 7	1658665	S	41	7	48	0.00005
ERR6913276	Ideonella dechloratans	36863	S	31	13	44	0.00005
ERR6913276	Inhella inkyongensis	392593	S	19	2	21	0.00002
ERR6913276	Aquabacterium olei	1296669	S	99	23	122	0.00013
ERR6913276	Aquabacterium sp. J223	2898431	S	49	15	64	0.00007
ERR6913276	Rhizobacter gummiphilus	946333	S	32	7	39	0.00004
ERR6913276	Rhizobacter sp. AJA081-3	2753607	S	29	9	38	0.00004
ERR6913276	Tepidimonas taiwanensis	307486	S	59	16	75	0.00008
ERR6913276	Thiomonas intermedia	926	S	21	4	25	0.00003
ERR6913276	Thiomonas sp. X19	1050370	S	9	1	10	0.00001
ERR6913276	Thiomonas arsenitoxydans	426114	S	6	17	23	0.00003
ERR6913276	Paucibacter sp. KCTC 42545	1768242	S	47	7	54	0.00006
ERR6913276	Leptothrix cholodnii	34029	S	44	14	58	0.00006
ERR6913276	Xylophilus rhododendri	2697032	S	24	6	30	0.00003
ERR6913276	Candidatus Ichthyocystis hellenicum	1561003	S	5	0	5	0.00001
ERR6913276	Sutterella wadsworthensis	40545	S	14	0	14	0.00002
ERR6913276	Sutterella megalosphaeroides	2494234	S	8	0	8	0.00001
ERR6913276	Sutterella faecalis	2584944	S	5	0	5	0.00001
ERR6913276	Turicimonas muris	1796652	S	12	0	12	0.00001
ERR6913276	Neisseria mucosa	488	S	1710	607	2317	0.00255
ERR6913276	Neisseria elongata	495	S	961	109	1070	0.00118
ERR6913276	Neisseria sicca	490	S	668	195	863	0.00095
ERR6913276	Neisseria subflava	28449	S	342	92	434	0.00048
ERR6913276	Neisseria flavescens	484	S	268	77	345	0.00038
ERR6913276	Neisseria meningitidis	487	S	184	166	350	0.00038
ERR6913276	Neisseria sp. oral taxon 014	641148	S	84	8	92	0.00010
ERR6913276	Neisseria sp. KEM232	655307	S	58	3	61	0.00007
ERR6913276	Neisseria sp. ZJ785	2709396	S	12	0	12	0.00001
ERR6913276	Neisseria sp. ZJ106	2912188	S	12	0	12	0.00001
ERR6913276	Neisseria bacilliformis	267212	S	170	12	182	0.00020
ERR6913276	Neisseria macacae	496	S	137	64	201	0.00022
ERR6913276	Neisseria gonorrhoeae	485	S	90	31	121	0.00013
ERR6913276	Neisseria lactamica	486	S	66	33	99	0.00011
ERR6913276	Neisseria cinerea	483	S	58	11	69	0.00008
ERR6913276	Neisseria musculi	1815583	S	17	0	17	0.00002
ERR6913276	Neisseria animaloris	326522	S	13	1	14	0.00002
ERR6913276	Neisseria animalis	492	S	12	0	12	0.00001
ERR6913276	Neisseria brasiliensis	2666100	S	11	0	11	0.00001
ERR6913276	Neisseria chenwenguii	1853278	S	10	0	10	0.00001
ERR6913276	Neisseria shayeganii	607712	S	8	0	8	0.00001
ERR6913276	Neisseria arctica	1470200	S	8	0	8	0.00001
ERR6913276	Neisseria weaveri	28091	S	8	0	8	0.00001
ERR6913276	Neisseria canis	493	S	7	0	7	0.00001
ERR6913276	Neisseria zalophi	640030	S	5	0	5	0.00001
ERR6913276	Kingella oralis	505	S	327	10	337	0.00037
ERR6913276	Kingella denitrificans	502	S	72	5	77	0.00008
ERR6913276	Kingella potus	265175	S	6	0	6	0.00001
ERR6913276	Aquella oligotrophica	2067065	S	260	2	262	0.00029
ERR6913276	Eikenella corrodens	539	S	112	8	120	0.00013
ERR6913276	Eikenella exigua	2528037	S	29	2	31	0.00003
ERR6913276	Morococcus cerebrosus	1056807	S	79	48	127	0.00014
ERR6913276	Vitreoscilla filiformis	63	S	39	11	50	0.00005
ERR6913276	Conchiformibius steedae	153493	S	27	0	27	0.00003
ERR6913276	Alysiella crassa	153491	S	8	0	8	0.00001
ERR6913276	Alysiella filiformis	194196	S	6	0	6	0.00001
ERR6913276	Uruburuella suis	252130	S	12	1	13	0.00001
ERR6913276	Wielerella bovis	2917790	S	10	0	10	0.00001
ERR6913276	Paralysiella testudinis	2809020	S	9	0	9	0.00001
ERR6913276	Chitinolyticbacter meiyuanensis	682798	S	7	0	7	0.00001
ERR6913276	Crenobacter cavernae	2290923	S	7	1	8	0.00001
ERR6913276	Chromobacterium sp. ATCC 53434	2059672	S	93	31	124	0.00014
ERR6913276	Chromobacterium sp. Rain0013	2292447	S	5	6	11	0.00001
ERR6913276	Chromobacterium sp. IIBBL 290-4	2953890	S	5	1	6	0.00001
ERR6913276	Chromobacterium vaccinii	1108595	S	11	5	16	0.00002
ERR6913276	Chromobacterium violaceum	536	S	9	5	14	0.00002
ERR6913276	Iodobacter fluviatilis	537	S	6	2	8	0.00001
ERR6913276	Aquaspirillum sp. LM1	1938604	S	62	8	70	0.00008
ERR6913276	Laribacter hongkongensis	168471	S	40	12	52	0.00006
ERR6913276	Deefgea piscis	2739061	S	21	7	28	0.00003
ERR6913276	Deefgea tanakiae	2865840	S	6	2	8	0.00001
ERR6913276	Vogesella sp. LIG4	1192162	S	20	6	26	0.00003
ERR6913276	Vogesella sp. XCS3	2877939	S	14	2	16	0.00002
ERR6913276	Aquitalea sp. USM4	1590041	S	10	2	12	0.00001
ERR6913276	Aquitalea denitrificans	519081	S	9	2	11	0.00001
ERR6913276	Jeongeupia sp. HS-3	1009682	S	12	1	13	0.00001
ERR6913276	Jeongeupia sp. USM3	1906741	S	6	1	7	0.00001
ERR6913276	Microvirgula aerodenitrificans	57480	S	13	2	15	0.00002
ERR6913276	Chitinibacter fontanus	1737446	S	6	5	11	0.00001
ERR6913276	Chitiniphilus sp. CD1	2981137	S	8	1	9	0.00001
ERR6913276	Pseudogulbenkiania sp. NH8B	748280	S	7	2	9	0.00001
ERR6913276	Dechloromonas sp. A34	447588	S	251	50	301	0.00033
ERR6913276	Dechloromonas sp. HYN0024	2231055	S	111	23	134	0.00015
ERR6913276	Dechloromonas sp. TW-R-39-2	2654218	S	67	61	128	0.00014
ERR6913276	Dechloromonas denitrificans	281362	S	259	92	351	0.00039
ERR6913276	Ferribacterium limneticum	76259	S	664	117	781	0.00086
ERR6913276	Quatrionicoccus australiensis	138118	S	164	44	208	0.00023
ERR6913276	Azospira oryzae	146939	S	158	160	318	0.00035
ERR6913276	Azospira sp. I09	1765049	S	151	128	279	0.00031
ERR6913276	Azospira restricta	404405	S	66	17	83	0.00009
ERR6913276	Azospira inquinata	2785627	S	23	1	24	0.00003
ERR6913276	Aromatoleum petrolei	76116	S	29	5	34	0.00004
ERR6913276	Aromatoleum bremense	76115	S	16	6	22	0.00002
ERR6913276	Aromatoleum aromaticum	551760	S	15	7	22	0.00002
ERR6913276	Oryzomicrobium terrae	1735038	S	25	3	28	0.00003
ERR6913276	Niveibacterium microcysteis	2811415	S	12	1	13	0.00001
ERR6913276	Rugosibacter aromaticivorans	1565605	S	10	0	10	0.00001
ERR6913276	Thauera sp. MZ1T	85643	S	31	12	43	0.00005
ERR6913276	Thauera sp. WB-2	2897772	S	25	6	31	0.00003
ERR6913276	Thauera sp. K11	2005884	S	21	6	27	0.00003
ERR6913276	Thauera chlorobenzoica	96773	S	17	7	24	0.00003
ERR6913276	Thauera humireducens	1134435	S	15	3	18	0.00002
ERR6913276	Thauera aromatica	59405	S	13	6	19	0.00002
ERR6913276	Azoarcus sp. KH32C	748247	S	22	3	25	0.00003
ERR6913276	Azoarcus sp. DD4	2027405	S	22	7	29	0.00003
ERR6913276	Azoarcus olearius	418699	S	20	5	25	0.00003
ERR6913276	Parazoarcus communis	41977	S	30	3	33	0.00004
ERR6913276	Nitrogeniibacter aestuarii	2815343	S	19	1	20	0.00002
ERR6913276	Nitrogeniibacter mangrovi	2016596	S	9	1	10	0.00001
ERR6913276	Pseudazoarcus pumilus	2067960	S	19	2	21	0.00002
ERR6913276	Pseudothauera hydrothermalis	2184083	S	11	1	12	0.00001
ERR6913276	Fluviibacter phosphoraccumulans	1751046	S	90	4	94	0.00010
ERR6913276	Candidatus Methylopumilus turicensis	1581680	S	23	18	41	0.00005
ERR6913276	Candidatus Methylopumilus universalis	2588536	S	20	6	26	0.00003
ERR6913276	Candidatus Methylopumilus rimovensis	2588535	S	13	3	16	0.00002
ERR6913276	Candidatus Methylopumilus planktonicus	1581557	S	5	1	6	0.00001
ERR6913276	Methylophilus methylotrophus	17	S	32	22	54	0.00006
ERR6913276	Methylophilus medardicus	2588534	S	8	2	10	0.00001
ERR6913276	Methylotenera mobilis	359408	S	24	13	37	0.00004
ERR6913276	Methylotenera versatilis	1055487	S	12	6	18	0.00002
ERR6913276	Methyloradius palustris	2778876	S	21	9	30	0.00003
ERR6913276	Methylovorus glucosotrophus	266009	S	5	6	11	0.00001
ERR6913276	Denitratisoma oestradiolicum	311182	S	69	19	88	0.00010
ERR6913276	Denitratisoma sp. DHT3	1981880	S	42	22	64	0.00007
ERR6913276	Sulfuritalea hydrogenivorans	748811	S	37	9	46	0.00005
ERR6913276	Sterolibacterium denitrificans	157592	S	30	6	36	0.00004
ERR6913276	Methyloversatilis sp. RAC08	1842540	S	12	2	14	0.00002
ERR6913276	Candidatus Nitrotoga arctica	453162	S	5	10	15	0.00002
ERR6913276	Sideroxyarcus emersonii	2764705	S	17	15	32	0.00004
ERR6913276	Sideroxydans lithotrophicus	63745	S	11	8	19	0.00002
ERR6913276	Gallionella capsiferriformans	370405	S	9	1	10	0.00001
ERR6913276	Ferriphaselus amnicola	1188319	S	8	2	10	0.00001
ERR6913276	Ferrigenium kumadai	1682490	S	8	4	12	0.00001
ERR6913276	Nitrosomonas eutropha	916	S	7	8	15	0.00002
ERR6913276	Nitrosomonas europaea	915	S	5	2	7	0.00001
ERR6913276	Nitrosospira lacus	1288494	S	7	4	11	0.00001
ERR6913276	Sulfuriferula nivalis	2675298	S	15	0	15	0.00002
ERR6913276	Sulfuriferula sp. AH1	1985873	S	8	1	9	0.00001
ERR6913276	Sulfuriferula plumbiphila	171865	S	5	1	6	0.00001
ERR6913276	Sulfuricella denitrificans	649841	S	8	0	8	0.00001
ERR6913276	Sulfurimicrobium lacus	2715678	S	8	1	9	0.00001
ERR6913276	Usitatibacter rugosus	2732067	S	23	4	27	0.00003
ERR6913276	Usitatibacter palustris	2732487	S	16	3	19	0.00002
ERR6913276	Sulfuritortus calidifontis	1914471	S	9	5	14	0.00002
ERR6913276	Casimicrobium huifangae	2591109	S	15	1	16	0.00002
ERR6913276	Candidatus Nasuia deltocephalinicola	1160784	S	6	0	6	0.00001
ERR6913276	Ferrovum myxofaciens	416213	S	7	0	7	0.00001
ERR6913276	Hydrogenophilus thermoluteolus	297	S	158	2	160	0.00018
ERR6913276	Mariprofundus aestuarium	1921086	S	8	33	41	0.00005
ERR6913276	Mariprofundus ferrinatatus	1921087	S	5	20	25	0.00003
ERR6913276	Acidithiobacillus ferrooxidans	920	S	11	10	21	0.00002
ERR6913276	Acidithiobacillus ferrivorans	160808	S	7	3	10	0.00001
ERR6913276	Capnocytophaga gingivalis	1017	S	881	41	922	0.00101
ERR6913276	Capnocytophaga sputigena	1019	S	521	66	587	0.00065
ERR6913276	Capnocytophaga sp. FDAARGOS_737	2545799	S	152	34	186	0.00020
ERR6913276	Capnocytophaga sp. oral taxon 878	1316596	S	86	9	95	0.00010
ERR6913276	Capnocytophaga sp. oral taxon 864	1316593	S	23	21	44	0.00005
ERR6913276	Capnocytophaga sp. oral taxon 323	1705617	S	13	13	26	0.00003
ERR6913276	Capnocytophaga sp. oral taxon 902	2748316	S	6	9	15	0.00002
ERR6913276	Capnocytophaga endodontalis	2708117	S	143	24	167	0.00018
ERR6913276	Capnocytophaga leadbetteri	327575	S	117	24	141	0.00016
ERR6913276	Capnocytophaga ochracea	1018	S	103	73	176	0.00019
ERR6913276	Capnocytophaga haemolytica	45243	S	17	0	17	0.00002
ERR6913276	Capnocytophaga canimorsus	28188	S	5	0	5	0.00001
ERR6913276	Flavobacterium sp. IMCC36792	3016339	S	87	26	113	0.00012
ERR6913276	Flavobacterium sp. N2013	2986828	S	58	22	80	0.00009
ERR6913276	Flavobacterium sp. 140616W15	2478552	S	54	16	70	0.00008
ERR6913276	Flavobacterium sp. IMCC36793	3003263	S	41	11	52	0.00006
ERR6913276	Flavobacterium sp. IMCC36791	3003262	S	39	8	47	0.00005
ERR6913276	Flavobacterium sp. I3-2	2748319	S	37	15	52	0.00006
ERR6913276	Flavobacterium sp. N2820	2986834	S	31	10	41	0.00005
ERR6913276	Flavobacterium sp. F-70	2893884	S	27	11	38	0.00004
ERR6913276	Flavobacterium sp. IMCC34518	3003623	S	26	8	34	0.00004
ERR6913276	Flavobacterium sp. N1994	2986827	S	22	3	25	0.00003
ERR6913276	Flavobacterium sp. CJ74	2294119	S	20	1	21	0.00002
ERR6913276	Flavobacterium sp. Sr18	935222	S	19	5	24	0.00003
ERR6913276	Flavobacterium sp. IMCC34775	3003258	S	18	6	24	0.00003
ERR6913276	Flavobacterium sp. M31R6	2739062	S	17	6	23	0.00003
ERR6913276	Flavobacterium sp. F-340	2893886	S	15	5	20	0.00002
ERR6913276	Flavobacterium sp. CHNK8	2871165	S	15	32	47	0.00005
ERR6913276	Flavobacterium sp. K5-23	2746225	S	14	4	18	0.00002
ERR6913276	Flavobacterium sp. F-29	2893883	S	14	4	18	0.00002
ERR6913276	Flavobacterium sp. CLA17	2724135	S	13	5	18	0.00002
ERR6913276	Flavobacterium sp. N3904	2986835	S	13	4	17	0.00002
ERR6913276	Flavobacterium sp. IMCC34774	3003257	S	13	2	15	0.00002
ERR6913276	Flavobacterium sp. N2270	2986831	S	13	4	17	0.00002
ERR6913276	Flavobacterium sp. CC-SYL302	2870839	S	12	3	15	0.00002
ERR6913276	Flavobacterium sp. KBS0721	1179672	S	12	11	23	0.00003
ERR6913276	Flavobacterium sp. CECT 9288	2845819	S	10	20	30	0.00003
ERR6913276	Flavobacterium sp. N502536	2986837	S	9	11	20	0.00002
ERR6913276	Flavobacterium sp. LPB0248	2614441	S	9	15	24	0.00003
ERR6913276	Flavobacterium sp. F-323	2893885	S	9	3	12	0.00001
ERR6913276	Flavobacterium sp. MFBS3-15	2989816	S	9	0	9	0.00001
ERR6913276	Flavobacterium sp. CS20	2775246	S	9	2	11	0.00001
ERR6913276	Flavobacterium sp. SLB02	2665645	S	9	9	18	0.00002
ERR6913276	Flavobacterium sp. MDT1-60	1979344	S	8	4	12	0.00001
ERR6913276	Flavobacterium sp. KACC 22763	3025668	S	8	30	38	0.00004
ERR6913276	Flavobacterium sp. MMS21-Er5	2937442	S	7	8	15	0.00002
ERR6913276	Flavobacterium sp. N1736	2986823	S	7	4	11	0.00001
ERR6913276	Flavobacterium sp. N2038	2986829	S	6	4	10	0.00001
ERR6913276	Flavobacterium sp. TR2	2977321	S	6	7	13	0.00001
ERR6913276	Flavobacterium sp. N1846	2986824	S	5	1	6	0.00001
ERR6913276	Flavobacterium sp. xlx-214	2654325	S	5	0	5	0.00001
ERR6913276	Flavobacterium ammoniigenes	1751095	S	70	31	101	0.00011
ERR6913276	Flavobacterium ammonificans	1751056	S	59	28	87	0.00010
ERR6913276	Flavobacterium cyclinae	2895947	S	56	35	91	0.00010
ERR6913276	Flavobacterium channae	2897181	S	50	38	88	0.00010
ERR6913276	Flavobacterium nackdongense	2547394	S	34	5	39	0.00004
ERR6913276	Flavobacterium sangjuense	2518177	S	33	5	38	0.00004
ERR6913276	Flavobacterium branchiophilum	55197	S	22	2	24	0.00003
ERR6913276	Flavobacterium psychrophilum	96345	S	21	4	25	0.00003
ERR6913276	Flavobacterium haoranii	683124	S	18	12	30	0.00003
ERR6913276	Flavobacterium bizetiae	2704140	S	17	20	37	0.00004
ERR6913276	Flavobacterium azooxidireducens	1871076	S	17	1	18	0.00002
ERR6913276	Flavobacterium album	2175091	S	15	1	16	0.00002
ERR6913276	Flavobacterium faecale	1355330	S	15	2	17	0.00002
ERR6913276	Flavobacterium kingsejongi	1678728	S	15	4	19	0.00002
ERR6913276	Flavobacterium columnare	996	S	13	28	41	0.00005
ERR6913276	Flavobacterium commune	1306519	S	13	3	16	0.00002
ERR6913276	Flavobacterium gilvum	1492737	S	12	2	14	0.00002
ERR6913276	Flavobacterium covae	2906076	S	12	31	43	0.00005
ERR6913276	Flavobacterium oreochromis	2906078	S	9	4	13	0.00001
ERR6913276	Flavobacterium magnum	2162713	S	7	0	7	0.00001
ERR6913276	Flavobacterium davisii	2906077	S	7	3	10	0.00001
ERR6913276	Flavobacterium alkalisoli	2602769	S	7	0	7	0.00001
ERR6913276	Flavobacterium fluviale	2249356	S	6	6	12	0.00001
ERR6913276	Flavobacterium inviolabile	2748320	S	6	1	7	0.00001
ERR6913276	Flavobacterium crassostreae	1763534	S	5	1	6	0.00001
ERR6913276	Flavobacterium johnsoniae	986	S	5	27	32	0.00004
ERR6913276	Flavobacterium crocinum	2183896	S	5	4	9	0.00001
ERR6913276	Flavobacterium sediminis	2201181	S	5	1	6	0.00001
ERR6913276	Flavobacterium anhuiense	459526	S	5	7	12	0.00001
ERR6913276	Polaribacter sp. MED152	313598	S	10	6	16	0.00002
ERR6913276	Polaribacter sp. ALD11	2058137	S	9	6	15	0.00002
ERR6913276	Polaribacter sp. Hel1_33_78	1336804	S	6	2	8	0.00001
ERR6913276	Polaribacter sp. SA4-10	754397	S	5	3	8	0.00001
ERR6913276	Polaribacter reichenbachii	996801	S	5	2	7	0.00001
ERR6913276	Polaribacter batillariae	2808900	S	5	2	7	0.00001
ERR6913276	Polaribacter cellanae	2818493	S	5	3	8	0.00001
ERR6913276	Tenacibaculum sp. SZ-18	754423	S	10	11	21	0.00002
ERR6913276	Tenacibaculum jejuense	584609	S	11	1	12	0.00001
ERR6913276	Tenacibaculum ovolyticum	104270	S	7	1	8	0.00001
ERR6913276	Tenacibaculum finnmarkense	2781243	S	7	19	26	0.00003
ERR6913276	Tenacibaculum maritimum	107401	S	6	0	6	0.00001
ERR6913276	Tenacibaculum mesophilum	104268	S	5	2	7	0.00001
ERR6913276	Myroides sp. SCSIO 72103	2968490	S	13	76	89	0.00010
ERR6913276	Myroides sp. A21	1583100	S	5	9	14	0.00002
ERR6913276	Myroides odoratus	256	S	14	1	15	0.00002
ERR6913276	Myroides phaeus	702745	S	6	1	7	0.00001
ERR6913276	Myroides albus	2562892	S	5	1	6	0.00001
ERR6913276	Winogradskyella sp. J14-2	1936080	S	8	1	9	0.00001
ERR6913276	Winogradskyella sp. PC-19	754417	S	7	2	9	0.00001
ERR6913276	Winogradskyella sp. HaHa_3_26	2749995	S	5	2	7	0.00001
ERR6913276	Winogradskyella sediminis	1382466	S	11	3	14	0.00002
ERR6913276	Winogradskyella forsetii	2686077	S	7	1	8	0.00001
ERR6913276	Aquimarina sp. BL5	1714860	S	9	1	10	0.00001
ERR6913276	Aquimarina sp. ERC-38	2949996	S	9	0	9	0.00001
ERR6913276	Aquimarina sp. AD10	1714849	S	8	0	8	0.00001
ERR6913276	Aquimarina sp. TRL1	2736252	S	5	0	5	0.00001
ERR6913276	Gramella fulva	2126553	S	12	1	13	0.00001
ERR6913276	Gramella forsetii	411153	S	5	0	5	0.00001
ERR6913276	Gramella flava	1486245	S	5	1	6	0.00001
ERR6913276	Gramella salexigens	1913577	S	5	0	5	0.00001
ERR6913276	Formosa sediminum	2594004	S	13	2	15	0.00002
ERR6913276	Formosa sp. Hel3_A1_48	1336795	S	9	1	10	0.00001
ERR6913276	Formosa agariphila	320324	S	6	1	7	0.00001
ERR6913276	Muricauda sp. SCSIO 65647	2908843	S	8	0	8	0.00001
ERR6913276	Muricauda oceani	2698672	S	8	3	11	0.00001
ERR6913276	Muricauda aquimarina	254955	S	6	2	8	0.00001
ERR6913276	Lacinutrix sp. Bg11-31	2057808	S	7	2	9	0.00001
ERR6913276	Lacinutrix sp. WUR7	2653681	S	5	1	6	0.00001
ERR6913276	Lacinutrix sp. HL-RS19	2980107	S	5	1	6	0.00001
ERR6913276	Lacinutrix venerupis	1486034	S	5	1	6	0.00001
ERR6913276	Maribacter hydrothermalis	1836467	S	8	0	8	0.00001
ERR6913276	Maribacter sp. Hal144	2980554	S	5	0	5	0.00001
ERR6913276	Maribacter cobaltidurans	1178778	S	5	3	8	0.00001
ERR6913276	Antarcticibacterium sp. 1MA-6-2	2908210	S	11	1	12	0.00001
ERR6913276	Antarcticibacterium flavum	2058175	S	8	1	9	0.00001
ERR6913276	Tamlana carrageenivorans	2069432	S	8	10	18	0.00002
ERR6913276	Lutibacter sp. A80	2918453	S	7	4	11	0.00001
ERR6913276	Flavivirga eckloniae	1803846	S	15	1	16	0.00002
ERR6913276	Cellulophaga baltica	76594	S	5	4	9	0.00001
ERR6913276	Psychroflexus sp. ALD_RP9	2777186	S	7	0	7	0.00001
ERR6913276	Psychroflexus torquis	57029	S	6	0	6	0.00001
ERR6913276	Olleya aquimaris	639310	S	7	3	10	0.00001
ERR6913276	Kordia antarctica	1218801	S	7	0	7	0.00001
ERR6913276	Kordia sp. SMS9	2282170	S	6	0	6	0.00001
ERR6913276	Amniculibacterium sp. G2-70	2767188	S	11	2	13	0.00001
ERR6913276	Aequorivita sp. H23M31	2494375	S	6	1	7	0.00001
ERR6913276	Galbibacter sp. BG1	1170699	S	11	0	11	0.00001
ERR6913276	Robiginitalea biformata	252307	S	10	0	10	0.00001
ERR6913276	Salegentibacter mishustinae	270918	S	6	4	10	0.00001
ERR6913276	Siansivirga zeaxanthinifaciens	762954	S	8	2	10	0.00001
ERR6913276	Wenyingzhuangia fucanilytica	1790137	S	8	1	9	0.00001
ERR6913276	Aureibaculum algae	2584122	S	8	0	8	0.00001
ERR6913276	Costertonia aggregata	343403	S	8	1	9	0.00001
ERR6913276	Sinomicrobium kalidii	2900738	S	7	0	7	0.00001
ERR6913276	Flagellimonas sp. CMM7	2654676	S	5	0	5	0.00001
ERR6913276	Salinimicrobium sp. HN-2-9-2	2809707	S	6	0	6	0.00001
ERR6913276	Algibacter sp. L3A6	2686366	S	5	1	6	0.00001
ERR6913276	Urechidicola croceus	1850246	S	5	2	7	0.00001
ERR6913276	Abyssalbus ytuae	2926907	S	5	0	5	0.00001
ERR6913276	Chryseobacterium manosquense	2754694	S	542	216	758	0.00083
ERR6913276	Chryseobacterium sp. KACC 21268	3025664	S	30	1	31	0.00003
ERR6913276	Chryseobacterium sp. 6424	2039166	S	19	2	21	0.00002
ERR6913276	Chryseobacterium sp. Y16C	2920939	S	14	4	18	0.00002
ERR6913276	Chryseobacterium sp. MMS21-Ot14	2983606	S	11	0	11	0.00001
ERR6913276	Chryseobacterium sp. 3008163	2478663	S	10	2	12	0.00001
ERR6913276	Chryseobacterium sp. IHB B 17019	1721091	S	9	0	9	0.00001
ERR6913276	Chryseobacterium sp. SNU WT5	2594269	S	9	1	10	0.00001
ERR6913276	Chryseobacterium sp. MEBOG06	2879938	S	9	1	10	0.00001
ERR6913276	Chryseobacterium sp. PCH239	2825845	S	8	4	12	0.00001
ERR6913276	Chryseobacterium sp. T16E-39	2015076	S	7	0	7	0.00001
ERR6913276	Chryseobacterium sp. MEBOG07	2879939	S	7	1	8	0.00001
ERR6913276	Chryseobacterium sp. D764	2856522	S	7	27	34	0.00004
ERR6913276	Chryseobacterium sp. G0201	2487065	S	6	1	7	0.00001
ERR6913276	Chryseobacterium sp. StRB126	878220	S	6	1	7	0.00001
ERR6913276	Chryseobacterium sp. ZHDP1	2838877	S	6	3	9	0.00001
ERR6913276	Chryseobacterium sp. CY350	2997336	S	5	0	5	0.00001
ERR6913276	Chryseobacterium indoltheticum	254	S	64	11	75	0.00008
ERR6913276	Chryseobacterium capnotolerans	2759528	S	61	14	75	0.00008
ERR6913276	Chryseobacterium indologenes	253	S	37	9	46	0.00005
ERR6913276	Chryseobacterium balustinum	246	S	32	7	39	0.00004
ERR6913276	Chryseobacterium aureum	2497456	S	29	4	33	0.00004
ERR6913276	Chryseobacterium camelliae	1265445	S	21	3	24	0.00003
ERR6913276	Chryseobacterium gambrini	373672	S	17	5	22	0.00002
ERR6913276	Chryseobacterium taklimakanense	536441	S	16	4	20	0.00002
ERR6913276	Chryseobacterium carnipullorum	1124835	S	16	3	19	0.00002
ERR6913276	Chryseobacterium gallinarum	1324352	S	16	2	18	0.00002
ERR6913276	Chryseobacterium piperi	558152	S	13	0	13	0.00001
ERR6913276	Chryseobacterium shandongense	1493872	S	12	3	15	0.00002
ERR6913276	Chryseobacterium salivictor	2547600	S	11	0	11	0.00001
ERR6913276	Chryseobacterium oryzae	2929799	S	11	1	12	0.00001
ERR6913276	Chryseobacterium suipulveris	2929800	S	11	1	12	0.00001
ERR6913276	Chryseobacterium lactis	1241981	S	8	2	10	0.00001
ERR6913276	Chryseobacterium oranimense	421058	S	8	0	8	0.00001
ERR6913276	Chryseobacterium bernardetii	1241978	S	7	33	40	0.00004
ERR6913276	Chryseobacterium turcicum	2898076	S	6	1	7	0.00001
ERR6913276	Chryseobacterium daecheongense	192389	S	6	0	6	0.00001
ERR6913276	Chryseobacterium arthrosphaerae	651561	S	6	1	7	0.00001
ERR6913276	Chryseobacterium paludis	2956784	S	5	0	5	0.00001
ERR6913276	Epilithonimonas vandammei	2487072	S	346	167	513	0.00056
ERR6913276	Epilithonimonas zeae	1416779	S	25	1	26	0.00003
ERR6913276	Kaistella sp. BT6-1-3	2989820	S	60	20	80	0.00009
ERR6913276	Kaistella sp. GW4-15	2878534	S	19	2	21	0.00002
ERR6913276	Kaistella sp. 97-N-M2	2908645	S	7	0	7	0.00001
ERR6913276	Kaistella daneshvariae	2487074	S	73	5	78	0.00009
ERR6913276	Kaistella carnis	1241979	S	20	5	25	0.00003
ERR6913276	Kaistella jeonii	266749	S	16	1	17	0.00002
ERR6913276	Kaistella flava (ex Peng et al. 2021)	2038776	S	11	1	12	0.00001
ERR6913276	Candidatus Kaistella beijingensis	2820270	S	10	1	11	0.00001
ERR6913276	Empedobacter falsenii	343874	S	404	82	486	0.00053
ERR6913276	Empedobacter stercoris	1628248	S	46	7	53	0.00006
ERR6913276	Empedobacter brevis	247	S	21	2	23	0.00003
ERR6913276	Cloacibacterium caeni	2004710	S	206	108	314	0.00035
ERR6913276	Cloacibacterium normanense	237258	S	73	31	104	0.00011
ERR6913276	Cloacibacterium sp. TD35	2976818	S	47	9	56	0.00006
ERR6913276	Elizabethkingia anophelis	1117645	S	14	8	22	0.00002
ERR6913276	Elizabethkingia bruuniana	1756149	S	11	19	30	0.00003
ERR6913276	Elizabethkingia sp. JS20170427COW	2583851	S	5	0	5	0.00001
ERR6913276	Elizabethkingia miricola	172045	S	6	3	9	0.00001
ERR6913276	Bergeyella cardium	1585976	S	54	2	56	0.00006
ERR6913276	Cruoricaptor ignavus	1118202	S	17	1	18	0.00002
ERR6913276	Ornithobacterium rhinotracheale	28251	S	15	3	18	0.00002
ERR6913276	Riemerella anatipestifer	34085	S	14	1	15	0.00002
ERR6913276	Weeksella virosa	1014	S	11	1	12	0.00001
ERR6913276	Faecalibacter bovis	2898187	S	5	0	5	0.00001
ERR6913276	Fluviicola taffensis	191579	S	91	2	93	0.00010
ERR6913276	Croceimicrobium hydrocarbonivorans	2761580	S	8	72	80	0.00009
ERR6913276	Blattabacterium cuenoti	1653831	S	35	11	46	0.00005
ERR6913276	Blattabacterium sp. (Blattella germanica)	624186	S	5	4	9	0.00001
ERR6913276	Candidatus Karelsulcia muelleri	336810	S	45	4	49	0.00005
ERR6913276	Ichthyobacterium seriolicida	242600	S	15	0	15	0.00002
ERR6913276	Parvicella tangerina	2829795	S	6	0	6	0.00001
ERR6913276	Prevotella melaninogenica	28132	S	937	93	1030	0.00113
ERR6913276	Prevotella nigrescens	28133	S	812	108	920	0.00101
ERR6913276	Prevotella oris	28135	S	388	12	400	0.00044
ERR6913276	Prevotella sp. oral taxon 475	712471	S	147	5	152	0.00017
ERR6913276	Prevotella sp. oral taxon 299	652716	S	112	3	115	0.00013
ERR6913276	Prevotella sp. Rep29	2691580	S	14	1	15	0.00002
ERR6913276	Prevotella sp. E15-22	2937774	S	10	10	20	0.00002
ERR6913276	Prevotella sp. E13-17	2913616	S	8	4	12	0.00001
ERR6913276	Prevotella sp. E9-3	2913621	S	8	4	12	0.00001
ERR6913276	Prevotella sp. E2-28	2913620	S	6	4	10	0.00001
ERR6913276	Prevotella intermedia	28131	S	182	28	210	0.00023
ERR6913276	Prevotella histicola	470565	S	162	5	167	0.00018
ERR6913276	Prevotella denticola	28129	S	144	1131	1275	0.00140
ERR6913276	Prevotella jejuni	1177574	S	132	11	143	0.00016
ERR6913276	Prevotella veroralis	28137	S	78	4	82	0.00009
ERR6913276	Prevotella copri	165179	S	76	5	81	0.00009
ERR6913276	Prevotella corporis	28128	S	68	10	78	0.00009
ERR6913276	Prevotella herbatica	2801997	S	30	0	30	0.00003
ERR6913276	Prevotella dentalis	52227	S	26	1	27	0.00003
ERR6913276	Prevotella fusca	589436	S	20	1	21	0.00002
ERR6913276	Prevotella scopos	589437	S	15	1	16	0.00002
ERR6913276	Prevotella multiformis	282402	S	12	1	13	0.00001
ERR6913276	Prevotella ruminicola	839	S	9	0	9	0.00001
ERR6913276	Prevotella bryantii	77095	S	6	0	6	0.00001
ERR6913276	Hoylesella buccalis	28127	S	140	35	175	0.00019
ERR6913276	Hoylesella enoeca	76123	S	65	5	70	0.00008
ERR6913276	Pseudoprevotella muciniphila	2133944	S	63	0	63	0.00007
ERR6913276	Paraprevotella xylaniphila	454155	S	26	5	31	0.00003
ERR6913276	Bacteroides uniformis	820	S	47	73	120	0.00013
ERR6913276	Bacteroides xylanisolvens	371601	S	27	53	80	0.00009
ERR6913276	Bacteroides cellulosilyticus	246787	S	26	19	45	0.00005
ERR6913276	Bacteroides thetaiotaomicron	818	S	25	7	32	0.00004
ERR6913276	Bacteroides caccae	47678	S	20	5	25	0.00003
ERR6913276	Bacteroides stercoris	46506	S	19	7	26	0.00003
ERR6913276	Bacteroides salyersiae	291644	S	18	3	21	0.00002
ERR6913276	Bacteroides fragilis	817	S	16	17	33	0.00004
ERR6913276	Bacteroides heparinolyticus	28113	S	16	2	18	0.00002
ERR6913276	Bacteroides ovatus	28116	S	15	54	69	0.00008
ERR6913276	Bacteroides eggerthii	28111	S	10	3	13	0.00001
ERR6913276	Bacteroides zoogleoformans	28119	S	9	3	12	0.00001
ERR6913276	Bacteroides zhangwenhongii	2650157	S	9	2	11	0.00001
ERR6913276	Bacteroides helcogenes	290053	S	8	0	8	0.00001
ERR6913276	Bacteroides nordii	291645	S	8	1	9	0.00001
ERR6913276	Phocaeicola vulgatus	821	S	182	158	340	0.00037
ERR6913276	Phocaeicola coprophilus	387090	S	17	3	20	0.00002
ERR6913276	Phocaeicola dorei	357276	S	16	14	30	0.00003
ERR6913276	Phocaeicola salanitronis	376805	S	12	1	13	0.00001
ERR6913276	Porphyromonas endodontalis	28124	S	287	16	303	0.00033
ERR6913276	Porphyromonas sp. oral taxon 275	712435	S	192	6	198	0.00022
ERR6913276	Porphyromonas somerae	322095	S	65	9	74	0.00008
ERR6913276	Porphyromonas gingivalis	837	S	60	7	67	0.00007
ERR6913276	Porphyromonas asaccharolytica	28123	S	60	5	65	0.00007
ERR6913276	Porphyromonas cangingivalis	36874	S	8	0	8	0.00001
ERR6913276	Tannerella serpentiformis	712710	S	240	8	248	0.00027
ERR6913276	Tannerella forsythia	28112	S	45	7	52	0.00006
ERR6913276	Parabacteroides distasonis	823	S	25	81	106	0.00012
ERR6913276	Parabacteroides merdae	46503	S	23	6	29	0.00003
ERR6913276	Alistipes communis	2585118	S	57	16	73	0.00008
ERR6913276	Alistipes megaguti	2364787	S	14	1	15	0.00002
ERR6913276	Alistipes shahii	328814	S	10	8	18	0.00002
ERR6913276	Alistipes finegoldii	214856	S	8	5	13	0.00001
ERR6913276	Alistipes onderdonkii	328813	S	7	4	11	0.00001
ERR6913276	Duncaniella dubosii	2518971	S	7	2	9	0.00001
ERR6913276	Muribaculum intestinale	1796646	S	11	0	11	0.00001
ERR6913276	Sodaliphilus pleomorphus	2606626	S	6	0	6	0.00001
ERR6913276	Odoribacter splanchnicus	28118	S	28	1	29	0.00003
ERR6913276	Paludibacter propionicigenes	185300	S	25	0	25	0.00003
ERR6913276	Salinivirga cyanobacteriivorans	1307839	S	14	0	14	0.00002
ERR6913276	Barnesiella viscericola	397865	S	7	1	8	0.00001
ERR6913276	Coprobacter secundus	1501392	S	5	1	6	0.00001
ERR6913276	Candidatus Azobacteroides pseudotrichonymphae	511435	S	10	0	10	0.00001
ERR6913276	Tenuifilum thalassicum	2590900	S	6	0	6	0.00001
ERR6913276	Alkalitalea saponilacus	889453	S	74	8	82	0.00009
ERR6913276	Alkaliflexus sp. Ai-910	2949635	S	12	1	13	0.00001
ERR6913276	Hymenobacter sp. 5317J-9	2932250	S	36	22	58	0.00006
ERR6913276	Hymenobacter sp. YIM 151858-1	2987688	S	26	16	42	0.00005
ERR6913276	Hymenobacter sp. PAMC 26628	1484118	S	24	15	39	0.00004
ERR6913276	Hymenobacter sp. NBH84	2596915	S	17	6	23	0.00003
ERR6913276	Hymenobacter sp. BRD128	2675878	S	17	6	23	0.00003
ERR6913276	Hymenobacter sp. YIM 151500-1	2987689	S	16	6	22	0.00002
ERR6913276	Hymenobacter sp. S2-20-2	2761579	S	14	6	20	0.00002
ERR6913276	Hymenobacter sp. DG01	2584940	S	10	7	17	0.00002
ERR6913276	Hymenobacter sp. 5116S-3	2932248	S	10	4	14	0.00002
ERR6913276	Hymenobacter sp. BT18	2835648	S	10	3	13	0.00001
ERR6913276	Hymenobacter sp. PAMC 29467	2999067	S	9	13	22	0.00002
ERR6913276	Hymenobacter sp. BRD67	2675877	S	8	14	22	0.00002
ERR6913276	Hymenobacter sp. 5413J-13	2932251	S	8	3	11	0.00001
ERR6913276	Hymenobacter sp. 5420S-77	2932254	S	6	1	7	0.00001
ERR6913276	Hymenobacter monticola	1705399	S	42	19	61	0.00007
ERR6913276	Hymenobacter sedentarius	1411621	S	35	14	49	0.00005
ERR6913276	Hymenobacter jejuensis	2502781	S	14	2	16	0.00002
ERR6913276	Hymenobacter psoromatis	1484116	S	10	3	13	0.00001
ERR6913276	Hymenobacter qilianensis	1385715	S	8	3	11	0.00001
ERR6913276	Hymenobacter tibetensis	497967	S	7	2	9	0.00001
ERR6913276	Hymenobacter nivis	1850093	S	7	4	11	0.00001
ERR6913276	Hymenobacter yonginensis	748197	S	6	18	24	0.00003
ERR6913276	Hymenobacter swuensis	1446467	S	6	3	9	0.00001
ERR6913276	Hymenobacter oligotrophus	2319843	S	6	3	9	0.00001
ERR6913276	Pontibacter russatus	2694929	S	20	5	25	0.00003
ERR6913276	Pontibacter akesuensis	388950	S	11	3	14	0.00002
ERR6913276	Pontibacter actiniarum	323450	S	8	5	13	0.00001
ERR6913276	Pontibacter sp. SGAir0037	2571030	S	6	2	8	0.00001
ERR6913276	Adhaeribacter swui	2086471	S	12	3	15	0.00002
ERR6913276	Adhaeribacter radiodurans	2745197	S	9	2	11	0.00001
ERR6913276	Rufibacter radiotolerans	1379910	S	9	3	12	0.00001
ERR6913276	Rufibacter tibetensis	512763	S	7	2	9	0.00001
ERR6913276	Rufibacter sp. DG15C	1379909	S	5	5	10	0.00001
ERR6913276	Aquirufa antheringensis	2516559	S	37	70	107	0.00012
ERR6913276	Aquirufa lenticrescens	2696560	S	36	67	103	0.00011
ERR6913276	Aquirufa nivalisilvae	2516557	S	7	2	9	0.00001
ERR6913276	Spirosoma sp. KCTC 72228	2710596	S	11	3	14	0.00002
ERR6913276	Spirosoma sp. KCTC 42546	2520506	S	8	2	10	0.00001
ERR6913276	Spirosoma pollinicola	2057025	S	22	6	28	0.00003
ERR6913276	Spirosoma rigui	564064	S	19	6	25	0.00003
ERR6913276	Spirosoma rhododendri	2728024	S	18	6	24	0.00003
ERR6913276	Spirosoma taeanense	2735870	S	17	7	24	0.00003
ERR6913276	Spirosoma radiotolerans	1379870	S	14	5	19	0.00002
ERR6913276	Spirosoma montaniterrae	1178516	S	9	2	11	0.00001
ERR6913276	Spirosoma endbachense	2666025	S	7	29	36	0.00004
ERR6913276	Spirosoma aerolatum	1211326	S	6	1	7	0.00001
ERR6913276	Cytophaga hutchinsonii	985	S	29	4	33	0.00004
ERR6913276	Rhodocytophaga rosea	2704465	S	20	1	21	0.00002
ERR6913276	Tellurirhabdus rosea	2674997	S	5	3	8	0.00001
ERR6913276	Dyadobacter fermentans	94254	S	52	20	72	0.00008
ERR6913276	Dyadobacter sp. U1	2910158	S	18	6	24	0.00003
ERR6913276	Dyadobacter sp. CY22	2909339	S	11	9	20	0.00002
ERR6913276	Dyadobacter sp. NIV53	2861765	S	7	1	8	0.00001
ERR6913276	Dyadobacter sandarakinus	2747268	S	6	2	8	0.00001
ERR6913276	Emticicia sp. 21SJ11W-3	2916755	S	61	10	71	0.00008
ERR6913276	Runella sp. SP2	2268026	S	27	8	35	0.00004
ERR6913276	Runella slithyformis	106	S	6	8	14	0.00002
ERR6913276	Runella rosea	2259595	S	6	8	14	0.00002
ERR6913276	Larkinella insperata	332158	S	13	4	17	0.00002
ERR6913276	Larkinella sp. IE-0392	2907205	S	13	5	18	0.00002
ERR6913276	Fibrella sp. ES10-3-2-2	1834519	S	12	3	15	0.00002
ERR6913276	Fibrella aestuarina	651143	S	7	3	10	0.00001
ERR6913276	Arcticibacterium luteifluviistationis	1784714	S	15	2	17	0.00002
ERR6913276	Marinilongibacter aquaticus	2975157	S	6	1	7	0.00001
ERR6913276	Leadbetterella byssophila	316068	S	5	2	7	0.00001
ERR6913276	Algoriphagus sp. Y33	2772483	S	7	7	14	0.00002
ERR6913276	Algoriphagus machipongonensis	388413	S	7	2	9	0.00001
ERR6913276	Algoriphagus sanaruensis	1727163	S	6	1	7	0.00001
ERR6913276	Echinicola marina	2859768	S	7	20	27	0.00003
ERR6913276	Mongoliitalea daihaiensis	2782006	S	15	4	19	0.00002
ERR6913276	Cyclobacterium amurskyense	320787	S	6	2	8	0.00001
ERR6913276	Fulvivirga sp. W9P-11	2904246	S	20	3	23	0.00003
ERR6913276	Fulvivirga sp. SW1-E11	2904247	S	7	1	8	0.00001
ERR6913276	Fulvivirga sp. SS9-22	2904245	S	5	0	5	0.00001
ERR6913276	Fulvivirga lutea	2810512	S	9	2	11	0.00001
ERR6913276	Chryseolinea soli	2321403	S	7	0	7	0.00001
ERR6913276	Flammeovirga pectinis	2494373	S	14	19	33	0.00004
ERR6913276	Persicobacter sp. JZB09	1085624	S	27	3	30	0.00003
ERR6913276	Reichenbachiella sp. Wsw4-B4	2979869	S	9	2	11	0.00001
ERR6913276	Reichenbachiella sp. BKB1-1	2979464	S	8	2	10	0.00001
ERR6913276	Cardinium endosymbiont of Sogatella furcifera	650378	S	12	1	13	0.00001
ERR6913276	Bernardetia litoralis	999	S	17	1	18	0.00002
ERR6913276	Mangrovivirga cuniculi	2715131	S	13	2	15	0.00002
ERR6913276	Marivirga tractuosa	1006	S	6	4	10	0.00001
ERR6913276	Sphingobacterium daejeonense	371142	S	601	83	684	0.00075
ERR6913276	Sphingobacterium sp. UDSM-2020	2795738	S	21	2	23	0.00003
ERR6913276	Sphingobacterium sp. DR205	2713573	S	20	1	21	0.00002
ERR6913276	Sphingobacterium sp. SYP-B4668	2996035	S	15	1	16	0.00002
ERR6913276	Sphingobacterium sp. LZ7M1	2961941	S	14	4	18	0.00002
ERR6913276	Sphingobacterium sp. G1-14	2003121	S	12	32	44	0.00005
ERR6913276	Sphingobacterium sp. KACC 22765	3025669	S	12	0	12	0.00001
ERR6913276	Sphingobacterium sp. ML3W	1538644	S	10	1	11	0.00001
ERR6913276	Sphingobacterium sp. SRCM116780	2907623	S	9	0	9	0.00001
ERR6913276	Sphingobacterium sp. dk4302	2662364	S	8	4	12	0.00001
ERR6913276	Sphingobacterium sp. CZ-2	2557994	S	5	0	5	0.00001
ERR6913276	Sphingobacterium sp. E70	2853439	S	5	0	5	0.00001
ERR6913276	Sphingobacterium multivorum	28454	S	133	137	270	0.00030
ERR6913276	Sphingobacterium lactis	797291	S	119	32	151	0.00017
ERR6913276	Sphingobacterium psychroaquaticum	561061	S	20	1	21	0.00002
ERR6913276	Sphingobacterium hotanense	649196	S	18	2	20	0.00002
ERR6913276	Sphingobacterium mizutaii	1010	S	13	1	14	0.00002
ERR6913276	Sphingobacterium faecium	34087	S	13	20	33	0.00004
ERR6913276	Sphingobacterium spiritivorum	258	S	11	2	13	0.00001
ERR6913276	Sphingobacterium thalpophilum	259	S	11	3	14	0.00002
ERR6913276	Sphingobacterium siyangense	459529	S	8	25	33	0.00004
ERR6913276	Mucilaginibacter paludis	423351	S	68	2	70	0.00008
ERR6913276	Mucilaginibacter sp. 14171R-50	2703789	S	15	0	15	0.00002
ERR6913276	Mucilaginibacter sp. 21P	2778902	S	15	0	15	0.00002
ERR6913276	Mucilaginibacter sp. KACC 22063	3025666	S	9	0	9	0.00001
ERR6913276	Mucilaginibacter sp. SMC90	2929803	S	5	0	5	0.00001
ERR6913276	Mucilaginibacter gotjawali	1550579	S	13	0	13	0.00001
ERR6913276	Mucilaginibacter xinganensis	1234841	S	9	0	9	0.00001
ERR6913276	Mucilaginibacter rubeus	2027860	S	8	44	52	0.00006
ERR6913276	Mucilaginibacter robiniae	2728022	S	8	0	8	0.00001
ERR6913276	Mucilaginibacter gossypii	551996	S	7	14	21	0.00002
ERR6913276	Mucilaginibacter mali	2740462	S	7	0	7	0.00001
ERR6913276	Mucilaginibacter celer	2305508	S	6	0	6	0.00001
ERR6913276	Mucilaginibacter ginsenosidivorans	398053	S	5	0	5	0.00001
ERR6913276	Mucilaginibacter mallensis	652787	S	5	0	5	0.00001
ERR6913276	Mucilaginibacter ginkgonis	2682091	S	5	0	5	0.00001
ERR6913276	Pedobacter sp. SL55	2995161	S	26	3	29	0.00003
ERR6913276	Pedobacter sp. HDW13	2714940	S	14	7	21	0.00002
ERR6913276	Pedobacter sp. G11	2482728	S	13	5	18	0.00002
ERR6913276	Pedobacter sp. PACM 27299	1727164	S	6	1	7	0.00001
ERR6913276	Pedobacter heparinus	984	S	13	2	15	0.00002
ERR6913276	Pedobacter roseus	336820	S	13	13	26	0.00003
ERR6913276	Pedobacter ginsengisoli	363852	S	13	2	15	0.00002
ERR6913276	Pedobacter endophyticus	2789740	S	12	2	14	0.00002
ERR6913276	Pedobacter mucosus	2895286	S	12	2	14	0.00002
ERR6913276	Pedobacter cryoconitis	188932	S	9	1	10	0.00001
ERR6913276	Pedobacter schmidteae	2201271	S	7	1	8	0.00001
ERR6913276	Pedobacter suwonensis	332999	S	5	3	8	0.00001
ERR6913276	Pedobacter riviphilus	2766984	S	5	4	9	0.00001
ERR6913276	Olivibacter sp. LS-1	2592345	S	14	0	14	0.00002
ERR6913276	Olivibacter sp. SDN3	2764720	S	6	0	6	0.00001
ERR6913276	Solitalea sp. S2-8	2911172	S	8	7	15	0.00002
ERR6913276	Anseongella ginsenosidimutans	496056	S	8	0	8	0.00001
ERR6913276	Arachidicoccus sp. B3-10	2545455	S	128	20	148	0.00016
ERR6913276	Arachidicoccus sp. BS20	1850526	S	14	2	16	0.00002
ERR6913276	Arachidicoccus ginsenosidivorans	496057	S	15	5	20	0.00002
ERR6913276	Arachidicoccus soli	2341117	S	9	2	11	0.00001
ERR6913276	Arachidicoccus terrestris	2875539	S	9	3	12	0.00001
ERR6913276	Chitinophaga sp. HK235	2952571	S	11	18	29	0.00003
ERR6913276	Chitinophaga sp. XS-30	2604421	S	7	12	19	0.00002
ERR6913276	Chitinophaga sp. R8	2920382	S	7	16	23	0.00003
ERR6913276	Chitinophaga filiformis	104663	S	12	5	17	0.00002
ERR6913276	Chitinophaga oryzae	2725414	S	9	3	12	0.00001
ERR6913276	Chitinophaga caeni	2029983	S	8	1	9	0.00001
ERR6913276	Chitinophaga alhagiae	2203219	S	7	0	7	0.00001
ERR6913276	Chitinophaga agri	2703787	S	7	5	12	0.00001
ERR6913276	Chitinophaga pinensis	79329	S	5	3	8	0.00001
ERR6913276	Ferruginibacter albus	2875540	S	29	6	35	0.00004
ERR6913276	Ferruginibacter lapsinanis	563172	S	24	5	29	0.00003
ERR6913276	Pseudobacter ginsenosidimutans	661488	S	38	7	45	0.00005
ERR6913276	Lacibacter sp. S13-6-22	2760713	S	35	4	39	0.00004
ERR6913276	Niabella soli	446683	S	21	5	26	0.00003
ERR6913276	Niabella ginsenosidivorans	1176587	S	9	1	10	0.00001
ERR6913276	Niastella koreensis	354356	S	29	6	35	0.00004
ERR6913276	Flavihumibacter fluminis (ex Park et al. 2022)	2838157	S	15	2	17	0.00002
ERR6913276	Flavihumibacter rivuli	2838156	S	9	2	11	0.00001
ERR6913276	Panacibacter ginsenosidivorans	1813871	S	23	2	25	0.00003
ERR6913276	Phnomibacter ginsenosidimutans	2676868	S	23	4	27	0.00003
ERR6913276	Paraflavitalea soli	2315862	S	22	4	26	0.00003
ERR6913276	Sediminibacterium sp. TEGAF015	575378	S	21	5	26	0.00003
ERR6913276	Filimonas lacunae	477680	S	19	4	23	0.00003
ERR6913276	Flavisolibacter ginsenosidimutans	661481	S	9	1	10	0.00001
ERR6913276	Pseudocnuella soli	2502779	S	11	2	13	0.00001
ERR6913276	Haliscomenobacter hydrossis	2350	S	165	34	199	0.00022
ERR6913276	Aureispira sp. EL160426	2864201	S	77	54	131	0.00014
ERR6913276	Candidatus Sulfidibacterium hydrothermale	2875962	S	98	1	99	0.00011
ERR6913276	Salinibacter ruber	146919	S	35	0	35	0.00004
ERR6913276	Rhodothermus marinus	29549	S	14	0	14	0.00002
ERR6913276	Rhodocaloribacter litoris	2558931	S	10	0	10	0.00001
ERR6913276	Prosthecochloris aestuarii	1102	S	7	9	16	0.00002
ERR6913276	Chlorobium limicola	1092	S	7	25	32	0.00004
ERR6913276	Chlorobaculum parvum	274539	S	5	12	17	0.00002
ERR6913276	Cyclonatronum proteinivorum	1457365	S	15	0	15	0.00002
ERR6913276	Ignavibacterium album	591197	S	10	1	11	0.00001
ERR6913276	Gemmatirosa kalamazoonensis	861299	S	39	1	40	0.00004
ERR6913276	Gemmatimonas phototrophica	1379270	S	8	8	16	0.00002
ERR6913276	Gemmatimonas groenlandica	2732249	S	8	7	15	0.00002
ERR6913276	Fibrobacter succinogenes	833	S	12	0	12	0.00001
ERR6913276	Planctomyces sp. SH-PL14	1632864	S	47	7	54	0.00006
ERR6913276	Planctomyces sp. SH-PL62	1636152	S	35	29	64	0.00007
ERR6913276	Gimesia algae	2527971	S	17	5	22	0.00002
ERR6913276	Gimesia benthica	2608982	S	11	16	27	0.00003
ERR6913276	Gimesia maris	122	S	10	2	12	0.00001
ERR6913276	Gimesia aquarii	2527964	S	10	0	10	0.00001
ERR6913276	Planctopirus ephydatiae	2528019	S	6	17	23	0.00003
ERR6913276	Calycomorphotria hydatis	2528027	S	22	2	24	0.00003
ERR6913276	Caulifigura coniformis	2527983	S	18	4	22	0.00002
ERR6913276	Fuerstiella marisgermanici	1891926	S	14	0	14	0.00002
ERR6913276	Symmachiella dynata	2527995	S	11	1	12	0.00001
ERR6913276	Alienimonas californiensis	2527989	S	9	1	10	0.00001
ERR6913276	Polystyrenella longa	2528007	S	7	0	7	0.00001
ERR6913276	Crateriforma conspicua	2527996	S	5	2	7	0.00001
ERR6913276	Thalassoglobus polymorphus	2527994	S	5	0	5	0.00001
ERR6913276	Pirellula sp. SH-Sr6A	1632865	S	19	0	19	0.00002
ERR6913276	Pirellula staleyi	125	S	6	0	6	0.00001
ERR6913276	Mariniblastus fucicola	980251	S	25	1	26	0.00003
ERR6913276	Rosistilla ulvae	1930277	S	9	7	16	0.00002
ERR6913276	Rosistilla carotiformis	2528017	S	6	5	11	0.00001
ERR6913276	Anatilimnocola aggregata	2528021	S	22	9	31	0.00003
ERR6913276	Roseimaritima ulvae	980254	S	10	2	12	0.00001
ERR6913276	Lignipirellula cremea	2528010	S	12	5	17	0.00002
ERR6913276	Bremerella volcania	2527984	S	7	2	9	0.00001
ERR6913276	Aureliella helgolandensis	2527968	S	9	2	11	0.00001
ERR6913276	Rhodopirellula sp. P2	2127060	S	5	3	8	0.00001
ERR6913276	Stieleria neptunia	2527979	S	5	1	6	0.00001
ERR6913276	Lacipirellula parvula	2650471	S	24	5	29	0.00003
ERR6913276	Pirellulimonas nuda	2528009	S	10	2	12	0.00001
ERR6913276	Adhaeretor mobilis	1930276	S	6	0	6	0.00001
ERR6913276	Botrimarina mediterranea	2528022	S	5	1	6	0.00001
ERR6913276	Thermogutta terrifontis	1331910	S	7	0	7	0.00001
ERR6913276	Gemmata obscuriglobus	114	S	33	7	40	0.00004
ERR6913276	Gemmata massiliana	1210884	S	12	4	16	0.00002
ERR6913276	Gemmata sp. SH-PL17	1630693	S	11	4	15	0.00002
ERR6913276	Limnoglobus roseus	2598579	S	36	4	40	0.00004
ERR6913276	Urbifossiella limnaea	2528023	S	34	7	41	0.00005
ERR6913276	Tuwongella immobilis	692036	S	25	1	26	0.00003
ERR6913276	Frigoriglobus tundricola	2774151	S	21	6	27	0.00003
ERR6913276	Telmatocola sphagniphila	1123043	S	12	0	12	0.00001
ERR6913276	Singulisphaera acidiphila	466153	S	43	7	50	0.00005
ERR6913276	Paludisphaera borealis	1387353	S	28	12	40	0.00004
ERR6913276	Aquisphaera giovannonii	406548	S	25	6	31	0.00003
ERR6913276	Tautonia plasticadhaerens	2527974	S	20	3	23	0.00003
ERR6913276	Isosphaera pallida	128	S	8	0	8	0.00001
ERR6913276	Poriferisphaera corsica	2528020	S	14	0	14	0.00002
ERR6913276	Mucisphaera calidilacus	2527982	S	11	0	11	0.00001
ERR6913276	Phycisphaera mikurensis	547188	S	9	0	9	0.00001
ERR6913276	Sedimentisphaera cyanobacteriorum	1940790	S	7	5	12	0.00001
ERR6913276	Sedimentisphaera salicampi	1941349	S	6	1	7	0.00001
ERR6913276	Anaerohalosphaera lusitana	1936003	S	5	0	5	0.00001
ERR6913276	Humisphaera borealis	2807512	S	9	0	9	0.00001
ERR6913276	Candidatus Kuenenia stuttgartiensis	174633	S	16	0	16	0.00002
ERR6913276	Luteolibacter sp. SL250	2995170	S	64	26	90	0.00010
ERR6913276	Luteolibacter luteus	2728835	S	32	7	39	0.00004
ERR6913276	Luteolibacter ambystomatis	2824561	S	31	13	44	0.00005
ERR6913276	Verrucomicrobium spinosum	2736	S	84	22	106	0.00012
ERR6913276	Verrucomicrobium sp. GAS474	1882831	S	18	6	24	0.00003
ERR6913276	Roseimicrobium sp. ORNL1	2711231	S	37	6	43	0.00005
ERR6913276	Sulfuriroseicoccus oceanibius	2707525	S	27	9	36	0.00004
ERR6913276	Akkermansia muciniphila	239935	S	41	19	60	0.00007
ERR6913276	Akkermansia glycaniphila	1679444	S	26	6	32	0.00004
ERR6913276	Opitutus terrae	107709	S	35	7	42	0.00005
ERR6913276	Opitutus sp. GAS368	1882749	S	10	9	19	0.00002
ERR6913276	Nibricoccus aquaticus	2576891	S	21	6	27	0.00003
ERR6913276	Ereboglobus luteus	1796921	S	14	3	17	0.00002
ERR6913276	Lacunisphaera limnophila	1838286	S	13	13	26	0.00003
ERR6913276	Horticoccus luteus	2862869	S	5	1	6	0.00001
ERR6913276	Coraliomargarita akajimensis	395922	S	15	1	16	0.00002
ERR6913276	Ruficoccus sp. ZRK36	2866311	S	8	1	9	0.00001
ERR6913276	Candidatus Xiphinematobacter sp. Idaho Grape	1704307	S	38	6	44	0.00005
ERR6913276	Methylacidimicrobium sp. AP8	2730359	S	10	6	16	0.00002
ERR6913276	Candidatus Protochlamydia naegleriophila	389348	S	11	18	29	0.00003
ERR6913276	Parachlamydia acanthamoebae	83552	S	21	16	37	0.00004
ERR6913276	Neochlamydia sp. S13	1353976	S	15	7	22	0.00002
ERR6913276	Candidatus Rhabdochlamydia oedothoracis	2720720	S	5	14	19	0.00002
ERR6913276	Simkania negevensis	83561	S	13	2	15	0.00002
ERR6913276	Waddlia chondrophila	71667	S	7	2	9	0.00001
ERR6913276	Candidatus Velamenicoccus archaeovorus	1930593	S	13	0	13	0.00001
ERR6913276	Kiritimatiella glycovorans	1307763	S	7	3	10	0.00001
ERR6913276	Leptotrichia sp. oral taxon 212	712357	S	120	4	124	0.00014
ERR6913276	Leptotrichia sp. oral taxon 498	712368	S	26	6	32	0.00004
ERR6913276	Leptotrichia sp. oral taxon 218	712361	S	21	4	25	0.00003
ERR6913276	Leptotrichia sp. oral taxon 221	712362	S	16	1	17	0.00002
ERR6913276	Leptotrichia sp. oral taxon 847	1785996	S	5	0	5	0.00001
ERR6913276	Leptotrichia hofstadii	157688	S	158	21	179	0.00020
ERR6913276	Leptotrichia hongkongensis	554406	S	120	16	136	0.00015
ERR6913276	Leptotrichia wadei	157687	S	97	12	109	0.00012
ERR6913276	Leptotrichia trevisanii	109328	S	66	6	72	0.00008
ERR6913276	Leptotrichia buccalis	40542	S	36	3	39	0.00004
ERR6913276	Leptotrichia shahii	157691	S	8	1	9	0.00001
ERR6913276	Pseudoleptotrichia goodfellowii	157692	S	29	0	29	0.00003
ERR6913276	Sebaldella termitidis	826	S	15	0	15	0.00002
ERR6913276	Streptobacillus moniliformis	34105	S	11	0	11	0.00001
ERR6913276	Fusobacterium nucleatum	851	S	509	116	625	0.00069
ERR6913276	Fusobacterium pseudoperiodonticum	2663009	S	46	9	55	0.00006
ERR6913276	Fusobacterium hwasookii	1583098	S	35	33	68	0.00007
ERR6913276	Fusobacterium necrophorum	859	S	8	0	8	0.00001
ERR6913276	Fusobacterium sp. oral taxon 203	671211	S	5	2	7	0.00001
ERR6913276	Ilyobacter polytropus	167642	S	7	0	7	0.00001
ERR6913276	Campylobacter showae	204	S	147	18	165	0.00018
ERR6913276	Campylobacter concisus	199	S	123	9	132	0.00015
ERR6913276	Campylobacter gracilis	824	S	116	5	121	0.00013
ERR6913276	Campylobacter ureolyticus	827	S	107	14	121	0.00013
ERR6913276	Campylobacter sp. CCUG 57310	2517362	S	6	0	6	0.00001
ERR6913276	Campylobacter sp. 2014D-0216	1813595	S	6	4	10	0.00001
ERR6913276	Campylobacter curvus	200	S	24	1	25	0.00003
ERR6913276	Campylobacter rectus	203	S	23	2	25	0.00003
ERR6913276	Campylobacter fetus	196	S	22	8	30	0.00003
ERR6913276	Campylobacter hominis	76517	S	10	1	11	0.00001
ERR6913276	Campylobacter canadensis	449520	S	9	1	10	0.00001
ERR6913276	Campylobacter avium	522485	S	8	0	8	0.00001
ERR6913276	Campylobacter pinnipediorum	1965231	S	6	0	6	0.00001
ERR6913276	Campylobacter jejuni	197	S	6	32	38	0.00004
ERR6913276	Campylobacter geochelonis	1780362	S	6	0	6	0.00001
ERR6913276	Campylobacter mucosalis	202	S	5	0	5	0.00001
ERR6913276	Candidatus Campylobacter infans	2561898	S	5	0	5	0.00001
ERR6913276	Campylobacter iguaniorum	1244531	S	5	0	5	0.00001
ERR6913276	Arcobacter nitrofigilis	28199	S	11	4	15	0.00002
ERR6913276	Arcobacter suis	1278212	S	10	35	45	0.00005
ERR6913276	Arcobacter sp. FWKO B	2593672	S	6	1	7	0.00001
ERR6913276	Aliarcobacter cryaerophilus	28198	S	23	22	45	0.00005
ERR6913276	Aliarcobacter butzleri	28197	S	11	14	25	0.00003
ERR6913276	Aliarcobacter skirrowii	28200	S	6	8	14	0.00002
ERR6913276	Helicobacter pylori	210	S	35	9	44	0.00005
ERR6913276	Helicobacter bilis	37372	S	8	4	12	0.00001
ERR6913276	Sulfurospirillum cavolei	366522	S	5	2	7	0.00001
ERR6913276	Caminibacter mediatlanticus	291048	S	6	7	13	0.00001
ERR6913276	Nitrosophilus labii	2706014	S	7	4	11	0.00001
ERR6913276	Sorangium cellulosum	56	S	88	108	196	0.00022
ERR6913276	Polyangium aurulentum	2567896	S	68	45	113	0.00012
ERR6913276	Chondromyces crocatus	52	S	46	15	61	0.00007
ERR6913276	Pajaroellobacter abortibovis	1882918	S	24	2	26	0.00003
ERR6913276	Labilithrix luteola	1391654	S	78	14	92	0.00010
ERR6913276	Sandaracinus amylolyticus	927083	S	47	8	55	0.00006
ERR6913276	Haliangium ochraceum	80816	S	59	3	62	0.00007
ERR6913276	Nannocystis sp. fl3	2995304	S	51	4	55	0.00006
ERR6913276	Myxococcus xanthus	34	S	12	19	31	0.00003
ERR6913276	Myxococcus hansupus	1297742	S	11	3	14	0.00002
ERR6913276	Myxococcus sp. SCHIC003	2813577	S	11	3	14	0.00002
ERR6913276	Corallococcus sp. EGB	1521117	S	11	2	13	0.00001
ERR6913276	Corallococcus sp. NCRR	2996782	S	7	2	9	0.00001
ERR6913276	Corallococcus macrosporus	35	S	13	11	24	0.00003
ERR6913276	Corallococcus coralloides	184914	S	8	3	11	0.00001
ERR6913276	Pyxidicoccus sp. SCPEA002	2813578	S	12	1	13	0.00001
ERR6913276	Anaeromyxobacter sp. Fw109-5	404589	S	20	6	26	0.00003
ERR6913276	Anaeromyxobacter paludicola	2918171	S	17	4	21	0.00002
ERR6913276	Anaeromyxobacter oryzae	2918170	S	14	4	18	0.00002
ERR6913276	Archangium gephyra	48	S	19	3	22	0.00002
ERR6913276	Archangium violaceum	83451	S	15	2	17	0.00002
ERR6913276	Cystobacter fuscus	43	S	15	3	18	0.00002
ERR6913276	Melittangium boletus	83453	S	5	1	6	0.00001
ERR6913276	Desulfovibrio vulgaris	881	S	63	6	69	0.00008
ERR6913276	Desulfovibrio sp. 86	2666132	S	6	1	7	0.00001
ERR6913276	Desulfovibrio sulfodismutans	63561	S	8	1	9	0.00001
ERR6913276	Desulfovibrio ferrophilus	241368	S	7	0	7	0.00001
ERR6913276	Pseudodesulfovibrio piezophilus	879567	S	10	0	10	0.00001
ERR6913276	Pseudodesulfovibrio portus	231439	S	7	2	9	0.00001
ERR6913276	Pseudodesulfovibrio tunisiensis	463192	S	6	0	6	0.00001
ERR6913276	Pseudodesulfovibrio indicus	1716143	S	6	3	9	0.00001
ERR6913276	Megalodesulfovibrio gigas	879	S	19	0	19	0.00002
ERR6913276	Oceanidesulfovibrio marinus	370038	S	14	0	14	0.00002
ERR6913276	Oleidesulfovibrio alaskensis	58180	S	12	7	19	0.00002
ERR6913276	Salidesulfovibrio onnuriiensis	2583823	S	9	1	10	0.00001
ERR6913276	Maridesulfovibrio salexigens	880	S	5	0	5	0.00001
ERR6913276	Desulfolutivibrio sulfoxidireducens	2773299	S	7	1	8	0.00001
ERR6913276	Desulfocurvibacter africanus	873	S	6	0	6	0.00001
ERR6913276	Paradesulfovibrio bizertensis	376490	S	5	0	5	0.00001
ERR6913276	Desulfomicrobium baculatum	899	S	5	4	9	0.00001
ERR6913276	Geomonas sp. RF6	2897342	S	16	0	16	0.00002
ERR6913276	Geomonas nitrogeniifigens	2847991	S	9	0	9	0.00001
ERR6913276	Geomonas oryzisoli	2847992	S	8	0	8	0.00001
ERR6913276	Geomonas paludis	2740185	S	7	0	7	0.00001
ERR6913276	Geobacter sp. SVR	2495594	S	8	0	8	0.00001
ERR6913276	Geobacter sulfurreducens	35554	S	8	1	9	0.00001
ERR6913276	Geobacter pickeringii	345632	S	8	1	9	0.00001
ERR6913276	Trichlorobacter lovleyi	313985	S	17	0	17	0.00002
ERR6913276	Citrifermentans bremense	60035	S	8	2	10	0.00001
ERR6913276	Desulfuromonas sp. DDH964	1823759	S	8	0	8	0.00001
ERR6913276	Desulfuromonas versatilis	2802975	S	8	0	8	0.00001
ERR6913276	Syntrophotalea acetylenica	29542	S	7	0	7	0.00001
ERR6913276	Desulfuromonas soudanensis	1603606	S	5	0	5	0.00001
ERR6913276	Desulfobacter hydrogenophilus	2291	S	8	6	14	0.00002
ERR6913276	Desulfosarcina ovata	83564	S	6	6	12	0.00001
ERR6913276	Desulfonema magnum	45655	S	9	0	9	0.00001
ERR6913276	Desulfatibacillum aliphaticivorans	218208	S	10	1	11	0.00001
ERR6913276	Desulfosudis oleivorans	181663	S	6	4	10	0.00001
ERR6913276	Desulfobulbus propionicus	894	S	9	0	9	0.00001
ERR6913276	Desulfobulbus oralis	1986146	S	5	0	5	0.00001
ERR6913276	Desulfurivibrio alkaliphilus	427923	S	6	0	6	0.00001
ERR6913276	Syntrophobacter fumaroxidans	119484	S	14	6	20	0.00002
ERR6913276	Caldimicrobium thiodismutans	1653476	S	5	0	5	0.00001
ERR6913276	Desulfomonile tiedjei	2358	S	10	0	10	0.00001
ERR6913276	Desulfarculus baarsii	453230	S	6	2	8	0.00001
ERR6913276	Syntrophus aciditrophicus	316277	S	5	0	5	0.00001
ERR6913276	Treponema sp. OMZ 803	120682	S	15	28	43	0.00005
ERR6913276	Treponema sp. OMZ 906	2563662	S	7	13	20	0.00002
ERR6913276	Treponema sp. Marseille-Q4132	2766701	S	7	0	7	0.00001
ERR6913276	Treponema sp. OMZ 855	1643512	S	6	13	19	0.00002
ERR6913276	Treponema socranskii	53419	S	20	1	21	0.00002
ERR6913276	Treponema denticola	158	S	18	17	35	0.00004
ERR6913276	Treponema medium	58231	S	13	3	16	0.00002
ERR6913276	Treponema vincentii	69710	S	9	3	12	0.00001
ERR6913276	Treponema primitia	88058	S	9	0	9	0.00001
ERR6913276	Treponema pedis	409322	S	8	0	8	0.00001
ERR6913276	Treponema pallidum	160	S	6	9	15	0.00002
ERR6913276	Treponema phagedenis	162	S	5	0	5	0.00001
ERR6913276	Borrelia sp. HM	1882662	S	5	8	13	0.00001
ERR6913276	Borreliella afzelii	29518	S	7	4	11	0.00001
ERR6913276	Salinispira pacifica	1307761	S	25	1	26	0.00003
ERR6913276	Sediminispirochaeta smaragdinae	55206	S	8	0	8	0.00001
ERR6913276	Spirochaeta thermophila	154	S	6	-6	0	0.00000
ERR6913276	Sphaerochaeta associata	1129264	S	7	0	7	0.00001
ERR6913276	Gracilinema caldarium	215591	S	6	3	9	0.00001
ERR6913276	Leptospira interrogans	173	S	12	26	38	0.00004
ERR6913276	Leptospira biflexa	172	S	7	-7	0	0.00000
ERR6913276	Leptospira kirschneri	29507	S	7	0	7	0.00001
ERR6913276	Leptospira kobayashii	1917830	S	6	0	6	0.00001
ERR6913276	Turneriella parva	29510	S	21	0	21	0.00002
ERR6913276	Thermospira aquatica	2828656	S	18	0	18	0.00002
ERR6913276	Brachyspira hyodysenteriae	159	S	5	3	8	0.00001
ERR6913276	Brachyspira pilosicoli	52584	S	5	0	5	0.00001
ERR6913276	Candidatus Nanosynbacter sp. HMT-352	2899133	S	60	27	87	0.00010
ERR6913276	Candidatus Nanosynbacter featherlites	2572088	S	42	12	54	0.00006
ERR6913276	Candidatus Nanosynbacter lyticus	2093824	S	34	26	60	0.00007
ERR6913276	Candidatus Saccharimonas aalborgensis	1332188	S	25	0	25	0.00003
ERR6913276	Candidatus Mycosynbacter amalyticus	2665156	S	25	0	25	0.00003
ERR6913276	Candidatus Minimicrobia vallesae	2841264	S	7	8	15	0.00002
ERR6913276	Candidatus Chromulinivorax destructor	2066483	S	20	4	24	0.00003
ERR6913276	Candidatus Babela massiliensis	673862	S	6	0	6	0.00001
ERR6913276	Candidatus Absconditicoccus praedator	2735562	S	20	0	20	0.00002
ERR6913276	Candidatus Bipolaricaulis anaerobius	2026885	S	5	0	5	0.00001
ERR6913276	Candidatus Koribacter versatilis	658062	S	23	1	24	0.00003
ERR6913276	Edaphobacter sp. 12200R-103	2703788	S	11	1	12	0.00001
ERR6913276	Edaphobacter lichenicola	2051959	S	5	2	7	0.00001
ERR6913276	Granulicella sp. WH15	2602070	S	8	1	9	0.00001
ERR6913276	Granulicella tundricola	940615	S	5	0	5	0.00001
ERR6913276	Acidobacterium capsulatum	33075	S	7	1	8	0.00001
ERR6913276	Acidisarcina polymorpha	2211140	S	5	1	6	0.00001
ERR6913276	Paludibaculum fermentans	1473598	S	47	4	51	0.00006
ERR6913276	Luteitalea pratensis	1855912	S	50	32	82	0.00009
ERR6913276	Luteitalea sp. TBR-22	2802971	S	7	5	12	0.00001
ERR6913276	Chloracidobacterium validum	2821543	S	19	0	19	0.00002
ERR6913276	Chloracidobacterium aggregatum	2851959	S	9	34	43	0.00005
ERR6913276	Sulfidibacter corallicola	2818388	S	17	0	17	0.00002
ERR6913276	Bdellovibrio bacteriovorus	959	S	59	7	66	0.00007
ERR6913276	Bdellovibrio sp. SKB1291214	1732569	S	5	0	5	0.00001
ERR6913276	Bdellovibrio sp. KM01	2748865	S	5	0	5	0.00001
ERR6913276	Micavibrio aeruginosavorus	349221	S	45	0	45	0.00005
ERR6913276	Pseudobdellovibrio exovorus	453816	S	25	2	27	0.00003
ERR6913276	Bacteriovorax stolpii	960	S	44	1	45	0.00005
ERR6913276	Silvanigrella aquatica	1915309	S	9	3	12	0.00001
ERR6913276	Nitrospira moscoviensis	42253	S	14	6	20	0.00002
ERR6913276	Candidatus Nitrospira inopinata	1715989	S	12	4	16	0.00002
ERR6913276	Nitrospira japonica	1325564	S	10	6	16	0.00002
ERR6913276	Nitrospira sp. KM1	1936990	S	10	5	15	0.00002
ERR6913276	Leptospirillum ferrooxidans	180	S	5	2	7	0.00001
ERR6913276	Thermodesulfovibrio yellowstonii	28262	S	9	0	9	0.00001
ERR6913276	Athalassotoga saccharophila	1441386	S	23	0	23	0.00003
ERR6913276	Oceanotoga sp. DSM 15011	2984951	S	13	0	13	0.00001
ERR6913276	Sulfurihydrogenibium azorense	309806	S	27	2	29	0.00003
ERR6913276	Thermocrinis minervae	381751	S	5	3	8	0.00001
ERR6913276	Thermosulfidibacter takaii	412593	S	5	0	5	0.00001
ERR6913276	Aminomonas paucivorans	81412	S	6	5	11	0.00001
ERR6913276	Thermanaerovibrio acidaminovorans	81462	S	6	6	12	0.00001
ERR6913276	Pyramidobacter piscolens	638849	S	8	2	10	0.00001
ERR6913276	Denitrovibrio acetiphilus	118000	S	26	0	26	0.00003
ERR6913276	Persicimonas caeni	2292766	S	15	0	15	0.00002
ERR6913276	Microvenator marinus	2600177	S	7	0	7	0.00001
ERR6913276	Dissulfurimicrobium hydrothermale	1750598	S	6	0	6	0.00001
ERR6913276	Endomicrobium proavitum	1408281	S	15	2	17	0.00002
ERR6913276	Candidatus Endomicrobium trichonymphae	1408204	S	5	1	6	0.00001
ERR6913276	Elusimicrobium minutum	423605	S	5	0	5	0.00001
ERR6913276	Dictyoglomus thermophilum	14	S	5	1	6	0.00001
ERR6913276	Caldithrix abyssi	187145	S	7	0	7	0.00001
ERR6913276	Desulfurispirillum indicum	936456	S	5	0	5	0.00001
ERR6913276	Malassezia restricta	76775	S	22933	324	23257	0.02558
ERR6913276	Sporisorium graminicola	280036	S	53	4	57	0.00006
ERR6913276	Ustilago maydis	5270	S	12	0	12	0.00001
ERR6913276	Psilocybe cubensis	181762	S	47	9	56	0.00006
ERR6913276	Marasmius oreades	181124	S	24	8	32	0.00004
ERR6913276	Rhizoctonia solani	456999	S	58	9	67	0.00007
ERR6913276	Cryptococcus gattii VGI	37769	S	11	25	36	0.00004
ERR6913276	Cryptococcus neoformans	5207	S	10	12	22	0.00002
ERR6913276	Puccinia striiformis	27350	S	52	29	81	0.00009
ERR6913276	Puccinia triticina	208348	S	9	0	9	0.00001
ERR6913276	Fusarium graminearum	5518	S	13	22	35	0.00004
ERR6913276	Fusarium pseudograminearum	101028	S	8	11	19	0.00002
ERR6913276	Fusarium venenatum	56646	S	6	22	28	0.00003
ERR6913276	Fusarium keratoplasticum	1328300	S	18	16	34	0.00004
ERR6913276	Fusarium falciforme	195108	S	16	11	27	0.00003
ERR6913276	Fusarium oxysporum	5507	S	41	24	65	0.00007
ERR6913276	Fusarium verticillioides	117187	S	15	18	33	0.00004
ERR6913276	Fusarium fujikuroi	5127	S	11	2	13	0.00001
ERR6913276	Fusarium musae	1042133	S	5	5	10	0.00001
ERR6913276	Drechmeria coniospora	98403	S	38	9	47	0.00005
ERR6913276	Purpureocillium takamizusanense	2060973	S	17	7	24	0.00003
ERR6913276	Ustilaginoidea virens	1159556	S	30	6	36	0.00004
ERR6913276	Pochonia chlamydosporia	280754	S	11	1	12	0.00001
ERR6913276	Colletotrichum higginsianum	80884	S	25	17	42	0.00005
ERR6913276	Colletotrichum lupini	145971	S	16	3	19	0.00002
ERR6913276	Thermothielavioides terrestris	2587410	S	33	7	40	0.00004
ERR6913276	Thermothelomyces thermophilus	78579	S	16	3	19	0.00002
ERR6913276	Neurospora crassa	5141	S	51	10	61	0.00007
ERR6913276	Pyricularia grisea	148305	S	22	8	30	0.00003
ERR6913276	Pyricularia oryzae	318829	S	7	4	11	0.00001
ERR6913276	Pyricularia pennisetigena	1578925	S	6	2	8	0.00001
ERR6913276	Botrytis cinerea	40559	S	47	1	48	0.00005
ERR6913276	Aspergillus chevalieri	182096	S	63	16	79	0.00009
ERR6913276	Aspergillus oryzae	5062	S	17	51	68	0.00007
ERR6913276	Aspergillus puulaauensis	1220207	S	46	8	54	0.00006
ERR6913276	Aspergillus luchuensis	1069201	S	36	9	45	0.00005
ERR6913276	Aspergillus fumigatus	746128	S	23	4	27	0.00003
ERR6913276	Aspergillus nidulans	162425	S	10	1	11	0.00001
ERR6913276	Penicillium oxalicum	69781	S	42	15	57	0.00006
ERR6913276	Talaromyces rugulosus	121627	S	209	36	245	0.00027
ERR6913276	Zymoseptoria tritici	1047171	S	37	16	53	0.00006
ERR6913276	Cercospora beticola	122368	S	27	8	35	0.00004
ERR6913276	Fulvia fulva	5499	S	17	7	24	0.00003
ERR6913276	Brettanomyces nanus	13502	S	90	40	130	0.00014
ERR6913276	Brettanomyces bruxellensis	5007	S	11	2	13	0.00001
ERR6913276	Ogataea parapolymorpha	1005962	S	49	8	57	0.00006
ERR6913276	Pichia kudriavzevii	4909	S	46	12	58	0.00006
ERR6913276	Saccharomyces cerevisiae	4932	S	33	8	41	0.00005
ERR6913276	Saccharomyces eubayanus	1080349	S	6	0	6	0.00001
ERR6913276	Tetrapisispora blattae	1071379	S	22	2	24	0.00003
ERR6913276	Tetrapisispora phaffii	113608	S	19	1	20	0.00002
ERR6913276	Kluyveromyces marxianus	4911	S	7	28	35	0.00004
ERR6913276	Kazachstania naganishii	588726	S	14	1	15	0.00002
ERR6913276	Kazachstania africana	432096	S	7	0	7	0.00001
ERR6913276	Zygosaccharomyces rouxii	4956	S	19	1	20	0.00002
ERR6913276	Naumovozyma castellii	27288	S	12	1	13	0.00001
ERR6913276	Eremothecium sinecaudum	45286	S	6	2	8	0.00001
ERR6913276	Zygotorulaspora mrakii	42260	S	5	0	5	0.00001
ERR6913276	Candida orthopsilosis	273371	S	74	5	79	0.00009
ERR6913276	Candida albicans	5476	S	17	2	19	0.00002
ERR6913276	Candida dubliniensis	42374	S	7	1	8	0.00001
ERR6913276	Debaryomyces hansenii	4959	S	13	2	15	0.00002
ERR6913276	Scheffersomyces stipitis	4924	S	11	2	13	0.00001
ERR6913276	Sugiyamaella lignohabitans	796027	S	27	3	30	0.00003
ERR6913276	Yarrowia lipolytica	4952	S	18	0	18	0.00002
ERR6913276	Saccharomycodes ludwigii	36035	S	6	1	7	0.00001
ERR6913276	Komagataella phaffii	460519	S	6	0	6	0.00001
ERR6913276	Schizosaccharomyces pombe	4896	S	76	18	94	0.00010
ERR6913276	Homo sapiens	9606	S	2880	319	3199	0.00352
ERR6913276	Phaeodactylum tricornutum	2850	S	7676	305	7981	0.00878
ERR6913276	Thalassiosira pseudonana	35128	S	3714	244	3958	0.00435
ERR6913276	Babesia bigemina	5866	S	196	66	262	0.00029
ERR6913276	Babesia microti	5868	S	154	42	196	0.00022
ERR6913276	Babesia bovis	5865	S	67	31	98	0.00011
ERR6913276	Theileria equi	5872	S	24	5	29	0.00003
ERR6913276	Theileria orientalis	68886	S	10	4	14	0.00002
ERR6913276	Theileria parva	5875	S	6	7	13	0.00001
ERR6913276	Theileria annulata	5874	S	5	7	12	0.00001
ERR6913276	Plasmodium malariae	5858	S	77	17	94	0.00010
ERR6913276	Plasmodium vivax	5855	S	7	12	19	0.00002
ERR6913276	Plasmodium knowlesi	5850	S	6	15	21	0.00002
ERR6913276	Plasmodium sp. gorilla clade G2	880535	S	25	48	73	0.00008
ERR6913276	Plasmodium yoelii	5861	S	10	18	28	0.00003
ERR6913276	Plasmodium berghei	5821	S	5	10	15	0.00002
ERR6913276	Plasmodium relictum	85471	S	18	9	27	0.00003
ERR6913276	Toxoplasma gondii	5811	S	125	124	249	0.00027
ERR6913276	Besnoitia besnoiti	94643	S	52	23	75	0.00008
ERR6913276	Neospora caninum	29176	S	6	0	6	0.00001
ERR6913276	Cryptosporidium parvum	5807	S	91	6	97	0.00011
ERR6913276	Bigelowiella natans	227086	S	312	105	417	0.00046
ERR6913276	Cryptomonas paramecium	2898	S	200	46	246	0.00027
ERR6913276	Hemiselmis andersenii	464988	S	33	9	42	0.00005
ERR6913276	Guillardia theta	55529	S	169	102	271	0.00030
ERR6913276	Leishmania mexicana	5665	S	114	151	265	0.00029
ERR6913276	Leishmania major	5664	S	11	27	38	0.00004
ERR6913276	Trypanosoma brucei	5691	S	58	6	64	0.00007
ERR6913276	Dictyostelium discoideum	44689	S	60	0	60	0.00007
ERR6913276	Trichomonas vaginalis	5722	S	48	0	48	0.00005
ERR6913276	Giardia intestinalis	5741	S	5	0	5	0.00001
ERR6913276	Natronomonas moolapensis	416273	S	281	36	317	0.00035
ERR6913276	Natronomonas sp. ZY43	2961939	S	47	21	68	0.00007
ERR6913276	Natronomonas gomsonensis	1046043	S	43	12	55	0.00006
ERR6913276	Natronomonas salina	1710540	S	28	5	33	0.00004
ERR6913276	Natronomonas halophila	2747817	S	27	4	31	0.00003
ERR6913276	Natronomonas pharaonis	2257	S	24	2	26	0.00003
ERR6913276	Haloarcula sp. JP-L23	2716717	S	28	2	30	0.00003
ERR6913276	Haloarcula marismortui	2238	S	22	29	51	0.00006
ERR6913276	Haloarcula sinaiiensis	35742	S	18	11	29	0.00003
ERR6913276	Haloarcula taiwanensis	1932004	S	16	1	17	0.00002
ERR6913276	Halosimplex sp. XZYJT29	3026162	S	33	8	41	0.00005
ERR6913276	Halosimplex rubrum	869889	S	13	2	15	0.00002
ERR6913276	Halosimplex litoreum	1198301	S	12	1	13	0.00001
ERR6913276	Halosimplex pelagicum	869886	S	11	1	12	0.00001
ERR6913276	Halorhabdus tiamatea	430914	S	34	5	39	0.00004
ERR6913276	Halorhabdus utahensis	146826	S	14	0	14	0.00002
ERR6913276	Halorhabdus sp. CBA1104	1380432	S	9	0	9	0.00001
ERR6913276	Halorientalis marina	2931976	S	28	9	37	0.00004
ERR6913276	Halorientalis sp. IM1011	1932360	S	15	1	16	0.00002
ERR6913276	Halorientalis litorea	2931977	S	10	2	12	0.00001
ERR6913276	Halosegnis sp. ZY10	2962671	S	29	10	39	0.00004
ERR6913276	Halosegnis rubeus	2212850	S	13	45	58	0.00006
ERR6913276	Haloglomus sp. ZY41	2962672	S	20	10	30	0.00003
ERR6913276	Haloglomus sp. ZY58	2962673	S	9	3	12	0.00001
ERR6913276	Halomicrobium salinisoli	2878391	S	17	5	22	0.00002
ERR6913276	Halomicrobium sp. LC1Hm	2610902	S	5	14	19	0.00002
ERR6913276	Halapricum desulfuricans	2841257	S	17	1	18	0.00002
ERR6913276	Halapricum salinum	1457250	S	12	0	12	0.00001
ERR6913276	Halosiccatus urmianus	1586233	S	16	5	21	0.00002
ERR6913276	Halobacterium sp. DL1	751944	S	28	14	42	0.00005
ERR6913276	Halobacterium sp. XZYJT26	2902624	S	12	2	14	0.00002
ERR6913276	Halobacterium sp. Gai3-17	2902623	S	9	0	9	0.00001
ERR6913276	Halobacterium sp. BOL4-2	2810537	S	6	9	15	0.00002
ERR6913276	Halobacterium noricense	223182	S	28	5	33	0.00004
ERR6913276	Halobacterium litoreum	2039234	S	25	2	27	0.00003
ERR6913276	Halobacterium salinarum	2242	S	19	40	59	0.00006
ERR6913276	Halobacterium hubeiense	1407499	S	13	3	16	0.00002
ERR6913276	Halorussus sp. YCN54	2953750	S	11	2	13	0.00001
ERR6913276	Halorussus sp. XZYJ18	2953748	S	10	4	14	0.00002
ERR6913276	Halorussus sp. XZYJT49	2938695	S	8	5	13	0.00001
ERR6913276	Halorussus sp. XZYJT10	2953749	S	7	1	8	0.00001
ERR6913276	Halorussus pelagicus	2505977	S	16	2	18	0.00002
ERR6913276	Halanaeroarchaeum sp. HSR-CO	2866382	S	31	3	34	0.00004
ERR6913276	Halanaeroarchaeum sulfurireducens	1604004	S	28	3	31	0.00003
ERR6913276	Haladaptatus salinisoli	2884876	S	14	3	17	0.00002
ERR6913276	Haladaptatus halobius	2884875	S	12	1	13	0.00001
ERR6913276	Haladaptatus pallidirubidus	1008152	S	7	0	7	0.00001
ERR6913276	Halodesulfurarchaeum formicicum	1873524	S	32	1	33	0.00004
ERR6913276	Halomarina sp. BCD28	2961595	S	19	1	20	0.00002
ERR6913276	Halomarina sp. BND7	2961599	S	6	0	6	0.00001
ERR6913276	Salarchaeum japonicum	555573	S	14	10	24	0.00003
ERR6913276	Halarchaeum sp. CBA1220	1853682	S	17	1	18	0.00002
ERR6913276	Halalkalicoccus jeotgali	413810	S	9	0	9	0.00001
ERR6913276	Halovenus salina	1510225	S	7	0	7	0.00001
ERR6913276	Salinarchaeum laminariae	869888	S	19	0	19	0.00002
ERR6913276	Salinarchaeum sp. IM2453	2862870	S	7	0	7	0.00001
ERR6913276	Salinarchaeum sp. Harcht-Bsk1	1333523	S	6	0	6	0.00001
ERR6913276	Natranaeroarchaeum sulfidigenes	2784880	S	12	0	12	0.00001
ERR6913276	Salinirubellus sp. BND22	2962676	S	22	3	25	0.00003
ERR6913276	Salinirubellus salinus	1364945	S	11	1	12	0.00001
ERR6913276	Halococcus dombrowskii	179637	S	14	2	16	0.00002
ERR6913276	Halococcus qingdaonensis	224402	S	9	3	12	0.00001
ERR6913276	Halorubrum sp. CBA1229	1853699	S	34	8	42	0.00005
ERR6913276	Halorubrum sp. PV6	634157	S	26	2	28	0.00003
ERR6913276	Halorubrum sp. 1-13-28	2949307	S	21	5	26	0.00003
ERR6913276	Halorubrum sp. BOL3-1	2497325	S	18	2	20	0.00002
ERR6913276	Halorubrum salinarum	2739057	S	20	5	25	0.00003
ERR6913276	Halorubrum ezzemoulense	337243	S	14	2	16	0.00002
ERR6913276	Halorubrum trapanicum	29284	S	13	6	19	0.00002
ERR6913276	Halorubrum lacusprofundi	2247	S	12	5	17	0.00002
ERR6913276	Halobaculum magnesiiphilum	1017351	S	22	13	35	0.00004
ERR6913276	Halobaculum sp. CBA1158	2904243	S	16	4	20	0.00002
ERR6913276	Halobaculum salinum	2743089	S	12	1	13	0.00001
ERR6913276	Halobaculum roseum	2175149	S	5	4	9	0.00001
ERR6913276	Halohasta litchfieldiae	1073996	S	35	7	42	0.00005
ERR6913276	Halalkaliarchaeum desulfuricum	2055893	S	13	1	14	0.00002
ERR6913276	Halalkaliarchaeum sp. AArc-CO	2866381	S	10	1	11	0.00001
ERR6913276	Salinigranum rubrum	755307	S	19	2	21	0.00002
ERR6913276	Halopenitus persicus	1048396	S	16	1	17	0.00002
ERR6913276	Halolamina sp. CBA1230	1853690	S	5	1	6	0.00001
ERR6913276	Haloplanus aerogenes	660522	S	26	2	28	0.00003
ERR6913276	Haloplanus sp. HW8-1	2949995	S	15	4	19	0.00002
ERR6913276	Haloplanus sp. GDY1	2949993	S	7	1	8	0.00001
ERR6913276	Haloplanus rubicundus	1547898	S	18	2	20	0.00002
ERR6913276	Haloplanus rallus	1816183	S	14	28	42	0.00005
ERR6913276	Haloplanus salinarum	1912324	S	8	11	19	0.00002
ERR6913276	Haloprofundus sp. MHR1	2572921	S	18	4	22	0.00002
ERR6913276	Haloprofundus salilacus	2876190	S	15	1	16	0.00002
ERR6913276	Haloprofundus halobius	2876194	S	7	1	8	0.00001
ERR6913276	Haloferax alexandrinus	114529	S	7	10	17	0.00002
ERR6913276	Haloferax gibbonsii	35746	S	5	1	6	0.00001
ERR6913276	Halobellus ramosii	1379040	S	14	5	19	0.00002
ERR6913276	Halobellus limi	699433	S	5	1	6	0.00001
ERR6913276	Halogeometricum borinquense	60847	S	10	0	10	0.00001
ERR6913276	Haloquadratum walsbyi	293091	S	9	0	9	0.00001
ERR6913276	Natrinema sp. J7-2	406552	S	25	13	38	0.00004
ERR6913276	Natrinema sp. DC36	2878680	S	14	3	17	0.00002
ERR6913276	Natrinema sp. YPL30	1710539	S	12	2	14	0.00002
ERR6913276	Natrinema sp. SYSU A 869	2871694	S	8	1	9	0.00001
ERR6913276	Natrinema pellirubrum	69525	S	18	8	26	0.00003
ERR6913276	Natrinema versiforme	88724	S	12	4	16	0.00002
ERR6913276	Natrinema salinisoli	2878535	S	6	1	7	0.00001
ERR6913276	Haloterrigena sp. BND6	2961571	S	13	1	14	0.00002
ERR6913276	Haloterrigena sp. ZJ2	2961570	S	8	1	9	0.00001
ERR6913276	Haloterrigena sp. DT87	2961598	S	5	1	6	0.00001
ERR6913276	Haloterrigena salifodinae	2675099	S	7	6	13	0.00001
ERR6913276	Haloterrigena alkaliphila	2816475	S	7	2	9	0.00001
ERR6913276	Haloterrigena longa	370324	S	6	2	8	0.00001
ERR6913276	Halovivax sp. CGA30	2961597	S	15	0	15	0.00002
ERR6913276	Halovivax sp. WLHSJ27	2963433	S	9	1	10	0.00001
ERR6913276	Halovivax limisalsi	1453760	S	12	0	12	0.00001
ERR6913276	Halovivax ruber	387341	S	8	0	8	0.00001
ERR6913276	Halovivax cerinus	1487865	S	6	0	6	0.00001
ERR6913276	Natrarchaeobaculum sulfurireducens	2044521	S	6	15	21	0.00002
ERR6913276	Natribaculum sp. AD-4	2961596	S	12	2	14	0.00002
ERR6913276	Natribaculum sp. CGA3	2953881	S	7	0	7	0.00001
ERR6913276	Natribaculum luteum	1586232	S	5	0	5	0.00001
ERR6913276	Halobiforma lacisalsi	229731	S	21	4	25	0.00003
ERR6913276	Natronorubrum aibiense	348826	S	12	1	13	0.00001
ERR6913276	Natronorubrum bangense	61858	S	5	0	5	0.00001
ERR6913276	Halosolutus halophilus	1552990	S	10	1	11	0.00001
ERR6913276	Halosolutus gelatinilyticus	2931975	S	7	0	7	0.00001
ERR6913276	Halopiger xanaduensis	387343	S	14	2	16	0.00002
ERR6913276	Saliphagus sp. WLHS1	2953753	S	7	2	9	0.00001
ERR6913276	Saliphagus sp. WLHSJ1	2961994	S	5	0	5	0.00001
ERR6913276	Natronococcus occultus	29288	S	8	0	8	0.00001
ERR6913276	Halostagnicola larsenii	353800	S	9	0	9	0.00001
ERR6913276	Natronobacterium gregoryi	44930	S	6	0	6	0.00001
ERR6913276	Natronobiforma sp. CGA73	2963434	S	6	0	6	0.00001
ERR6913276	Methanoculleus bourgensis	83986	S	7	4	11	0.00001
ERR6913276	Methanoregula formicica	882104	S	6	0	6	0.00001
ERR6913276	Methanothrix harundinacea	301375	S	11	0	11	0.00001
ERR6913276	Methanothrix sp.	90426	S	6	6	12	0.00001
ERR6913276	Methanosarcina mazei	2209	S	6	4	10	0.00001
ERR6913276	Methanobacterium lacus	877455	S	18	1	19	0.00002
ERR6913276	Methanobacterium paludis	868131	S	9	1	10	0.00001
ERR6913276	Methanobrevibacter smithii	2173	S	15	2	17	0.00002
ERR6913276	Methanothermus fervidus	2180	S	11	0	11	0.00001
ERR6913276	Methanococcus aeolicus	42879	S	5	0	5	0.00001
ERR6913276	Pyrobaculum calidifontis	181486	S	6	0	6	0.00001
ERR6913276	Candidatus Nitrosocosmicus oleophilus	1353260	S	12	0	12	0.00001
ERR6913276	Candidatus Nitrosotalea okcheonensis	1903276	S	5	0	5	0.00001
ERR6913276	Candidatus Methanomethylophilus alvus	1291540	S	18	0	18	0.00002
ERR6913276	Propionibacterium phage Enoki	1654780	S	6	8	14	0.00002
ERR6913276	Propionibacterium phage QueenBey	1654782	S	6	4	10	0.00001
ERR6913276	Propionibacterium phage PA1-14	1747271	S	6	7	13	0.00001
ERR6913276	Pahexavirus solid	1982306	S	15	20	35	0.00004
ERR6913276	Pahexavirus lauchelly	1982257	S	10	5	15	0.00002
ERR6913276	Pahexavirus PHL113M01	1982286	S	7	14	21	0.00002
ERR6913276	Pahexavirus ouroboros	1982259	S	6	3	9	0.00001
ERR6913276	Pahexavirus P105	1982261	S	6	11	17	0.00002
ERR6913276	Skunavirus sv37201	2845159	S	10	34	44	0.00005
ERR6913276	Skunavirus B1127	2845450	S	6	6	12	0.00001
ERR6913276	Staphylococcus phage StB20	1147043	S	9	7	16	0.00002
ERR6913276	Streptococcus phage EJ-1	12402	S	7	0	7	0.00001
ERR6913276	Gordonia phage Emperor	2201427	S	5	0	5	0.00001
ERR6913276	Andhravirus St134	2732592	S	7	25	32	0.00004
ERR6913276	Rosenblumvirus PSa3	2732601	S	12	9	21	0.00002
ERR6913276	Charybdisvirus scam3	2734102	S	5	5	10	0.00001
ERR6913276	Staphylococcus phage StB12	1147042	S	15	1	16	0.00002
ERR6913276	Stenotrophomonas phage Philippe	2859655	S	6	0	6	0.00001
ERR6913276	Dybvigvirus Av1	338473	S	8	0	8	0.00001
ERR6913276	Human mastadenovirus C	129951	S	687	0	687	0.00076
ERR6913276	Moumouvirus	985782	S	8	0	8	0.00001
ERR6913276	Severe acute respiratory syndrome-related coronavirus	694009	S	26	0	26	0.00003
ERR6913276	Citrus endogenous pararetrovirus	1435008	S	11	0	11	0.00001
ERR6913276	Tobacco vein clearing virus	107324	S	7	0	7	0.00001
ERR6913276	Beihai picorna-like virus 49	1922593	S	7	0	7	0.00001
ERR6913276	Betapapillomavirus 1	337051	S	14	0	14	0.00002
ERR6913276	Usarudivirus SIRV10	2846588	S	5	0	5	0.00001
ERR6913278	Veillonella rogosae	423477	S	23329	11207	34536	0.02711
ERR6913278	Veillonella atypica	39777	S	21044	3168	24212	0.01900
ERR6913278	Veillonella nakazawae	2682456	S	5505	12283	17788	0.01396
ERR6913278	Veillonella sp. S12025-13	2682455	S	3280	6527	9807	0.00770
ERR6913278	Veillonella parvula	29466	S	2028	132962	134990	0.10595
ERR6913278	Veillonella dispar	39778	S	1925	1977	3902	0.00306
ERR6913278	Veillonella rodentium	248315	S	589	53	642	0.00050
ERR6913278	Megasphaera stantonii	2144175	S	1520	636	2156	0.00169
ERR6913278	Megasphaera hexanoica	1675036	S	481	457	938	0.00074
ERR6913278	Megasphaera elsdenii	907	S	159	420	579	0.00045
ERR6913278	Megasphaera massiliensis	1232428	S	22	13	35	0.00003
ERR6913278	Dialister pneumosintes	39950	S	228	60	288	0.00023
ERR6913278	Dialister succinatiphilus	487173	S	132	67	199	0.00016
ERR6913278	Selenomonas sp. oral taxon 478	712538	S	486	698	1184	0.00093
ERR6913278	Selenomonas sp. oral taxon 136	713030	S	222	280	502	0.00039
ERR6913278	Selenomonas sp. oral taxon 920	1884263	S	142	123	265	0.00021
ERR6913278	Selenomonas sp. oral taxon 126	712528	S	57	82	139	0.00011
ERR6913278	Selenomonas sputigena	69823	S	1169	139	1308	0.00103
ERR6913278	Selenomonas timonae	2754044	S	115	301	416	0.00033
ERR6913278	Selenomonas ruminantium	971	S	9	0	9	0.00001
ERR6913278	Megamonas funiformis	437897	S	12	6	18	0.00001
ERR6913278	Megamonas hypermegale	158847	S	11	9	20	0.00002
ERR6913278	Pectinatus frisingensis	865	S	15	1	16	0.00001
ERR6913278	Pelosinus sp. UFO1	484770	S	18	16	34	0.00003
ERR6913278	Sporomusa termitida	2377	S	17	13	30	0.00002
ERR6913278	Acidaminococcus intestini	187327	S	30	5	35	0.00003
ERR6913278	Acidaminococcus fermentans	905	S	5	1	6	0.00000
ERR6913278	Phascolarctobacterium faecium	33025	S	5	0	5	0.00000
ERR6913278	Phascolarctobacterium sp. Marseille-Q4147	2823317	S	5	2	7	0.00001
ERR6913278	Streptococcus sp. LPB0220	2610896	S	15327	6308	21635	0.01698
ERR6913278	Streptococcus sp. HSISM1	1316408	S	9299	3539	12838	0.01008
ERR6913278	Streptococcus sp. oral taxon 431	712633	S	8668	1296	9964	0.00782
ERR6913278	Streptococcus sp. oral taxon 061	712623	S	3523	959	4482	0.00352
ERR6913278	Streptococcus sp. Marseille-Q6470	2972784	S	2863	691	3554	0.00279
ERR6913278	Streptococcus sp. Marseille-Q3533	2759692	S	2696	468	3164	0.00248
ERR6913278	Streptococcus sp. A12	1759399	S	1849	644	2493	0.00196
ERR6913278	Streptococcus sp. 116-D4	2598453	S	646	201	847	0.00066
ERR6913278	Streptococcus sp. NPS 308	1902136	S	187	86	273	0.00021
ERR6913278	Streptococcus sp. FDAARGOS_192	1839799	S	88	151	239	0.00019
ERR6913278	Streptococcus sp. 1643	2576376	S	78	88	166	0.00013
ERR6913278	Streptococcus sp. HSISS2	1316411	S	75	78	153	0.00012
ERR6913278	Streptococcus sp. HSISS3	1316412	S	61	61	122	0.00010
ERR6913278	Streptococcus sp. oral taxon 064	712624	S	33	78	111	0.00009
ERR6913278	Streptococcus sp. HSISS1	1316410	S	17	488	505	0.00040
ERR6913278	Streptococcus sp. HN38	3020829	S	10	13	23	0.00002
ERR6913278	Streptococcus sp. KS 6	2598457	S	9	8	17	0.00001
ERR6913278	Streptococcus sp. CNU G2	2686210	S	5	11	16	0.00001
ERR6913278	Streptococcus sp. NSJ-72	2763068	S	5	17	22	0.00002
ERR6913278	Streptococcus parasanguinis	1318	S	16007	5095	21102	0.01656
ERR6913278	Streptococcus salivarius	1304	S	5925	3688	9613	0.00755
ERR6913278	Streptococcus infantis	68892	S	4759	910	5669	0.00445
ERR6913278	Streptococcus oralis	1303	S	2379	1467	3846	0.00302
ERR6913278	Streptococcus lactarius	684066	S	1668	206	1874	0.00147
ERR6913278	Streptococcus mitis	28037	S	1659	664	2323	0.00182
ERR6913278	Streptococcus australis	113107	S	1547	1279	2826	0.00222
ERR6913278	Streptococcus ilei	1156431	S	1116	981	2097	0.00165
ERR6913278	Streptococcus pneumoniae	1313	S	955	14512	15467	0.01214
ERR6913278	Streptococcus rubneri	1234680	S	884	613	1497	0.00117
ERR6913278	Streptococcus sanguinis	1305	S	770	75	845	0.00066
ERR6913278	Streptococcus thermophilus	1308	S	729	2232	2961	0.00232
ERR6913278	Streptococcus pyogenes	1314	S	530	194	724	0.00057
ERR6913278	Streptococcus gordonii	1302	S	466	44	510	0.00040
ERR6913278	Streptococcus koreensis	2382163	S	456	478	934	0.00073
ERR6913278	Streptococcus suis	1307	S	311	612	923	0.00072
ERR6913278	Streptococcus cristatus	45634	S	306	33	339	0.00027
ERR6913278	Streptococcus intermedius	1338	S	100	33	133	0.00010
ERR6913278	Streptococcus anginosus	1328	S	97	150	247	0.00019
ERR6913278	Streptococcus constellatus	76860	S	39	9307	9346	0.00734
ERR6913278	Streptococcus agalactiae	1311	S	142	38110	38252	0.03002
ERR6913278	Streptococcus oriscaviae	2781599	S	128	5	133	0.00010
ERR6913278	Streptococcus gwangjuense	1433513	S	116	70	186	0.00015
ERR6913278	Streptococcus pseudopneumoniae	257758	S	114	64	178	0.00014
ERR6913278	Streptococcus ferus	1345	S	93	2	95	0.00007
ERR6913278	Streptococcus toyakuensis	2819619	S	90	68	158	0.00012
ERR6913278	Streptococcus sobrinus	1310	S	87	2	89	0.00007
ERR6913278	Streptococcus equinus	1335	S	72	18	90	0.00007
ERR6913278	Streptococcus parauberis	1348	S	72	13	85	0.00007
ERR6913278	Streptococcus equi	1336	S	56	3	59	0.00005
ERR6913278	Streptococcus dysgalactiae	1334	S	5	1	6	0.00000
ERR6913278	Streptococcus vestibularis	1343	S	57	20	77	0.00006
ERR6913278	Streptococcus iniae	1346	S	43	2	45	0.00004
ERR6913278	Streptococcus pluranimalium	82348	S	42	3	45	0.00004
ERR6913278	Streptococcus uberis	1349	S	34	1	35	0.00003
ERR6913278	Streptococcus mutans	1309	S	33	7	40	0.00003
ERR6913278	Streptococcus himalayensis	1888195	S	27	1	28	0.00002
ERR6913278	Streptococcus canis	1329	S	24	3	27	0.00002
ERR6913278	Streptococcus acidominimus	1326	S	23	2	25	0.00002
ERR6913278	Streptococcus chenjunshii	2173853	S	22	0	22	0.00002
ERR6913278	Streptococcus respiraculi	2021971	S	22	1	23	0.00002
ERR6913278	Streptococcus ratti	1341	S	22	0	22	0.00002
ERR6913278	Streptococcus merionis	400065	S	21	0	21	0.00002
ERR6913278	Streptococcus pantholopis	1811193	S	21	0	21	0.00002
ERR6913278	Streptococcus parasuis	1501662	S	21	18	39	0.00003
ERR6913278	Streptococcus alactolyticus	29389	S	18	3	21	0.00002
ERR6913278	Streptococcus pasteurianus	197614	S	17	66	83	0.00007
ERR6913278	Streptococcus halotolerans	1814128	S	16	0	16	0.00001
ERR6913278	Streptococcus marmotae	1825069	S	16	2	18	0.00001
ERR6913278	Streptococcus pseudoporcinus	361101	S	15	2	17	0.00001
ERR6913278	Streptococcus halichoeri	254785	S	10	0	10	0.00001
ERR6913278	Streptococcus troglodytae	1111760	S	8	1	9	0.00001
ERR6913278	Streptococcus urinalis	149016	S	8	0	8	0.00001
ERR6913278	Streptococcus porcinus	1340	S	7	0	7	0.00001
ERR6913278	Streptococcus lutetiensis	150055	S	7	4	11	0.00001
ERR6913278	Streptococcus milleri	33040	S	5	10	15	0.00001
ERR6913278	Lactococcus cremoris	1359	S	7	23	30	0.00002
ERR6913278	Lactococcus lactis	1358	S	6	3	9	0.00001
ERR6913278	Granulicatella adiacens	46124	S	3297	395	3692	0.00290
ERR6913278	Granulicatella elegans	137732	S	185	46	231	0.00018
ERR6913278	Carnobacterium maltaromaticum	2751	S	6	1	7	0.00001
ERR6913278	Dolosigranulum pigrum	29394	S	10	0	10	0.00001
ERR6913278	Lactobacillus iners	147802	S	72	5	77	0.00006
ERR6913278	Lactobacillus sp. wkB8	1545702	S	27	7	34	0.00003
ERR6913278	Lactobacillus acidophilus	1579	S	14	62	76	0.00006
ERR6913278	Lactobacillus delbrueckii	1584	S	13	2	15	0.00001
ERR6913278	Lactobacillus acetotolerans	1600	S	8	0	8	0.00001
ERR6913278	Lactobacillus jensenii	109790	S	6	0	6	0.00000
ERR6913278	Ligilactobacillus salivarius	1624	S	87	7	94	0.00007
ERR6913278	Ligilactobacillus ruminis	1623	S	5	0	5	0.00000
ERR6913278	Oenococcus sicerae	2203724	S	54	0	54	0.00004
ERR6913278	Oenococcus oeni	1247	S	11	0	11	0.00001
ERR6913278	Lacticaseibacillus sp. KACC 23028	3025672	S	23	1	24	0.00002
ERR6913278	Lacticaseibacillus rhamnosus	47715	S	15	0	15	0.00001
ERR6913278	Lacticaseibacillus paracasei	1597	S	6	4	10	0.00001
ERR6913278	Limosilactobacillus reuteri	1598	S	13	6	19	0.00001
ERR6913278	Limosilactobacillus fermentum	1613	S	9	1	10	0.00001
ERR6913278	Bombilactobacillus bombi	1303590	S	21	0	21	0.00002
ERR6913278	Companilactobacillus ginsenosidimutans	1007676	S	13	2	15	0.00001
ERR6913278	Lactiplantibacillus plantarum	1590	S	12	3	15	0.00001
ERR6913278	Latilactobacillus sakei	1599	S	6	0	6	0.00000
ERR6913278	Latilactobacillus curvatus	28038	S	5	0	5	0.00000
ERR6913278	Apilactobacillus apisilvae	2923364	S	7	1	8	0.00001
ERR6913278	Liquorilactobacillus hordei	468911	S	8	1	9	0.00001
ERR6913278	Fructobacillus americanaquae	2940302	S	7	0	7	0.00001
ERR6913278	Enterococcus faecium	1352	S	70	38	108	0.00008
ERR6913278	Enterococcus faecalis	1351	S	36	406	442	0.00035
ERR6913278	Enterococcus hirae	1354	S	8	6	14	0.00001
ERR6913278	Enterococcus cecorum	44008	S	5	0	5	0.00000
ERR6913278	Vagococcus fluvialis	2738	S	5	2	7	0.00001
ERR6913278	Vagococcus penaei	633807	S	5	2	7	0.00001
ERR6913278	Abiotrophia defectiva	46125	S	6	0	6	0.00000
ERR6913278	Suicoccus acidiformans	2036206	S	6	0	6	0.00000
ERR6913278	Ignavigranum ruoffiae	89093	S	5	0	5	0.00000
ERR6913278	Gemella sanguinis	84135	S	1065	1411	2476	0.00194
ERR6913278	Gemella haemolysans	1379	S	908	805	1713	0.00134
ERR6913278	Gemella sp. zg-570	2840371	S	26	40	66	0.00005
ERR6913278	Gemella morbillorum	29391	S	49	73	122	0.00010
ERR6913278	Bacillus atrophaeus	1452	S	791	449	1240	0.00097
ERR6913278	Bacillus amyloliquefaciens	1390	S	28	94	122	0.00010
ERR6913278	Bacillus velezensis	492670	S	27	36	63	0.00005
ERR6913278	Bacillus subtilis	1423	S	7	39	46	0.00004
ERR6913278	Bacillus anthracis	1392	S	28	267	295	0.00023
ERR6913278	Bacillus thuringiensis	1428	S	14	2	16	0.00001
ERR6913278	Bacillus cereus	1396	S	13	176	189	0.00015
ERR6913278	Bacillus sp. JY-23	2933872	S	6	1	7	0.00001
ERR6913278	Bacillus altitudinis	293387	S	6	1	7	0.00001
ERR6913278	Bacillus pumilus	1408	S	5	0	5	0.00000
ERR6913278	Priestia aryabhattai	412384	S	23	34	57	0.00004
ERR6913278	Priestia megaterium	1404	S	11	8	19	0.00001
ERR6913278	Lysinibacillus timonensis	2086577	S	5	3	8	0.00001
ERR6913278	Salicibibacter cibi	2743001	S	18	0	18	0.00001
ERR6913278	Anoxybacillus flavithermus	33934	S	8	5	13	0.00001
ERR6913278	Gottfriedia acidiceleris	371036	S	16	0	16	0.00001
ERR6913278	Rossellomorea sp. KS-H15a	2963940	S	9	0	9	0.00001
ERR6913278	Virgibacillus sp. MSP4-1	2700081	S	6	0	6	0.00000
ERR6913278	Metabacillus litoralis	152268	S	5	2	7	0.00001
ERR6913278	Weizmannia coagulans	1398	S	7	1	8	0.00001
ERR6913278	Geobacillus subterraneus	129338	S	5	1	6	0.00000
ERR6913278	Amphibacillus xylanus	1449	S	5	0	5	0.00000
ERR6913278	Staphylococcus capitis	29388	S	56	3	59	0.00005
ERR6913278	Staphylococcus epidermidis	1282	S	55	2	57	0.00004
ERR6913278	Staphylococcus aureus	1280	S	50	146	196	0.00015
ERR6913278	Staphylococcus hominis	1290	S	49	1	50	0.00004
ERR6913278	Staphylococcus pseudintermedius	283734	S	24	1	25	0.00002
ERR6913278	Nosocomiicoccus ampullae	489910	S	25	0	25	0.00002
ERR6913278	Paenibacillus physcomitrellae	1619311	S	70	6	76	0.00006
ERR6913278	Paenibacillus sp. YPD9-1	2908839	S	17	1	18	0.00001
ERR6913278	Paenibacillus sp. FSL H7-0357	1536774	S	5	0	5	0.00000
ERR6913278	Paenibacillus polymyxa	1406	S	7	27	34	0.00003
ERR6913278	Paenibacillus stellifer	169760	S	6	0	6	0.00000
ERR6913278	Listeria monocytogenes	1639	S	20	94	114	0.00009
ERR6913278	Brochothrix thermosphacta	2756	S	9	0	9	0.00001
ERR6913278	Sporosarcina ureae	1571	S	5	2	7	0.00001
ERR6913278	Tumebacillus avium	1903704	S	7	1	8	0.00001
ERR6913278	Lachnoanaerobaculum umeaense	617123	S	4531	185	4716	0.00370
ERR6913278	Butyrivibrio fibrisolvens	831	S	828	308	1136	0.00089
ERR6913278	Butyrivibrio proteoclasticus	43305	S	553	415	968	0.00076
ERR6913278	Butyrivibrio hungatei	185008	S	243	193	436	0.00034
ERR6913278	Butyrivibrio crossotus	45851	S	155	73	228	0.00018
ERR6913278	Lachnoclostridium phytofermentans	66219	S	513	35	548	0.00043
ERR6913278	Lachnoclostridium phocaeense	1871021	S	27	41	68	0.00005
ERR6913278	[Clostridium] scindens	29347	S	20	48	68	0.00005
ERR6913278	[Clostridium] hylemonae	89153	S	8	16	24	0.00002
ERR6913278	Lachnoclostridium sp. YL32	1834196	S	7	59	66	0.00005
ERR6913278	Lacrimispora xylanolytica	29375	S	246	350	596	0.00047
ERR6913278	Lacrimispora saccharolytica	84030	S	14	68	82	0.00006
ERR6913278	Lacrimispora sphenoides	29370	S	9	37	46	0.00004
ERR6913278	Lachnospira eligens	39485	S	671	135	806	0.00063
ERR6913278	Pseudobutyrivibrio xylanivorans	185007	S	650	30	680	0.00053
ERR6913278	Roseburia hominis	301301	S	459	268	727	0.00057
ERR6913278	Roseburia sp. NSJ-69	2763062	S	61	19	80	0.00006
ERR6913278	Roseburia intestinalis	166486	S	36	1582	1618	0.00127
ERR6913278	Blautia hansenii	1322	S	329	355	684	0.00054
ERR6913278	Blautia argi	1912897	S	41	27	68	0.00005
ERR6913278	Blautia liquoris	2779518	S	41	5	46	0.00004
ERR6913278	Blautia obeum	40520	S	9	12	21	0.00002
ERR6913278	Blautia producta	33035	S	7	6	13	0.00001
ERR6913278	Blautia pseudococcoides	1796616	S	7	5	12	0.00001
ERR6913278	Blautia sp. NBRC 113351	2877527	S	5	7	12	0.00001
ERR6913278	[Clostridium] colinum	36835	S	568	19	587	0.00046
ERR6913278	Anaerostipes hadrus	649756	S	459	171	630	0.00049
ERR6913278	Anaerostipes caccae	105841	S	72	14	86	0.00007
ERR6913278	Simiaoa sunii	2763672	S	390	215	605	0.00047
ERR6913278	Dorea longicatena	88431	S	233	196	429	0.00034
ERR6913278	Dorea formicigenerans	39486	S	141	137	278	0.00022
ERR6913278	[Ruminococcus] torques	33039	S	44	48	92	0.00007
ERR6913278	[Ruminococcus] gnavus	33038	S	29	3261	3290	0.00258
ERR6913278	[Ruminococcus] lactaris	46228	S	5	2	7	0.00001
ERR6913278	Anaerobutyricum hallii	39488	S	280	133	413	0.00032
ERR6913278	Qiania dongpingensis	2763669	S	247	36	283	0.00022
ERR6913278	Anaerocolumna chitinilytica	1727145	S	109	51	160	0.00013
ERR6913278	Anaerocolumna cellulosilytica	433286	S	31	21	52	0.00004
ERR6913278	Anaerocolumna sedimenticola	2696063	S	5	3	8	0.00001
ERR6913278	Anaeromicropila herbilytica	2785025	S	207	8	215	0.00017
ERR6913278	Herbinix luporum	1679721	S	191	49	240	0.00019
ERR6913278	Enterocloster bolteae	208479	S	93	78	171	0.00013
ERR6913278	Enterocloster asparagiformis	333367	S	53	5	58	0.00005
ERR6913278	Enterocloster clostridioformis	1531	S	5	38	43	0.00003
ERR6913278	Faecalicatena sp. Marseille-Q4148	2823316	S	181	110	291	0.00023
ERR6913278	Wansuia hejianensis	2763667	S	174	14	188	0.00015
ERR6913278	Coprococcus eutactus	33043	S	47	109	156	0.00012
ERR6913278	Coprococcus catus	116085	S	10	6	16	0.00001
ERR6913278	Coprococcus comes	410072	S	7	6	13	0.00001
ERR6913278	Novisyntrophococcus fermenticellae	2068655	S	148	27	175	0.00014
ERR6913278	Sellimonas intestinalis	1653434	S	130	14	144	0.00011
ERR6913278	Marvinbryantia formatexigens	168384	S	71	6	77	0.00006
ERR6913278	Anaeropeptidivorans aminofermentans	2934315	S	70	1	71	0.00006
ERR6913278	Oscillibacter hominis	2763056	S	360	167	527	0.00041
ERR6913278	Subdoligranulum variabile	214851	S	200	98	298	0.00023
ERR6913278	Ruthenibacterium lactatiformans	1550024	S	138	46	184	0.00014
ERR6913278	Caproicibacterium lactatifermentans	2666138	S	111	29	140	0.00011
ERR6913278	Caproicibacterium amylolyticum	2766537	S	15	2	17	0.00001
ERR6913278	Ruminococcus bicirculans	1160721	S	47	7	54	0.00004
ERR6913278	Ruminococcus gauvreauii	438033	S	30	5	35	0.00003
ERR6913278	Ruminococcus albus	1264	S	28	0	28	0.00002
ERR6913278	Monoglobus pectinilyticus	1981510	S	71	9	80	0.00006
ERR6913278	Fastidiosipila sanguinis	236753	S	71	6	77	0.00006
ERR6913278	Acetivibrio thermocellus	1515	S	55	11	66	0.00005
ERR6913278	Acetivibrio saccincola	1677857	S	11	3	14	0.00001
ERR6913278	Ruminiclostridium herbifermentans	2488810	S	58	20	78	0.00006
ERR6913278	Faecalibacterium prausnitzii	853	S	20	21	41	0.00003
ERR6913278	Faecalibacterium sp. I2-3-92	2929490	S	7	15	22	0.00002
ERR6913278	Pseudoclostridium thermosuccinogenes	84032	S	42	10	52	0.00004
ERR6913278	Solibaculum mannosilyticum	2780922	S	19	16	35	0.00003
ERR6913278	Acutalibacter muris	1796620	S	17	1	18	0.00001
ERR6913278	Vescimonas fastidiosa	2714353	S	7	12	19	0.00001
ERR6913278	Anaerotruncus colihominis	169435	S	12	12	24	0.00002
ERR6913278	Mageeibacillus indolicus	884684	S	10	1	11	0.00001
ERR6913278	Thermoclostridium stercorarium	1510	S	5	2	7	0.00001
ERR6913278	Clostridium sp. M62/1	411486	S	231	182	413	0.00032
ERR6913278	Clostridium sp. JN-1	2483110	S	112	16	128	0.00010
ERR6913278	Clostridium sp. SY8519	1042156	S	99	10	109	0.00009
ERR6913278	Clostridium sp. MD294	97138	S	54	2	56	0.00004
ERR6913278	Clostridium sp. BJN0001	2930219	S	6	1	7	0.00001
ERR6913278	Clostridium sp. JN-9	2507159	S	5	0	5	0.00000
ERR6913278	Clostridium pasteurianum	1501	S	101	7	108	0.00008
ERR6913278	Clostridium tetani	1513	S	39	8	47	0.00004
ERR6913278	Clostridium perfringens	1502	S	32	99	131	0.00010
ERR6913278	Clostridium beijerinckii	1520	S	26	44	70	0.00005
ERR6913278	Clostridium botulinum	1491	S	22	19	41	0.00003
ERR6913278	Clostridium tyrobutyricum	1519	S	21	1	22	0.00002
ERR6913278	Clostridium bornimense	1216932	S	18	3	21	0.00002
ERR6913278	Clostridium kluyveri	1534	S	18	1	19	0.00001
ERR6913278	Clostridium cellulovorans	1493	S	17	1	18	0.00001
ERR6913278	Clostridium aceticum	84022	S	17	2	19	0.00001
ERR6913278	Clostridium estertheticum	238834	S	7	1	8	0.00001
ERR6913278	Clostridium neonatale	137838	S	7	1	8	0.00001
ERR6913278	Clostridium cadaveris	1529	S	6	1	7	0.00001
ERR6913278	Caloramator sp. Dgby_cultured_2	3029174	S	76	57	133	0.00010
ERR6913278	Caloramator sp. E03	2576307	S	9	2	11	0.00001
ERR6913278	Hungatella hathewayi	154046	S	66	14	80	0.00006
ERR6913278	Serpentinicella alkaliphila	1734049	S	49	8	57	0.00004
ERR6913278	Crassaminicella profunda	1286698	S	10	9	19	0.00001
ERR6913278	Crassaminicella thermophila	2599308	S	5	5	10	0.00001
ERR6913278	Geosporobacter ferrireducens	1424294	S	9	1	10	0.00001
ERR6913278	Paraclostridium bifermentans	1490	S	7	2	9	0.00001
ERR6913278	Oceanirhabdus sp. W0125-5	2999116	S	6	1	7	0.00001
ERR6913278	Peptostreptococcus sp. CBA3647	3003601	S	250	11	261	0.00020
ERR6913278	Filifactor alocis	143361	S	108	13	121	0.00009
ERR6913278	Tepidibacter sp. 8C15b	2925782	S	31	1	32	0.00003
ERR6913278	Clostridioides difficile	1496	S	24	1038	1062	0.00083
ERR6913278	Romboutsia ilealis	1115758	S	12	5	17	0.00001
ERR6913278	Acetoanaerobium sticklandii	1511	S	18	0	18	0.00001
ERR6913278	Peptacetobacter hiranonis	89152	S	10	0	10	0.00001
ERR6913278	Peptoclostridium acidaminophilum	1731	S	6	0	6	0.00000
ERR6913278	Terrisporobacter hibernicus	2813371	S	6	0	6	0.00000
ERR6913278	Vallitalea guaymasensis	1185412	S	31	168	199	0.00016
ERR6913278	Vallitalea pronyensis	1348613	S	22	101	123	0.00010
ERR6913278	Petrocella atlantisensis	2173034	S	15	0	15	0.00001
ERR6913278	Mogibacterium diversum	114527	S	63	44	107	0.00008
ERR6913278	Mogibacterium pumilum	86332	S	16	14	30	0.00002
ERR6913278	Aminipila terrae	2697030	S	14	20	34	0.00003
ERR6913278	Aminipila butyrica	433296	S	9	9	18	0.00001
ERR6913278	Aminipila luticellarii	2507160	S	5	8	13	0.00001
ERR6913278	Emergencia timonensis	1776384	S	27	5	32	0.00003
ERR6913278	Massilistercora timonensis	2086584	S	37	19	56	0.00004
ERR6913278	Flintibacter sp. KGMB00164	2610895	S	12	1	13	0.00001
ERR6913278	Christensenella minuta	626937	S	130	25	155	0.00012
ERR6913278	Christensenella sp. Marseille-P3954	2086585	S	23	1	24	0.00002
ERR6913278	Desulfofarcimen acetoxidans	58138	S	45	5	50	0.00004
ERR6913278	Desulforamulus reducens	59610	S	15	11	26	0.00002
ERR6913278	Thermanaerosceptrum fracticalcis	1712410	S	20	2	22	0.00002
ERR6913278	Desulfitobacterium hafniense	49338	S	45	5	50	0.00004
ERR6913278	Desulfosporosinus youngiae	339862	S	5	12	17	0.00001
ERR6913278	Syntrophobotulus glycolicus	51197	S	8	0	8	0.00001
ERR6913278	Alkalicella caledoniensis	2731377	S	60	1	61	0.00005
ERR6913278	Eubacterium ventriosum	39496	S	25	13	38	0.00003
ERR6913278	Eubacterium sp. c-25	2841037	S	8	1	9	0.00001
ERR6913278	Eubacterium sp. MSJ-33	2841528	S	7	5	12	0.00001
ERR6913278	Eubacterium limosum	1736	S	6	4	10	0.00001
ERR6913278	Desulfoscipio gibsoniae	102134	S	15	0	15	0.00001
ERR6913278	Caldicellulosiruptor morganii	1387555	S	56	1	57	0.00004
ERR6913278	Caldicellulosiruptor kronotskyensis	413889	S	26	3	29	0.00002
ERR6913278	Thermoanaerobacter italicus	108150	S	19	4	23	0.00002
ERR6913278	Thermoanaerobacter wiegelii	46354	S	9	2	11	0.00001
ERR6913278	Ammonifex degensii	42838	S	8	0	8	0.00001
ERR6913278	Carboxydothermus hydrogenoformans	129958	S	9	0	9	0.00001
ERR6913278	Mahella australiensis	252966	S	13	1	14	0.00001
ERR6913278	Zhaonella formicivorans	2528593	S	12	0	12	0.00001
ERR6913278	Halanaerobium praevalens	2331	S	7	1	8	0.00001
ERR6913278	Halothermothrix orenii	31909	S	5	2	7	0.00001
ERR6913278	Anoxybacter fermentans	1323375	S	8	1	9	0.00001
ERR6913278	Bulleidia sp. zg-1006	2806552	S	3077	179	3256	0.00256
ERR6913278	Erysipelothrix sp. HDW6C	2714930	S	17	35	52	0.00004
ERR6913278	Erysipelothrix sp. HDW6A	2714928	S	9	13	22	0.00002
ERR6913278	Erysipelothrix inopinata	225084	S	8	10	18	0.00001
ERR6913278	Faecalibaculum rodentium	1702221	S	66	9	75	0.00006
ERR6913278	Longicatena caecimuris	1796635	S	62	25	87	0.00007
ERR6913278	Faecalitalea cylindroides	39483	S	23	7	30	0.00002
ERR6913278	Intestinibaculum porci	2487118	S	7	0	7	0.00001
ERR6913278	[Clostridium] innocuum	1522	S	8	0	8	0.00001
ERR6913278	Catenibacterium mitsuokai	100886	S	8	0	8	0.00001
ERR6913278	Parvimonas micra	33033	S	540	74	614	0.00048
ERR6913278	Anaerococcus prevotii	33034	S	53	11	64	0.00005
ERR6913278	Anaerococcus mediterraneensis	1870984	S	26	7	33	0.00003
ERR6913278	Anaerococcus vaginalis	33037	S	5	33	38	0.00003
ERR6913278	Peptoniphilus ivorii	54006	S	26	24	50	0.00004
ERR6913278	Murdochiella vaginalis	1852373	S	36	3	39	0.00003
ERR6913278	Finegoldia magna	1260	S	13	2	15	0.00001
ERR6913278	Helcococcus kunzii	40091	S	6	0	6	0.00000
ERR6913278	Gudongella oleilytica	1582259	S	18	0	18	0.00001
ERR6913278	Gottschalkia acidurici	1556	S	18	0	18	0.00001
ERR6913278	Schnuerera ultunensis	45497	S	5	0	5	0.00000
ERR6913278	Ezakiella coagulans	46507	S	134	53	187	0.00015
ERR6913278	Sedimentibacter sp. zth1	2816908	S	6	0	6	0.00000
ERR6913278	Limnochorda pilosa	1555112	S	10	0	10	0.00001
ERR6913278	endosymbiont 'TC1' of Trimyema compressum	243899	S	6	0	6	0.00000
ERR6913278	Rothia mucilaginosa	43675	S	18258	1490	19748	0.01550
ERR6913278	Rothia dentocariosa	2047	S	350	67	417	0.00033
ERR6913278	Rothia aeria	172042	S	257	40	297	0.00023
ERR6913278	Kocuria rhizophila	72000	S	490	1281	1771	0.00139
ERR6913278	Kocuria palustris	71999	S	222	59	281	0.00022
ERR6913278	Micrococcus luteus	1270	S	63	748	811	0.00064
ERR6913278	Micrococcus sp. KD337-16	2856555	S	11	11	22	0.00002
ERR6913278	Arthrobacter sp. PAMC 25486	1494608	S	6	10	16	0.00001
ERR6913278	Auritidibacter sp. NML130574	2170745	S	17	1	18	0.00001
ERR6913278	Renibacterium salmoninarum	1646	S	12	0	12	0.00001
ERR6913278	Microbacterium sp. XT11	367477	S	15	15	30	0.00002
ERR6913278	Microbacterium oxydans	82380	S	17	22	39	0.00003
ERR6913278	Microbacterium resistens	156977	S	5	2	7	0.00001
ERR6913278	Subtercola sp. PAMC28395	2846775	S	5	2	7	0.00001
ERR6913278	Janibacter limosus	53458	S	56	34	90	0.00007
ERR6913278	Janibacter sp. CX7	2963431	S	17	29	46	0.00004
ERR6913278	Janibacter indicus	857417	S	5	41	46	0.00004
ERR6913278	Jonesia denitrificans	43674	S	61	4	65	0.00005
ERR6913278	Brevibacterium sp. CS2	2575923	S	26	9	35	0.00003
ERR6913278	Brevibacterium aurantiacum	273384	S	7	16	23	0.00002
ERR6913278	Brevibacterium luteolum	199591	S	5	1	6	0.00000
ERR6913278	Dermacoccus nishinomiyaensis	1274	S	15	3	18	0.00001
ERR6913278	Kytococcus sedentarius	1276	S	12	2	14	0.00001
ERR6913278	Schaalia odontolytica	1660	S	5819	1062	6881	0.00540
ERR6913278	Schaalia meyeri	52773	S	348	60	408	0.00032
ERR6913278	Schaalia sp. 19OD2882	2794089	S	34	3	37	0.00003
ERR6913278	Schaalia sp. ZJ405	2709403	S	20	0	20	0.00002
ERR6913278	Schaalia turicensis	131111	S	29	6	35	0.00003
ERR6913278	Schaalia cardiffensis	181487	S	15	1	16	0.00001
ERR6913278	Actinomyces pacaensis	1852377	S	366	36	402	0.00032
ERR6913278	Actinomyces sp. oral taxon 169	712116	S	11	37	48	0.00004
ERR6913278	Actinomyces sp. oral taxon 414	712122	S	9	2	11	0.00001
ERR6913278	Actinomyces oris	544580	S	25	84	109	0.00009
ERR6913278	Actinomyces trachealis	2763540	S	18	3	21	0.00002
ERR6913278	Actinomyces howellii	52771	S	9	1	10	0.00001
ERR6913278	Actinomyces respiraculi	2744574	S	9	2	11	0.00001
ERR6913278	Actinomyces slackii	52774	S	8	1	9	0.00001
ERR6913278	Actinomyces radicidentis	111015	S	8	2	10	0.00001
ERR6913278	Actinomyces faecalis	2722820	S	8	1	9	0.00001
ERR6913278	Actinomyces naeslundii	1655	S	7	4	11	0.00001
ERR6913278	Mobiluncus curtisii	2051	S	183	21	204	0.00016
ERR6913278	Pauljensenia hongkongensis	178339	S	65	19	84	0.00007
ERR6913278	Trueperella bialowiezensis	312285	S	52	1	53	0.00004
ERR6913278	Cutibacterium acnes	1747	S	1064	130	1194	0.00094
ERR6913278	Cutibacterium granulosum	33011	S	23	2	25	0.00002
ERR6913278	Cutibacterium modestum	2559073	S	10	0	10	0.00001
ERR6913278	Arachnia propionica	1750	S	13	1	14	0.00001
ERR6913278	Arachnia rubra	1547448	S	5	0	5	0.00000
ERR6913278	Nocardioides sp. zg-536	2803858	S	5	3	8	0.00001
ERR6913278	Nocardioides seonyuensis	2518371	S	10	2	12	0.00001
ERR6913278	Nocardioides panacisoli	627624	S	7	2	9	0.00001
ERR6913278	Nocardioides aquaticus	160826	S	5	1	6	0.00000
ERR6913278	Corynebacterium matruchotii	43768	S	185	8	193	0.00015
ERR6913278	Corynebacterium tuberculostearicum	38304	S	20	14	34	0.00003
ERR6913278	Corynebacterium ihumii	1232427	S	17	9	26	0.00002
ERR6913278	Corynebacterium glucuronolyticum	39791	S	16	2	18	0.00001
ERR6913278	Corynebacterium kefirresidentii	1979527	S	13	12	25	0.00002
ERR6913278	Corynebacterium kroppenstedtii	161879	S	9	0	9	0.00001
ERR6913278	Corynebacterium jeikeium	38289	S	7	25	32	0.00003
ERR6913278	Corynebacterium falsenii	108486	S	6	1	7	0.00001
ERR6913278	Corynebacterium massiliense	441501	S	6	2	8	0.00001
ERR6913278	Corynebacterium endometrii	2488819	S	6	0	6	0.00000
ERR6913278	Corynebacterium glaucum	187491	S	5	1	6	0.00000
ERR6913278	Corynebacterium genitalium	38288	S	5	1	6	0.00000
ERR6913278	Corynebacterium minutissimum	38301	S	5	11	16	0.00001
ERR6913278	Mycolicibacterium celeriflavum	1249101	S	5	13	18	0.00001
ERR6913278	Nocardia asteroides	1824	S	5	4	9	0.00001
ERR6913278	Nocardia cyriacigeorgica	135487	S	5	5	10	0.00001
ERR6913278	Lawsonella clevelandensis	1528099	S	19	2	21	0.00002
ERR6913278	Streptomyces sp. T12	477697	S	34	18	52	0.00004
ERR6913278	Streptomyces venezuelae	54571	S	6	3	9	0.00001
ERR6913278	Streptomyces autolyticus	75293	S	5	37	42	0.00003
ERR6913278	Pseudonocardia autotrophica	2074	S	5	2	7	0.00001
ERR6913278	Saccharopolyspora pogona	333966	S	6	4	10	0.00001
ERR6913278	Nakamurella antarctica	1902245	S	5	0	5	0.00000
ERR6913278	Frankia inefficax	298654	S	6	0	6	0.00000
ERR6913278	Lancefieldella parvula	1382	S	266	6	272	0.00021
ERR6913278	Olsenella sp. oral taxon 807	712411	S	9	0	9	0.00001
ERR6913278	Collinsella aerofaciens	74426	S	5	1	6	0.00000
ERR6913278	Eggerthella lenta	84112	S	7	3	10	0.00001
ERR6913278	Berryella wangjianweii	2734634	S	7	0	7	0.00001
ERR6913278	Acidimicrobium ferrooxidans	53635	S	5	2	7	0.00001
ERR6913278	Conexibacter sp. DBS9H8	2937801	S	9	2	11	0.00001
ERR6913278	Leptolyngbya sp. 7M	2812896	S	106	398	504	0.00040
ERR6913278	Pseudanabaena sp. PCC 7367	82654	S	5	31	36	0.00003
ERR6913278	Halomicronema hongdechloris	1209493	S	9	85	94	0.00007
ERR6913278	Synechococcus sp. PCC 7502	1173263	S	21	14	35	0.00003
ERR6913278	Synechococcus sp. PCC 7336	195250	S	18	7	25	0.00002
ERR6913278	Synechococcus sp. JA-2-3B'a(2-13)	321332	S	6	12	18	0.00001
ERR6913278	Acaryochloris sp. 'Moss Beach'	2740837	S	21	81	102	0.00008
ERR6913278	Acaryochloris marina	155978	S	5	10	15	0.00001
ERR6913278	Chamaesiphon minutus	1173032	S	28	26	54	0.00004
ERR6913278	Calothrix sp. NIES-3974	2005462	S	58	9	67	0.00005
ERR6913278	Calothrix sp. PCC 6303	1170562	S	36	13	49	0.00004
ERR6913278	Brasilonema sennae	1397703	S	5	2	7	0.00001
ERR6913278	Microcoleus vaginatus	119532	S	15	1	16	0.00001
ERR6913278	Limnospira indica	147322	S	25	103	128	0.00010
ERR6913278	Moorena producens	1155739	S	8	-8	0	0.00000
ERR6913278	Candidatus Atelocyanobacterium thalassa	713887	S	19	4	23	0.00002
ERR6913278	Gloeothece citriformis	2546356	S	14	2	16	0.00001
ERR6913278	Chondrocystis sp. NIES-4102	2005460	S	11	7	18	0.00001
ERR6913278	Geminocystis sp. NIES-3708	1615909	S	11	7	18	0.00001
ERR6913278	Anthocerotibacter panamensis	2857077	S	35	2	37	0.00003
ERR6913278	Gloeomargarita lithophora	1188228	S	15	1	16	0.00001
ERR6913278	cyanobacterium endosymbiont of Epithemia turgida	718217	S	7	4	11	0.00001
ERR6913278	Mycoplasma sp. (ex Biomphalaria glabrata)	1749074	S	6	57	63	0.00005
ERR6913278	Mycoplasma phocoenae	754517	S	23	23	46	0.00004
ERR6913278	Mycoplasmopsis maculosa	114885	S	8	14	22	0.00002
ERR6913278	Mycoplasmopsis felis	33923	S	7	8	15	0.00001
ERR6913278	Mycoplasmopsis synoviae	2109	S	5	93	98	0.00008
ERR6913278	Candidatus Hepatoplasma crinochetorum	295596	S	26	1	27	0.00002
ERR6913278	Mesomycoplasma hyopneumoniae	2099	S	12	16	28	0.00002
ERR6913278	Spiroplasma platyhelix	301585	S	26	5	31	0.00002
ERR6913278	Spiroplasma endosymbiont of 'Nebria riversi'	2792084	S	9	1	10	0.00001
ERR6913278	Williamsoniiplasma luminosum	214888	S	35	6	41	0.00003
ERR6913278	Entomoplasma melaleucae	81459	S	17	4	21	0.00002
ERR6913278	Mesoplasma syrphidae	225999	S	9	2	11	0.00001
ERR6913278	Haploplasma axanthum	29552	S	23	6	29	0.00002
ERR6913278	Mariniplasma anaerobium	2735436	S	7	1	8	0.00001
ERR6913278	Paracholeplasma brassicae	61635	S	5	4	9	0.00001
ERR6913278	Metamycoplasma orale	2121	S	123	78	201	0.00016
ERR6913278	Metamycoplasma hyosynoviae	29559	S	9	4	13	0.00001
ERR6913278	Metamycoplasma hominis	2098	S	7	4	11	0.00001
ERR6913278	Metamycoplasma salivarium	2124	S	5	3	8	0.00001
ERR6913278	Malacoplasma penetrans	28227	S	6	0	6	0.00000
ERR6913278	Brevefilum fermentans	1986204	S	13	0	13	0.00001
ERR6913278	Pelolinea submarina	913107	S	9	0	9	0.00001
ERR6913278	Candidatus Promineofilum breve	1806508	S	7	0	7	0.00001
ERR6913278	Phototrophicus methaneseepsis	2710758	S	7	0	7	0.00001
ERR6913278	Caldilinea aerophila	133453	S	6	0	6	0.00000
ERR6913278	Thermus caldilimi	2483360	S	97	10	107	0.00008
ERR6913278	Allomeiothermus silvanus	52022	S	38	0	38	0.00003
ERR6913278	Fimbriimonas ginsengisoli	1005039	S	8	0	8	0.00001
ERR6913278	Prevotella sp. oral taxon 299	652716	S	15322	4929	20251	0.01589
ERR6913278	Prevotella sp. oral taxon 475	712471	S	8258	1494	9752	0.00765
ERR6913278	Prevotella sp. Rep29	2691580	S	1271	328	1599	0.00126
ERR6913278	Prevotella sp. E13-17	2913616	S	641	745	1386	0.00109
ERR6913278	Prevotella sp. E9-3	2913621	S	419	464	883	0.00069
ERR6913278	Prevotella sp. E15-22	2937774	S	378	833	1211	0.00095
ERR6913278	Prevotella sp. E2-28	2913620	S	23	40	63	0.00005
ERR6913278	Prevotella melaninogenica	28132	S	28746	26683	55429	0.04351
ERR6913278	Prevotella oris	28135	S	6897	2263	9160	0.00719
ERR6913278	Prevotella scopos	589437	S	4680	6924	11604	0.00911
ERR6913278	Prevotella jejuni	1177574	S	4099	4958	9057	0.00711
ERR6913278	Prevotella veroralis	28137	S	3989	3044	7033	0.00552
ERR6913278	Prevotella intermedia	28131	S	3093	3188	6281	0.00493
ERR6913278	Prevotella herbatica	2801997	S	2652	99	2751	0.00216
ERR6913278	Prevotella histicola	470565	S	1761	821	2582	0.00203
ERR6913278	Prevotella copri	165179	S	1504	207	1711	0.00134
ERR6913278	Prevotella dentalis	52227	S	1477	392	1869	0.00147
ERR6913278	Prevotella ruminicola	839	S	1404	76	1480	0.00116
ERR6913278	Prevotella nigrescens	28133	S	1387	1954	3341	0.00262
ERR6913278	Prevotella fusca	589436	S	1288	878	2166	0.00170
ERR6913278	Prevotella denticola	28129	S	1232	26743	27975	0.02196
ERR6913278	Prevotella corporis	28128	S	926	610	1536	0.00121
ERR6913278	Prevotella bryantii	77095	S	551	40	591	0.00046
ERR6913278	Prevotella multiformis	282402	S	279	374	653	0.00051
ERR6913278	Pseudoprevotella muciniphila	2133944	S	28119	1585	29704	0.02331
ERR6913278	Paraprevotella xylaniphila	454155	S	5412	1577	6989	0.00549
ERR6913278	Hoylesella enoeca	76123	S	985	1510	2495	0.00196
ERR6913278	Hoylesella buccalis	28127	S	760	1501	2261	0.00177
ERR6913278	Porphyromonas sp. oral taxon 275	712435	S	80923	7364	88287	0.06930
ERR6913278	Porphyromonas endodontalis	28124	S	2850	876	3726	0.00292
ERR6913278	Porphyromonas cangingivalis	36874	S	508	348	856	0.00067
ERR6913278	Porphyromonas asaccharolytica	28123	S	244	162	406	0.00032
ERR6913278	Porphyromonas gingivalis	837	S	200	147	347	0.00027
ERR6913278	Porphyromonas crevioricanis	393921	S	166	72	238	0.00019
ERR6913278	Porphyromonas somerae	322095	S	79	57	136	0.00011
ERR6913278	Bacteroides stercoris	46506	S	2168	928	3096	0.00243
ERR6913278	Bacteroides heparinolyticus	28113	S	1910	792	2702	0.00212
ERR6913278	Bacteroides zoogleoformans	28119	S	1024	461	1485	0.00117
ERR6913278	Bacteroides caccae	47678	S	904	357	1261	0.00099
ERR6913278	Bacteroides salyersiae	291644	S	415	116	531	0.00042
ERR6913278	Bacteroides faecium	2715212	S	409	63	472	0.00037
ERR6913278	Bacteroides xylanisolvens	371601	S	344	1257	1601	0.00126
ERR6913278	Bacteroides ovatus	28116	S	295	5423	5718	0.00449
ERR6913278	Bacteroides fragilis	817	S	293	396	689	0.00054
ERR6913278	Bacteroides uniformis	820	S	114	311	425	0.00033
ERR6913278	Bacteroides thetaiotaomicron	818	S	65	2566	2631	0.00207
ERR6913278	Bacteroides intestinalis	329854	S	62	19	81	0.00006
ERR6913278	Bacteroides helcogenes	290053	S	22	1	23	0.00002
ERR6913278	Bacteroides faecis	674529	S	20	16	36	0.00003
ERR6913278	Bacteroides eggerthii	28111	S	19	13	32	0.00003
ERR6913278	Bacteroides cellulosilyticus	246787	S	11	15	26	0.00002
ERR6913278	Bacteroides coprosuis	151276	S	9	0	9	0.00001
ERR6913278	Bacteroides zhangwenhongii	2650157	S	8	5	13	0.00001
ERR6913278	Phocaeicola dorei	357276	S	2639	3105	5744	0.00451
ERR6913278	Phocaeicola salanitronis	376805	S	1840	334	2174	0.00171
ERR6913278	Phocaeicola coprophilus	387090	S	1351	892	2243	0.00176
ERR6913278	Phocaeicola vulgatus	821	S	245	337	582	0.00046
ERR6913278	Tannerella serpentiformis	712710	S	7455	624	8079	0.00634
ERR6913278	Tannerella forsythia	28112	S	266	67	333	0.00026
ERR6913278	Parabacteroides merdae	46503	S	52	34	86	0.00007
ERR6913278	Parabacteroides johnsonii	387661	S	42	19	61	0.00005
ERR6913278	Parabacteroides goldsteinii	328812	S	24	6	30	0.00002
ERR6913278	Parabacteroides faecis	1217282	S	22	3	25	0.00002
ERR6913278	Parabacteroides distasonis	823	S	17	77	94	0.00007
ERR6913278	Coprobacter secundus	1501392	S	3035	777	3812	0.00299
ERR6913278	Barnesiella viscericola	397865	S	56	12	68	0.00005
ERR6913278	Alistipes onderdonkii	328813	S	207	1371	1578	0.00124
ERR6913278	Alistipes communis	2585118	S	65	141	206	0.00016
ERR6913278	Alistipes megaguti	2364787	S	34	42	76	0.00006
ERR6913278	Alistipes shahii	328814	S	15	188	203	0.00016
ERR6913278	Alistipes finegoldii	214856	S	12	143	155	0.00012
ERR6913278	Alistipes senegalensis	1288121	S	11	73	84	0.00007
ERR6913278	Alistipes indistinctus	626932	S	8	3	11	0.00001
ERR6913278	Alistipes dispar	2585119	S	6	12	18	0.00001
ERR6913278	Odoribacter splanchnicus	28118	S	1735	403	2138	0.00168
ERR6913278	Butyricimonas virosa	544645	S	24	79	103	0.00008
ERR6913278	Muribaculum intestinale	1796646	S	486	27	513	0.00040
ERR6913278	Muribaculum gordoncarteri	2530390	S	199	14	213	0.00017
ERR6913278	Duncaniella dubosii	2518971	S	50	547	597	0.00047
ERR6913278	Sodaliphilus pleomorphus	2606626	S	187	16	203	0.00016
ERR6913278	Paludibacter propionicigenes	185300	S	412	6	418	0.00033
ERR6913278	Tenuifilum thalassicum	2590900	S	345	4	349	0.00027
ERR6913278	Proteiniphilum propionicum	2829812	S	112	35	147	0.00012
ERR6913278	Proteiniphilum saccharofermentans	1642647	S	8	2	10	0.00001
ERR6913278	Petrimonas mucosa	1642646	S	39	53	92	0.00007
ERR6913278	Salinivirga cyanobacteriivorans	1307839	S	302	2	304	0.00024
ERR6913278	Candidatus Azobacteroides pseudotrichonymphae	511435	S	238	1	239	0.00019
ERR6913278	Maribellus comscasis	2681766	S	6	6	12	0.00001
ERR6913278	Alkaliflexus sp. Ai-910	2949635	S	9	6	15	0.00001
ERR6913278	Alkalitalea saponilacus	889453	S	9	0	9	0.00001
ERR6913278	Capnocytophaga gingivalis	1017	S	12724	1549	14273	0.01120
ERR6913278	Capnocytophaga leadbetteri	327575	S	6004	3958	9962	0.00782
ERR6913278	Capnocytophaga sp. FDAARGOS_737	2545799	S	2642	1680	4322	0.00339
ERR6913278	Capnocytophaga sp. oral taxon 878	1316596	S	1501	419	1920	0.00151
ERR6913278	Capnocytophaga sp. H2931	1945657	S	40	34	74	0.00006
ERR6913278	Capnocytophaga sp. oral taxon 864	1316593	S	18	49	67	0.00005
ERR6913278	Capnocytophaga sp. oral taxon 323	1705617	S	10	30	40	0.00003
ERR6913278	Capnocytophaga sp. H4358	1945658	S	9	7	16	0.00001
ERR6913278	Capnocytophaga sp. oral taxon 902	2748316	S	9	44	53	0.00004
ERR6913278	Capnocytophaga sputigena	1019	S	1292	509	1801	0.00141
ERR6913278	Capnocytophaga haemolytica	45243	S	236	22	258	0.00020
ERR6913278	Capnocytophaga ochracea	1018	S	59	21679	21738	0.01706
ERR6913278	Capnocytophaga endodontalis	2708117	S	52	31	83	0.00007
ERR6913278	Capnocytophaga canimorsus	28188	S	8	2	10	0.00001
ERR6913278	Capnocytophaga stomatis	1848904	S	6	1	7	0.00001
ERR6913278	Capnocytophaga cynodegmi	28189	S	5	1	6	0.00000
ERR6913278	Flavobacterium sp. I3-2	2748319	S	9	69	78	0.00006
ERR6913278	Flavobacterium davisii	2906077	S	53	270	323	0.00025
ERR6913278	Flavobacterium psychrophilum	96345	S	26	44	70	0.00005
ERR6913278	Flavobacterium oreochromis	2906078	S	12	59	71	0.00006
ERR6913278	Muricauda aurantiaca	1383885	S	443	153	596	0.00047
ERR6913278	Muricauda lutaonensis	516051	S	6	5	11	0.00001
ERR6913278	Amniculibacterium sp. G2-70	2767188	S	230	214	444	0.00035
ERR6913278	Abyssalbus ytuae	2926907	S	107	17	124	0.00010
ERR6913278	Salinimicrobium sp. HN-2-9-2	2809707	S	93	37	130	0.00010
ERR6913278	Nonlabens spongiae	331648	S	55	72	127	0.00010
ERR6913278	Aquimarina sp. TRL1	2736252	S	14	2	16	0.00001
ERR6913278	Gramella forsetii	411153	S	9	6	15	0.00001
ERR6913278	Kordia antarctica	1218801	S	5	10	15	0.00001
ERR6913278	Psychroflexus sp. ALD_RP9	2777186	S	9	2	11	0.00001
ERR6913278	Winogradskyella schleiferi	2686078	S	5	9	14	0.00001
ERR6913278	Olleya sp. Bg11-27	2058135	S	7	86	93	0.00007
ERR6913278	Zunongwangia sp. SCSIO 43204	2779359	S	5	11	16	0.00001
ERR6913278	Croceibacter atlanticus	313588	S	6	4	10	0.00001
ERR6913278	Oceanihabitans sp. IOP_32	2529032	S	6	7	13	0.00001
ERR6913278	Mesoflavibacter sp. SCSIO 43206	2779362	S	6	11	17	0.00001
ERR6913278	Chryseobacterium sp. POL2	2713414	S	382	741	1123	0.00088
ERR6913278	Chryseobacterium sp. CY350	2997336	S	370	488	858	0.00067
ERR6913278	Chryseobacterium sp. 3008163	2478663	S	11	41	52	0.00004
ERR6913278	Chryseobacterium sp. G0186	2487064	S	9	34	43	0.00003
ERR6913278	Chryseobacterium sp. CX-624	2758037	S	7	2	9	0.00001
ERR6913278	Chryseobacterium sp. 6424	2039166	S	5	7	12	0.00001
ERR6913278	Chryseobacterium camelliae	1265445	S	433	561	994	0.00078
ERR6913278	Chryseobacterium arthrosphaerae	651561	S	93	275	368	0.00029
ERR6913278	Chryseobacterium aureum	2497456	S	76	211	287	0.00023
ERR6913278	Chryseobacterium taklimakanense	536441	S	28	67	95	0.00007
ERR6913278	Chryseobacterium indologenes	253	S	8	24	32	0.00003
ERR6913278	Chryseobacterium manosquense	2754694	S	6	29	35	0.00003
ERR6913278	Chryseobacterium indoltheticum	254	S	5	14	19	0.00001
ERR6913278	Chryseobacterium lactis	1241981	S	5	11	16	0.00001
ERR6913278	Candidatus Kaistella beijingensis	2820270	S	85	194	279	0.00022
ERR6913278	Kaistella flava (ex Peng et al. 2021)	2038776	S	6	5	11	0.00001
ERR6913278	Kaistella daneshvariae	2487074	S	6	3	9	0.00001
ERR6913278	Epilithonimonas vandammei	2487072	S	9	42	51	0.00004
ERR6913278	Elizabethkingia sp. JS20170427COW	2583851	S	51	362	413	0.00032
ERR6913278	Elizabethkingia meningoseptica	238	S	5	634	639	0.00050
ERR6913278	Riemerella anatipestifer	34085	S	880	299	1179	0.00093
ERR6913278	Bergeyella cardium	1585976	S	872	255	1127	0.00088
ERR6913278	Apibacter raozihei	2500547	S	20	78	98	0.00008
ERR6913278	Empedobacter falsenii	343874	S	6	5	11	0.00001
ERR6913278	Ornithobacterium rhinotracheale	28251	S	10	2	12	0.00001
ERR6913278	Blattabacterium cuenoti	1653831	S	35	4	39	0.00003
ERR6913278	Blattabacterium sp. (Blatta orientalis)	367806	S	23	33	56	0.00004
ERR6913278	Fluviicola taffensis	191579	S	69	2	71	0.00006
ERR6913278	Paracrocinitomix mangrovi	2862509	S	6	0	6	0.00000
ERR6913278	Croceimicrobium hydrocarbonivorans	2761580	S	5	49	54	0.00004
ERR6913278	Candidatus Karelsulcia muelleri	336810	S	15	2	17	0.00001
ERR6913278	Candidatus Walczuchella monophlebidarum	1415657	S	6	0	6	0.00000
ERR6913278	Parvicella tangerina	2829795	S	10	0	10	0.00001
ERR6913278	Spirosoma sp. KUDC1026	2745947	S	93	333	426	0.00033
ERR6913278	Spirosoma montaniterrae	1178516	S	31	125	156	0.00012
ERR6913278	Spirosoma pollinicola	2057025	S	13	24	37	0.00003
ERR6913278	Spirosoma rhododendri	2728024	S	11	54	65	0.00005
ERR6913278	Tellurirhabdus rosea	2674997	S	12	394	406	0.00032
ERR6913278	Hymenobacter sp. BT18	2835648	S	28	31	59	0.00005
ERR6913278	Hymenobacter sp. YIM 151858-1	2987688	S	6	13	19	0.00001
ERR6913278	Hymenobacter sp. 5413J-13	2932251	S	6	5	11	0.00001
ERR6913278	Hymenobacter sp. 5317J-9	2932250	S	5	10	15	0.00001
ERR6913278	Hymenobacter monticola	1705399	S	13	23	36	0.00003
ERR6913278	Hymenobacter psoromatis	1484116	S	5	5	10	0.00001
ERR6913278	Hymenobacter oligotrophus	2319843	S	5	12	17	0.00001
ERR6913278	Hymenobacter jejuensis	2502781	S	5	2	7	0.00001
ERR6913278	Pontibacter sp. SGAir0037	2571030	S	26	18	44	0.00003
ERR6913278	Pontibacter actiniarum	323450	S	13	15	28	0.00002
ERR6913278	Rufibacter radiotolerans	1379910	S	7	2	9	0.00001
ERR6913278	Adhaeribacter swui	2086471	S	5	1	6	0.00000
ERR6913278	Nibribacter ruber	2698458	S	5	5	10	0.00001
ERR6913278	Leadbetterella byssophila	316068	S	157	78	235	0.00018
ERR6913278	Dyadobacter fermentans	94254	S	10	35	45	0.00004
ERR6913278	Fibrella sp. ES10-3-2-2	1834519	S	7	4	11	0.00001
ERR6913278	Emticicia sp. 21SJ11W-3	2916755	S	6	1	7	0.00001
ERR6913278	Bernardetia litoralis	999	S	157	21	178	0.00014
ERR6913278	Marivirga tractuosa	1006	S	155	257	412	0.00032
ERR6913278	Mongoliitalea daihaiensis	2782006	S	9	12	21	0.00002
ERR6913278	Aquiflexum balticum	280473	S	8	26	34	0.00003
ERR6913278	Cyclobacterium marinum	104	S	6	7	13	0.00001
ERR6913278	Candidatus Amoebophilus asiaticus	281120	S	12	3	15	0.00001
ERR6913278	Chryseolinea soli	2321403	S	10	2	12	0.00001
ERR6913278	Persicobacter sp. JZB09	1085624	S	13	3	16	0.00001
ERR6913278	Sphingobacterium lactis	797291	S	8	99	107	0.00008
ERR6913278	Mucilaginibacter ginsenosidivorans	398053	S	12	11	23	0.00002
ERR6913278	Mucilaginibacter paludis	423351	S	11	16	27	0.00002
ERR6913278	Mucilaginibacter rubeus	2027860	S	7	73	80	0.00006
ERR6913278	Mucilaginibacter ginkgonis	2682091	S	6	8	14	0.00001
ERR6913278	Solitalea sp. S2-8	2911172	S	11	31	42	0.00003
ERR6913278	Solitalea canadensis	995	S	8	18	26	0.00002
ERR6913278	Arachidicoccus sp. B3-10	2545455	S	9	148	157	0.00012
ERR6913278	Chitinophaga sp. XS-30	2604421	S	19	19	38	0.00003
ERR6913278	Chitinophaga oryzae	2725414	S	8	12	20	0.00002
ERR6913278	Pseudobacter ginsenosidimutans	661488	S	8	6	14	0.00001
ERR6913278	Candidatus Sulfidibacterium hydrothermale	2875962	S	31	0	31	0.00002
ERR6913278	Rhodothermus marinus	29549	S	8	0	8	0.00001
ERR6913278	Salinibacter ruber	146919	S	7	0	7	0.00001
ERR6913278	Haliscomenobacter hydrossis	2350	S	21	3	24	0.00002
ERR6913278	Prosthecochloris aestuarii	1102	S	40	2	42	0.00003
ERR6913278	Cyclonatronum proteinivorum	1457365	S	5	0	5	0.00000
ERR6913278	Fibrobacter succinogenes	833	S	7	0	7	0.00001
ERR6913278	Neisseria mucosa	488	S	43105	133357	176462	0.13850
ERR6913278	Neisseria sicca	490	S	1162	1376	2538	0.00199
ERR6913278	Neisseria meningitidis	487	S	855	55405	56260	0.04416
ERR6913278	Neisseria flavescens	484	S	735	647	1382	0.00108
ERR6913278	Neisseria gonorrhoeae	485	S	717	5641	6358	0.00499
ERR6913278	Neisseria subflava	28449	S	667	644	1311	0.00103
ERR6913278	Neisseria lactamica	486	S	321	663	984	0.00077
ERR6913278	Neisseria sp. oral taxon 014	641148	S	160	120	280	0.00022
ERR6913278	Neisseria sp. KEM232	655307	S	20	6	26	0.00002
ERR6913278	Neisseria sp. ZJ106	2912188	S	14	9	23	0.00002
ERR6913278	Neisseria sp. ZJ785	2709396	S	11	6	17	0.00001
ERR6913278	Neisseria elongata	495	S	209	166	375	0.00029
ERR6913278	Neisseria bacilliformis	267212	S	90	35	125	0.00010
ERR6913278	Neisseria cinerea	483	S	67	52	119	0.00009
ERR6913278	Neisseria musculi	1815583	S	49	6	55	0.00004
ERR6913278	Neisseria macacae	496	S	24	92	116	0.00009
ERR6913278	Neisseria canis	493	S	22	5	27	0.00002
ERR6913278	Neisseria chenwenguii	1853278	S	20	3	23	0.00002
ERR6913278	Neisseria animaloris	326522	S	17	4	21	0.00002
ERR6913278	Neisseria weixii	1853276	S	16	2	18	0.00001
ERR6913278	Neisseria animalis	492	S	15	2	17	0.00001
ERR6913278	Neisseria dentiae	194197	S	14	3	17	0.00001
ERR6913278	Neisseria arctica	1470200	S	14	1	15	0.00001
ERR6913278	Neisseria zalophi	640030	S	13	1	14	0.00001
ERR6913278	Neisseria brasiliensis	2666100	S	8	1	9	0.00001
ERR6913278	Neisseria dumasiana	1931275	S	5	1	6	0.00000
ERR6913278	Simonsiella muelleri	72	S	3020	608	3628	0.00285
ERR6913278	Eikenella corrodens	539	S	815	745	1560	0.00122
ERR6913278	Eikenella exigua	2528037	S	43	42	85	0.00007
ERR6913278	Kingella denitrificans	502	S	527	298	825	0.00065
ERR6913278	Kingella oralis	505	S	506	119	625	0.00049
ERR6913278	Kingella kingae	504	S	96	21	117	0.00009
ERR6913278	Kingella potus	265175	S	5	1	6	0.00000
ERR6913278	Wielerella bovis	2917790	S	554	128	682	0.00054
ERR6913278	Snodgrassella alvi	1196083	S	279	21	300	0.00024
ERR6913278	Alysiella crassa	153491	S	89	52	141	0.00011
ERR6913278	Alysiella filiformis	194196	S	46	26	72	0.00006
ERR6913278	Aquella oligotrophica	2067065	S	54	1	55	0.00004
ERR6913278	Paralysiella testudinis	2809020	S	37	11	48	0.00004
ERR6913278	Morococcus cerebrosus	1056807	S	25	278	303	0.00024
ERR6913278	Conchiformibius steedae	153493	S	15	324	339	0.00027
ERR6913278	Aquaspirillum sp. LM1	1938604	S	408	100	508	0.00040
ERR6913278	Chromobacterium violaceum	536	S	9	27	36	0.00003
ERR6913278	Paludibacterium sp. B53371	2806263	S	6	1	7	0.00001
ERR6913278	Jeongeupia sp. HS-3	1009682	S	5	1	6	0.00000
ERR6913278	Polaromonas naphthalenivorans	216465	S	45	82	127	0.00010
ERR6913278	Comamonas testosteroni	285	S	7	25	32	0.00003
ERR6913278	Comamonas kerstersii	225992	S	6	4	10	0.00001
ERR6913278	Comamonas thiooxydans	363952	S	6	20	26	0.00002
ERR6913278	Ottowia sp. oral taxon 894	1658672	S	31	18	49	0.00004
ERR6913278	Acidovorax carolinensis	553814	S	5	25	30	0.00002
ERR6913278	Acidovorax antarcticus	2743470	S	5	10	15	0.00001
ERR6913278	Variovorax sp. PAMC28562	2762323	S	5	3	8	0.00001
ERR6913278	Variovorax paradoxus	34073	S	6	11	17	0.00001
ERR6913278	Diaphorobacter ruginosibacter	1715720	S	9	12	21	0.00002
ERR6913278	Curvibacter sp. AEP1-3	1844971	S	13	8	21	0.00002
ERR6913278	Limnohabitans sp. 103DPR2	1678129	S	6	5	11	0.00001
ERR6913278	Simplicispira suum	2109915	S	7	13	20	0.00002
ERR6913278	Verminephrobacter eiseniae	364317	S	6	6	12	0.00001
ERR6913278	Kinneretia sp. DAIF2	2714952	S	5	3	8	0.00001
ERR6913278	Burkholderia cenocepacia	95486	S	13	12	25	0.00002
ERR6913278	Burkholderia vietnamiensis	60552	S	11	8	19	0.00001
ERR6913278	Burkholderia multivorans	87883	S	9	1	10	0.00001
ERR6913278	Burkholderia pseudomallei	28450	S	13	363	376	0.00030
ERR6913278	Burkholderia mallei	13373	S	7	1081	1088	0.00085
ERR6913278	Burkholderia thailandensis	57975	S	6	96	102	0.00008
ERR6913278	Lautropia mirabilis	47671	S	49	4	53	0.00004
ERR6913278	Cupriavidus metallidurans	119219	S	10	1	11	0.00001
ERR6913278	Cupriavidus pauculus	82633	S	8	1	9	0.00001
ERR6913278	Cupriavidus taiwanensis	164546	S	6	3	9	0.00001
ERR6913278	Polynucleobacter necessarius	576610	S	7	7	14	0.00001
ERR6913278	Ralstonia solanacearum	305	S	9	11	20	0.00002
ERR6913278	Massilia sp. NP310	2861282	S	11	21	32	0.00003
ERR6913278	Massilia sp. DM-R-R2A-13	2899220	S	6	8	14	0.00001
ERR6913278	Massilia forsythiae	2728020	S	5	5	10	0.00001
ERR6913278	Collimonas fungivorans	158899	S	8	17	25	0.00002
ERR6913278	Collimonas pratensis	279113	S	7	15	22	0.00002
ERR6913278	Collimonas arenae	279058	S	6	7	13	0.00001
ERR6913278	Oxalobacter vibrioformis	933080	S	11	0	11	0.00001
ERR6913278	Oxalobacter aliiformigenes	2946593	S	5	0	5	0.00000
ERR6913278	Undibacterium parvum	401471	S	5	1	6	0.00000
ERR6913278	Alcaligenes faecalis	511	S	5	14	19	0.00001
ERR6913278	Sphaerotilus sulfidivorans	639200	S	5	4	9	0.00001
ERR6913278	Nitrosomonas ureae	44577	S	32	4	36	0.00003
ERR6913278	Denitratisoma oestradiolicum	311182	S	7	3	10	0.00001
ERR6913278	Sulfuritortus calidifontis	1914471	S	5	5	10	0.00001
ERR6913278	Azoarcus sp. KH32C	748247	S	5	1	6	0.00000
ERR6913278	Haemophilus parainfluenzae	729	S	2628	1298	3926	0.00308
ERR6913278	Haemophilus influenzae	727	S	39	97	136	0.00011
ERR6913278	Haemophilus haemolyticus	726	S	33	47	80	0.00006
ERR6913278	Haemophilus sp. oral taxon 036	712310	S	14	25	39	0.00003
ERR6913278	Haemophilus pittmaniae	249188	S	11	3	14	0.00001
ERR6913278	Aggregatibacter sp. 2125159857	2820817	S	303	285	588	0.00046
ERR6913278	Aggregatibacter sp. oral taxon 513	712150	S	30	77	107	0.00008
ERR6913278	Aggregatibacter sp. Marseille-P9115	2866570	S	23	46	69	0.00005
ERR6913278	Aggregatibacter actinomycetemcomitans	714	S	47	14	61	0.00005
ERR6913278	Aggregatibacter aphrophilus	732	S	43	47	90	0.00007
ERR6913278	Aggregatibacter segnis	739	S	17	49	66	0.00005
ERR6913278	Pasteurella multocida	747	S	21	60	81	0.00006
ERR6913278	Mannheimia bovis	2770636	S	5	4	9	0.00001
ERR6913278	Actinobacillus sp. GY-402	2774188	S	10	6	16	0.00001
ERR6913278	Acinetobacter baumannii	470	S	28	271	299	0.00023
ERR6913278	Acinetobacter lwoffii	28090	S	33	58	91	0.00007
ERR6913278	Acinetobacter junii	40215	S	13	3	16	0.00001
ERR6913278	Acinetobacter johnsonii	40214	S	10	11	21	0.00002
ERR6913278	Acinetobacter lanii	2715163	S	10	0	10	0.00001
ERR6913278	Acinetobacter haemolyticus	29430	S	5	2	7	0.00001
ERR6913278	Moraxella osloensis	34062	S	81	22	103	0.00008
ERR6913278	Psychrobacter sanguinis	861445	S	7	54	61	0.00005
ERR6913278	Aquirhabdus parva	2283318	S	11	0	11	0.00001
ERR6913278	Escherichia coli	562	S	90	194	284	0.00022
ERR6913278	Candidatus Annandia pinicola	1345117	S	25	0	25	0.00002
ERR6913278	Klebsiella pneumoniae	573	S	24	93	117	0.00009
ERR6913278	Klebsiella aerogenes	548	S	6	0	6	0.00000
ERR6913278	Klebsiella quasipneumoniae	1463165	S	6	2	8	0.00001
ERR6913278	Salmonella enterica	28901	S	34	827	861	0.00068
ERR6913278	Buchnera aphidicola	9	S	22	0	22	0.00002
ERR6913278	Pantoea agglomerans	549	S	5	4	9	0.00001
ERR6913278	Serratia plymuthica	82996	S	7	9	16	0.00001
ERR6913278	Ewingella americana	41202	S	15	0	15	0.00001
ERR6913278	Morganella morganii	582	S	8	7	15	0.00001
ERR6913278	Pseudomonas psychrotolerans	237610	S	122	90	212	0.00017
ERR6913278	Pseudomonas sp. DY-1	1755504	S	6	5	11	0.00001
ERR6913278	Pseudomonas lurida	244566	S	29	30	59	0.00005
ERR6913278	Pseudomonas fluorescens	294	S	18	51	69	0.00005
ERR6913278	Pseudomonas oryzihabitans	47885	S	15	23	38	0.00003
ERR6913278	Pseudomonas syringae	317	S	6	12	18	0.00001
ERR6913278	Pseudomonas psychrophila	122355	S	5	1	6	0.00000
ERR6913278	Halomonas sp. JS92-SW72	2306583	S	34	11	45	0.00004
ERR6913278	Halomonas sp. KO116	1504981	S	19	6	25	0.00002
ERR6913278	Candidatus Portiera aleyrodidarum	91844	S	8	0	8	0.00001
ERR6913278	Stenotrophomonas maltophilia	40324	S	21	13	34	0.00003
ERR6913278	Stenotrophomonas sp. LM091	1904944	S	13	3	16	0.00001
ERR6913278	Stenotrophomonas rhizophila	216778	S	5	1	6	0.00000
ERR6913278	Xanthomonas campestris	339	S	33	16	49	0.00004
ERR6913278	Lysobacter enzymogenes	69	S	5	3	8	0.00001
ERR6913278	Pseudoalteromonas phenolica	161398	S	6	6	12	0.00001
ERR6913278	Shewanella inventionis	1738770	S	5	17	22	0.00002
ERR6913278	Vibrio cholerae	666	S	18	96	114	0.00009
ERR6913278	Photobacterium damselae	38293	S	7	2	9	0.00001
ERR6913278	Photobacterium sp. TLY01	2907534	S	5	0	5	0.00000
ERR6913278	Cardiobacterium hominis	2718	S	47	11	58	0.00005
ERR6913278	Cardiobacterium sp. Marseille-Q4385	2866573	S	13	3	16	0.00001
ERR6913278	Rheinheimera sp. MM224	3019969	S	25	8	33	0.00003
ERR6913278	Rheinheimera sp. D18	2545632	S	6	1	7	0.00001
ERR6913278	Aeromonas salmonicida	645	S	16	13	29	0.00002
ERR6913278	Aeromonas media	651	S	6	13	19	0.00001
ERR6913278	Aeromonas veronii	654	S	5	9	14	0.00001
ERR6913278	Microbulbifer aggregans	1769779	S	5	1	6	0.00000
ERR6913278	Oceanicoccus sagamiensis	716816	S	6	0	6	0.00000
ERR6913278	Candidatus Baumannia cicadellinicola	186490	S	8	0	8	0.00001
ERR6913278	Sphingomonas sp. AAP5	1523415	S	444	132	576	0.00045
ERR6913278	Sphingobium cloacae	120107	S	33	34	67	0.00005
ERR6913278	Aquisediminimonas profunda	1550733	S	5	0	5	0.00000
ERR6913278	Sphingosinicella microcystinivorans	335406	S	9	2	11	0.00001
ERR6913278	Mesorhizobium terrae	2725666	S	40	68	108	0.00008
ERR6913278	Terrihabitans soli	708113	S	89	31	120	0.00009
ERR6913278	Candidatus Hodgkinia cicadicola	573658	S	7	0	7	0.00001
ERR6913278	Bradyrhizobium sp. SK17	2057741	S	19	21	40	0.00003
ERR6913278	Bradyrhizobium sp. 200	2782665	S	5	3	8	0.00001
ERR6913278	Bradyrhizobium sp. CCBAU 051011	858422	S	5	4	9	0.00001
ERR6913278	Methylobacterium sp. FF17	2984843	S	10	20	30	0.00002
ERR6913278	Hyphomicrobium sp. DMF-1	3019544	S	5	6	11	0.00001
ERR6913278	Candidatus Filomicrobium marinum	1608628	S	5	0	5	0.00000
ERR6913278	Paracoccus sp. MC1862	2760307	S	12	22	34	0.00003
ERR6913278	Paracoccus sp. SCSIO 75233	3017782	S	6	36	42	0.00003
ERR6913278	Paracoccus sp. AK26	2589076	S	5	15	20	0.00002
ERR6913278	Paracoccus sanguinis	1545044	S	20	86	106	0.00008
ERR6913278	Roseivivax sp. THAF30	2587852	S	5	8	13	0.00001
ERR6913278	Azospirillum humicireducens	1226968	S	5	4	9	0.00001
ERR6913278	Nitrospirillum amazonense	28077	S	6	0	6	0.00000
ERR6913278	Formicincola oecophyllae	2558361	S	5	2	7	0.00001
ERR6913278	Rhodospirillum rubrum	1085	S	10	0	10	0.00001
ERR6913278	Pararhodospirillum photometricum	1084	S	5	0	5	0.00000
ERR6913278	Brevundimonas sp. Bb-A	2560058	S	15	37	52	0.00004
ERR6913278	Brevundimonas sp. PAMC22021	2861285	S	7	4	11	0.00001
ERR6913278	Ehrlichia ruminantium	779	S	6	28	34	0.00003
ERR6913278	Kordiimonas sp. SCSIO 12603	2829596	S	36	0	36	0.00003
ERR6913278	Hirschia baltica	2724	S	5	0	5	0.00000
ERR6913278	Hydrogenophilus thermoluteolus	297	S	15	0	15	0.00001
ERR6913278	Fusobacterium pseudoperiodonticum	2663009	S	5956	17859	23815	0.01869
ERR6913278	Fusobacterium nucleatum	851	S	3369	14748	18117	0.01422
ERR6913278	Fusobacterium hwasookii	1583098	S	130	1379	1509	0.00118
ERR6913278	Fusobacterium hominis	2764326	S	130	20	150	0.00012
ERR6913278	Fusobacterium periodonticum	860	S	126	1452	1578	0.00124
ERR6913278	Fusobacterium canifelinum	285729	S	37	141	178	0.00014
ERR6913278	Fusobacterium gastrosuis	1755100	S	29	2	31	0.00002
ERR6913278	Fusobacterium mortiferum	850	S	20	1	21	0.00002
ERR6913278	Fusobacterium sp. oral taxon 203	671211	S	16	110	126	0.00010
ERR6913278	Fusobacterium necrophorum	859	S	15	1	16	0.00001
ERR6913278	Fusobacterium gonidiaformans	849	S	5	1	6	0.00000
ERR6913278	Fusobacterium ulcerans	861	S	5	1	6	0.00000
ERR6913278	Ilyobacter polytropus	167642	S	17	0	17	0.00001
ERR6913278	Leptotrichia sp. oral taxon 212	712357	S	3407	200	3607	0.00283
ERR6913278	Leptotrichia sp. oral taxon 221	712362	S	1495	283	1778	0.00140
ERR6913278	Leptotrichia sp. oral taxon 498	712368	S	58	23	81	0.00006
ERR6913278	Leptotrichia sp. oral taxon 218	712361	S	29	10	39	0.00003
ERR6913278	Leptotrichia sp. oral taxon 847	1785996	S	22	5	27	0.00002
ERR6913278	Leptotrichia wadei	157687	S	2648	763	3411	0.00268
ERR6913278	Leptotrichia hofstadii	157688	S	202	63	265	0.00021
ERR6913278	Leptotrichia shahii	157691	S	99	34	133	0.00010
ERR6913278	Leptotrichia buccalis	40542	S	51	12	63	0.00005
ERR6913278	Leptotrichia trevisanii	109328	S	36	7	43	0.00003
ERR6913278	Leptotrichia hongkongensis	554406	S	36	11	47	0.00004
ERR6913278	Streptobacillus moniliformis	34105	S	22	1	23	0.00002
ERR6913278	Pseudoleptotrichia goodfellowii	157692	S	21	0	21	0.00002
ERR6913278	Sneathia vaginalis	187101	S	19	0	19	0.00001
ERR6913278	Sebaldella termitidis	826	S	7	0	7	0.00001
ERR6913278	Campylobacter concisus	199	S	1342	9	1351	0.00106
ERR6913278	Campylobacter showae	204	S	784	8	792	0.00062
ERR6913278	Campylobacter rectus	203	S	108	1	109	0.00009
ERR6913278	Campylobacter pinnipediorum	1965231	S	84	-84	0	0.00000
ERR6913278	Campylobacter sp. 19-13652	2840180	S	12	0	12	0.00001
ERR6913278	Campylobacter sp. VBCF_01 NA2	2983836	S	10	26	36	0.00003
ERR6913278	Campylobacter gracilis	824	S	61	0	61	0.00005
ERR6913278	Campylobacter jejuni	197	S	51	3758	3809	0.00299
ERR6913278	Campylobacter ureolyticus	827	S	39	0	39	0.00003
ERR6913278	Campylobacter sputorum	206	S	29	0	29	0.00002
ERR6913278	Campylobacter lanienae	75658	S	17	0	17	0.00001
ERR6913278	Campylobacter curvus	200	S	11	48	59	0.00005
ERR6913278	Campylobacter blaseri	2042961	S	11	0	11	0.00001
ERR6913278	Campylobacter insulaenigrae	260714	S	9	0	9	0.00001
ERR6913278	Campylobacter geochelonis	1780362	S	7	0	7	0.00001
ERR6913278	Campylobacter iguaniorum	1244531	S	5	0	5	0.00000
ERR6913278	Helicobacter cinaedi	213	S	64	0	64	0.00005
ERR6913278	Helicobacter pylori	210	S	17	0	17	0.00001
ERR6913278	Wolinella succinogenes	844	S	9	0	9	0.00001
ERR6913278	Sulfurospirillum cavolei	366522	S	34	0	34	0.00003
ERR6913278	Sulfuricurvum kujiense	148813	S	24	0	24	0.00002
ERR6913278	Treponema phagedenis	162	S	334	18	352	0.00028
ERR6913278	Treponema pedis	409322	S	295	17	312	0.00024
ERR6913278	Treponema sp. Marseille-Q4132	2766701	S	59	13	72	0.00006
ERR6913278	Treponema sp. OMZ 857	1643513	S	25	93	118	0.00009
ERR6913278	Treponema sp. OMZ 305	1659192	S	23	68	91	0.00007
ERR6913278	Treponema sp. OMZ 803	120682	S	8	36	44	0.00003
ERR6913278	Treponema sp. OMZ 906	2563662	S	8	36	44	0.00003
ERR6913278	Treponema sp. OMZ 838	1539298	S	6	49	55	0.00004
ERR6913278	Treponema pallidum	160	S	269	1835	2104	0.00165
ERR6913278	Treponema vincentii	69710	S	214	148	362	0.00028
ERR6913278	Treponema denticola	158	S	182	230	412	0.00032
ERR6913278	Treponema brennaborense	81028	S	128	9	137	0.00011
ERR6913278	Treponema medium	58231	S	90	53	143	0.00011
ERR6913278	Treponema putidum	221027	S	86	30	116	0.00009
ERR6913278	Treponema socranskii	53419	S	80	13	93	0.00007
ERR6913278	Treponema parvum	138851	S	51	1	52	0.00004
ERR6913278	Treponema peruense	2787628	S	26	1	27	0.00002
ERR6913278	Treponema primitia	88058	S	24	2	26	0.00002
ERR6913278	Treponema succinifaciens	167	S	22	1	23	0.00002
ERR6913278	Brucepastera parasyntrophica	2880008	S	86	10	96	0.00008
ERR6913278	Entomospira culicis	2719989	S	59	0	59	0.00005
ERR6913278	Thiospirochaeta perfilievii	252967	S	10	0	10	0.00001
ERR6913278	Oceanispirochaeta crateris	2518645	S	5	0	5	0.00000
ERR6913278	Breznakiella homolactica	2798577	S	35	4	39	0.00003
ERR6913278	Gracilinema caldarium	215591	S	31	4	35	0.00003
ERR6913278	Borrelia miyamotoi	47466	S	41	18	59	0.00005
ERR6913278	Candidatus Nanosynbacter sp. HMT-352	2899133	S	292	151	443	0.00035
ERR6913278	Candidatus Nanosynbacter lyticus	2093824	S	5	6	11	0.00001
ERR6913278	Candidatus Saccharimonas aalborgensis	1332188	S	13	0	13	0.00001
ERR6913278	Candidatus Mycosynbacter amalyticus	2665156	S	43	0	43	0.00003
ERR6913278	Candidatus Minimicrobia vallesae	2841264	S	23	10	33	0.00003
ERR6913278	Candidatus Absconditicoccus praedator	2735562	S	279	0	279	0.00022
ERR6913278	Gimesia aquarii	2527964	S	143	35	178	0.00014
ERR6913278	Planctomyces sp. SH-PL14	1632864	S	7	2	9	0.00001
ERR6913278	Calycomorphotria hydatis	2528027	S	7	1	8	0.00001
ERR6913278	Aeoliella mucimassa	2527972	S	38	5	43	0.00003
ERR6913278	Pirellula sp. SH-Sr6A	1632865	S	11	3	14	0.00001
ERR6913278	Thermogutta terrifontis	1331910	S	31	2	33	0.00003
ERR6913278	Humisphaera borealis	2807512	S	7	2	9	0.00001
ERR6913278	Anaerohalosphaera lusitana	1936003	S	5	0	5	0.00000
ERR6913278	Candidatus Uabimicrobium amorphum	2596890	S	5	0	5	0.00000
ERR6913278	Candidatus Rhabdochlamydia oedothoracis	2720720	S	128	3	131	0.00010
ERR6913278	Chlamydiifrater phoenicopteri	2681469	S	63	3	66	0.00005
ERR6913278	Chlamydia suis	83559	S	5	1	6	0.00000
ERR6913278	Ruficoccus sp. ZRK36	2866311	S	35	4	39	0.00003
ERR6913278	Verrucomicrobium sp. GAS474	1882831	S	10	4	14	0.00001
ERR6913278	Verrucomicrobium spinosum	2736	S	6	0	6	0.00000
ERR6913278	Luteolibacter luteus	2728835	S	6	3	9	0.00001
ERR6913278	Akkermansia muciniphila	239935	S	6	4	10	0.00001
ERR6913278	Tichowtungia aerotolerans	2697043	S	39	4	43	0.00003
ERR6913278	Lentisphaera profundi	1658616	S	12	1	13	0.00001
ERR6913278	Pyramidobacter piscolens	638849	S	42	21	63	0.00005
ERR6913278	Jonquetella anthropi	428712	S	10	5	15	0.00001
ERR6913278	Aminobacterium colombiense	81468	S	66	9	75	0.00006
ERR6913278	Fretibacterium fastidiosum	651822	S	6	0	6	0.00000
ERR6913278	Thermovirga lienii	336261	S	72	14	86	0.00007
ERR6913278	Acetomicrobium mobile	97477	S	16	1	17	0.00001
ERR6913278	Thermanaerovibrio acidaminovorans	81462	S	9	1	10	0.00001
ERR6913278	Cloacibacillus porcorum	1197717	S	6	0	6	0.00000
ERR6913278	Aminithiophilus ramosus	3029084	S	14	2	16	0.00001
ERR6913278	Desulfobulbus oligotrophicus	1909699	S	5	2	7	0.00001
ERR6913278	Syntrophobacter fumaroxidans	119484	S	6	2	8	0.00001
ERR6913278	Pseudothermotoga thermarum	119394	S	97	0	97	0.00008
ERR6913278	Tepiditoga spiralis	2108365	S	5	13	18	0.00001
ERR6913278	Polyangium aurulentum	2567896	S	5	4	9	0.00001
ERR6913278	Labilithrix luteola	1391654	S	7	0	7	0.00001
ERR6913278	Granulicella sp. WH15	2602070	S	10	0	10	0.00001
ERR6913278	Chloracidobacterium validum	2821543	S	5	2	7	0.00001
ERR6913278	Bdellovibrio bacteriovorus	959	S	33	1	34	0.00003
ERR6913278	Nitrospira moscoviensis	42253	S	9	2	11	0.00001
ERR6913278	Endomicrobium proavitum	1408281	S	7	3	10	0.00001
ERR6913278	Phaeodactylum tricornutum	2850	S	404	16	420	0.00033
ERR6913278	Thalassiosira pseudonana	35128	S	287	19	306	0.00024
ERR6913278	Plasmodium malariae	5858	S	9	3	12	0.00001
ERR6913278	Plasmodium yoelii	5861	S	5	5	10	0.00001
ERR6913278	Babesia microti	5868	S	7	11	18	0.00001
ERR6913278	Toxoplasma gondii	5811	S	11	9	20	0.00002
ERR6913278	Cryptosporidium parvum	5807	S	6	0	6	0.00000
ERR6913278	Bigelowiella natans	227086	S	26	9	35	0.00003
ERR6913278	Fusarium pseudograminearum	101028	S	5	10	15	0.00001
ERR6913278	Neurospora crassa	5141	S	5	2	7	0.00001
ERR6913278	Penicillium oxalicum	69781	S	5	9	14	0.00001
ERR6913278	Zymoseptoria tritici	1047171	S	7	3	10	0.00001
ERR6913278	Malassezia restricta	76775	S	53	7	60	0.00005
ERR6913278	Puccinia triticina	208348	S	5	3	8	0.00001
ERR6913278	Homo sapiens	9606	S	164	12	176	0.00014
ERR6913278	Guillardia theta	55529	S	24	13	37	0.00003
ERR6913278	Cryptomonas paramecium	2898	S	18	3	21	0.00002
ERR6913278	Leishmania mexicana	5665	S	7	14	21	0.00002
ERR6913278	Trypanosoma brucei	5691	S	5	-5	0	0.00000
ERR6913278	Trichomonas vaginalis	5722	S	9	0	9	0.00001
ERR6913278	Dictyostelium discoideum	44689	S	5	1	6	0.00000
ERR6913278	Halapricum salinum	1457250	S	5	2	7	0.00001
ERR6913278	Streptococcus phage PH15	537874	S	8	1	9	0.00001
ERR6913278	Streptococcus phage YMC-2011	1051631	S	5	1	6	0.00000
ERR6913101	Klebsiella pneumoniae	573	S	8950	31525	40475	0.33502
ERR6913101	Klebsiella quasipneumoniae	1463165	S	112	63	175	0.00145
ERR6913101	Klebsiella variicola	244366	S	64	79	143	0.00118
ERR6913101	Klebsiella michiganensis	1134687	S	37	103	140	0.00116
ERR6913101	Klebsiella aerogenes	548	S	24	2	26	0.00022
ERR6913101	Klebsiella oxytoca	571	S	19	1	20	0.00017
ERR6913101	Klebsiella africana	2489010	S	17	2	19	0.00016
ERR6913101	Klebsiella quasivariicola	2026240	S	13	2	15	0.00012
ERR6913101	Klebsiella grimontii	2058152	S	11	17	28	0.00023
ERR6913101	Klebsiella huaxiensis	2153354	S	8	0	8	0.00007
ERR6913101	Raoultella terrigena	577	S	6	0	6	0.00005
ERR6913101	Raoultella ornithinolytica	54291	S	6	4	10	0.00008
ERR6913101	Escherichia coli	562	S	578	908	1486	0.01230
ERR6913101	Enterobacter cloacae	550	S	8	74	82	0.00068
ERR6913101	Citrobacter portucalensis	1639133	S	8	4	12	0.00010
ERR6913101	Citrobacter freundii	546	S	6	5	11	0.00009
ERR6913101	Salmonella enterica	28901	S	22	182	204	0.00169
ERR6913101	Pluralibacter gergoviae	61647	S	8	0	8	0.00007
ERR6913101	Pantoea agglomerans	549	S	11	6	17	0.00014
ERR6913101	Buchnera aphidicola	9	S	9	0	9	0.00007
ERR6913101	Morganella morganii	582	S	12	3	15	0.00012
ERR6913101	Haemophilus parainfluenzae	729	S	1900	887	2787	0.02307
ERR6913101	Haemophilus parahaemolyticus	735	S	638	147	785	0.00650
ERR6913101	Haemophilus haemolyticus	726	S	41	46	87	0.00072
ERR6913101	Haemophilus influenzae	727	S	35	154	189	0.00156
ERR6913101	Haemophilus sp. oral taxon 036	712310	S	6	8	14	0.00012
ERR6913101	Mannheimia ovis	2679994	S	43	31	74	0.00061
ERR6913101	Mannheimia haemolytica	75985	S	7	2	9	0.00007
ERR6913101	Actinobacillus indolicus	51049	S	20	37	57	0.00047
ERR6913101	Actinobacillus sp. GY-402	2774188	S	9	3	12	0.00010
ERR6913101	Actinobacillus suis	716	S	6	14	20	0.00017
ERR6913101	Aggregatibacter aphrophilus	732	S	9	3	12	0.00010
ERR6913101	Aggregatibacter actinomycetemcomitans	714	S	6	77	83	0.00069
ERR6913101	Aggregatibacter segnis	739	S	6	6	12	0.00010
ERR6913101	Pasteurella multocida	747	S	10	40	50	0.00041
ERR6913101	Pasteurella atlantica	2827233	S	6	0	6	0.00005
ERR6913101	Stenotrophomonas maltophilia	40324	S	1077	266	1343	0.01112
ERR6913101	Stenotrophomonas sp. ASS1	2282124	S	6	7	13	0.00011
ERR6913101	Stenotrophomonas acidaminiphila	128780	S	7	2	9	0.00007
ERR6913101	Stenotrophomonas pavanii	487698	S	6	63	69	0.00057
ERR6913101	Stenotrophomonas rhizophila	216778	S	5	0	5	0.00004
ERR6913101	Xanthomonas campestris	339	S	119	32	151	0.00125
ERR6913101	Lysobacter enzymogenes	69	S	13	3	16	0.00013
ERR6913101	Lysobacter capsici	435897	S	7	5	12	0.00010
ERR6913101	Luteimonas sp. YGD11-2	2508168	S	7	1	8	0.00007
ERR6913101	Arenimonas daejeonensis	370777	S	5	0	5	0.00004
ERR6913101	Acinetobacter junii	40215	S	921	100	1021	0.00845
ERR6913101	Acinetobacter johnsonii	40214	S	63	36	99	0.00082
ERR6913101	Acinetobacter sp. TR11	3003393	S	8	4	12	0.00010
ERR6913101	Acinetobacter sp. WCHA45	2004644	S	8	2	10	0.00008
ERR6913101	Acinetobacter baumannii	470	S	14	48	62	0.00051
ERR6913101	Acinetobacter haemolyticus	29430	S	13	2	15	0.00012
ERR6913101	Acinetobacter lwoffii	28090	S	9	6	15	0.00012
ERR6913101	Acinetobacter ursingii	108980	S	8	6	14	0.00012
ERR6913101	Acinetobacter indicus	756892	S	5	0	5	0.00004
ERR6913101	Moraxella osloensis	34062	S	114	3	117	0.00097
ERR6913101	Moraxella catarrhalis	480	S	19	0	19	0.00016
ERR6913101	Moraxella nonliquefaciens	478	S	6	0	6	0.00005
ERR6913101	Psychrobacter sanguinis	861445	S	7	0	7	0.00006
ERR6913101	Vibrio fluvialis	676	S	576	272	848	0.00702
ERR6913101	Vibrio kanaloae	170673	S	165	41	206	0.00171
ERR6913101	Vibrio plantisponsor	664643	S	164	4	168	0.00139
ERR6913101	Vibrio parahaemolyticus	670	S	9	1	10	0.00008
ERR6913101	Vibrio alginolyticus	663	S	6	12	18	0.00015
ERR6913101	Vibrio furnissii	29494	S	24	1	25	0.00021
ERR6913101	Vibrio cholerae	666	S	17	6	23	0.00019
ERR6913101	Vibrio toranzoniae	1194427	S	9	2	11	0.00009
ERR6913101	Vibrio vulnificus	672	S	6	0	6	0.00005
ERR6913101	Vibrio cincinnatiensis	675	S	5	0	5	0.00004
ERR6913101	Vibrio ziniensis	2711221	S	5	0	5	0.00004
ERR6913101	Pseudomonas sp. FDAARGOS_380	2018067	S	31	44	75	0.00062
ERR6913101	Pseudomonas sp. T1-3-2	2908006	S	19	2	21	0.00017
ERR6913101	Pseudomonas sp. PIA16	2931382	S	11	2	13	0.00011
ERR6913101	Pseudomonas fluorescens	294	S	47	13	60	0.00050
ERR6913101	Pseudomonas protegens	380021	S	9	4	13	0.00011
ERR6913101	Pseudomonas azotoformans	47878	S	9	3	12	0.00010
ERR6913101	Pseudomonas synxantha	47883	S	8	2	10	0.00008
ERR6913101	Pseudomonas moraviensis	321662	S	5	2	7	0.00006
ERR6913101	Pseudomonas libanensis	75588	S	5	2	7	0.00006
ERR6913101	Pseudomonas orientalis	76758	S	5	0	5	0.00004
ERR6913101	Pseudomonas veronii	76761	S	5	4	9	0.00007
ERR6913101	Pseudomonas aeruginosa	287	S	26	148	174	0.00144
ERR6913101	Pseudomonas mendocina	300	S	9	1	10	0.00008
ERR6913101	Pseudomonas citronellolis	53408	S	9	3	12	0.00010
ERR6913101	Pseudomonas putida	303	S	31	92	123	0.00102
ERR6913101	Pseudomonas fulva	47880	S	6	2	8	0.00007
ERR6913101	Pseudomonas syringae	317	S	11	11	22	0.00018
ERR6913101	Pseudomonas simiae	321846	S	27	2	29	0.00024
ERR6913101	Pseudomonas chlororaphis	587753	S	11	4	15	0.00012
ERR6913101	Pseudomonas fragi	296	S	10	1	11	0.00009
ERR6913101	Pseudomonas eucalypticola	2599595	S	20	1	21	0.00017
ERR6913101	Pseudomonas extremaustralis	359110	S	12	0	12	0.00010
ERR6913101	Pseudomonas sediminis	1691904	S	9	0	9	0.00007
ERR6913101	Pseudomonas taetrolens	47884	S	5	0	5	0.00004
ERR6913101	Pseudomonas psychrotolerans	237610	S	5	0	5	0.00004
ERR6913101	Pseudomonas palleroniana	191390	S	5	0	5	0.00004
ERR6913101	Pseudomonas parafulva	157782	S	5	0	5	0.00004
ERR6913101	Pseudomonas tritici	2745518	S	5	0	5	0.00004
ERR6913101	Stutzerimonas stutzeri	316	S	39	10	49	0.00041
ERR6913101	Stutzerimonas balearica	74829	S	5	0	5	0.00004
ERR6913101	Stutzerimonas decontaminans	3022791	S	5	0	5	0.00004
ERR6913101	Shewanella algae	38313	S	222	78	300	0.00248
ERR6913101	Pseudoalteromonas prydzensis	182141	S	101	9	110	0.00091
ERR6913101	Pseudoalteromonas rhizosphaerae	2518973	S	24	2	26	0.00022
ERR6913101	Pseudoalteromonas mariniglutinosa	206042	S	10	16	26	0.00022
ERR6913101	Psychrosphaera aestuarii	1266052	S	8	0	8	0.00007
ERR6913101	Idiomarina loihiensis	135577	S	6	0	6	0.00005
ERR6913101	Rheinheimera sp. D18	2545632	S	25	0	25	0.00021
ERR6913101	Rheinheimera sp. F8	1763998	S	12	0	12	0.00010
ERR6913101	Rheinheimera sp. MM224	3019969	S	6	2	8	0.00007
ERR6913101	Aeromonas hydrophila	644	S	5	10	15	0.00012
ERR6913101	Aeromonas caviae	648	S	5	23	28	0.00023
ERR6913101	Methylomicrobium album	39775	S	7	0	7	0.00006
ERR6913101	Cardiobacterium hominis	2718	S	15	3	18	0.00015
ERR6913101	Neisseria sicca	490	S	460	947	1407	0.01165
ERR6913101	Neisseria mucosa	488	S	416	2145	2561	0.02120
ERR6913101	Neisseria subflava	28449	S	233	369	602	0.00498
ERR6913101	Neisseria flavescens	484	S	199	289	488	0.00404
ERR6913101	Neisseria arctica	1470200	S	173	19	192	0.00159
ERR6913101	Neisseria meningitidis	487	S	126	1020	1146	0.00949
ERR6913101	Neisseria lactamica	486	S	50	91	141	0.00117
ERR6913101	Neisseria elongata	495	S	50	52	102	0.00084
ERR6913101	Neisseria gonorrhoeae	485	S	34	356	390	0.00323
ERR6913101	Neisseria sp. oral taxon 014	641148	S	16	18	34	0.00028
ERR6913101	Neisseria sp. ZJ106	2912188	S	7	1	8	0.00007
ERR6913101	Neisseria cinerea	483	S	25	31	56	0.00046
ERR6913101	Neisseria macacae	496	S	11	71	82	0.00068
ERR6913101	Neisseria bacilliformis	267212	S	7	3	10	0.00008
ERR6913101	Neisseria brasiliensis	2666100	S	5	1	6	0.00005
ERR6913101	Kingella denitrificans	502	S	20	15	35	0.00029
ERR6913101	Kingella oralis	505	S	5	1	6	0.00005
ERR6913101	Eikenella corrodens	539	S	9	9	18	0.00015
ERR6913101	Morococcus cerebrosus	1056807	S	9	168	177	0.00147
ERR6913101	Aquella oligotrophica	2067065	S	5	0	5	0.00004
ERR6913101	Chromobacterium vaccinii	1108595	S	5	11	16	0.00013
ERR6913101	Vogesella sp. LIG4	1192162	S	7	3	10	0.00008
ERR6913101	Vogesella sp. XCS3	2877939	S	5	1	6	0.00005
ERR6913101	Paludibacterium sp. B53371	2806263	S	5	1	6	0.00005
ERR6913101	Aquaspirillum sp. LM1	1938604	S	6	1	7	0.00006
ERR6913101	Burkholderia multivorans	87883	S	431	30	461	0.00382
ERR6913101	Burkholderia cenocepacia	95486	S	14	4	18	0.00015
ERR6913101	Burkholderia cepacia	292	S	10	380	390	0.00323
ERR6913101	Burkholderia ubonensis	101571	S	5	0	5	0.00004
ERR6913101	Burkholderia pseudomallei	28450	S	5	4	9	0.00007
ERR6913101	Burkholderia sp. FERM BP-3421	1494466	S	6	0	6	0.00005
ERR6913101	Burkholderia gladioli	28095	S	12	1	13	0.00011
ERR6913101	Burkholderia glumae	337	S	7	0	7	0.00006
ERR6913101	Cupriavidus taiwanensis	164546	S	11	12	23	0.00019
ERR6913101	Cupriavidus sp. EM10	2839983	S	7	2	9	0.00007
ERR6913101	Cupriavidus necator	106590	S	7	4	11	0.00009
ERR6913101	Cupriavidus metallidurans	119219	S	6	1	7	0.00006
ERR6913101	Cupriavidus basilensis	68895	S	5	1	6	0.00005
ERR6913101	Cupriavidus pauculus	82633	S	5	1	6	0.00005
ERR6913101	Polynucleobacter sp. Adler-ghost	2770234	S	5	4	9	0.00007
ERR6913101	Polynucleobacter difficilis	556054	S	21	0	21	0.00017
ERR6913101	Polynucleobacter asymbioticus	576611	S	6	0	6	0.00005
ERR6913101	Polynucleobacter necessarius	576610	S	5	0	5	0.00004
ERR6913101	Lautropia mirabilis	47671	S	58	2	60	0.00050
ERR6913101	Paraburkholderia tropica	92647	S	13	5	18	0.00015
ERR6913101	Ralstonia mannitolilytica	105219	S	17	6	23	0.00019
ERR6913101	Ralstonia solanacearum	305	S	12	14	26	0.00022
ERR6913101	Pandoraea apista	93218	S	5	9	14	0.00012
ERR6913101	Chitinimonas koreensis	356302	S	7	0	7	0.00006
ERR6913101	Acidovorax sp. KKS102	358220	S	16	5	21	0.00017
ERR6913101	Acidovorax sp. T1	1858609	S	13	7	20	0.00017
ERR6913101	Acidovorax sp. JMULE5	2518343	S	12	2	14	0.00012
ERR6913101	Acidovorax temperans	80878	S	23	8	31	0.00026
ERR6913101	Acidovorax radicis	758826	S	12	1	13	0.00011
ERR6913101	Acidovorax carolinensis	553814	S	10	4	14	0.00012
ERR6913101	Acidovorax avenae	80867	S	6	5	11	0.00009
ERR6913101	Variovorax sp. PAMC 28711	1795631	S	11	1	12	0.00010
ERR6913101	Variovorax sp. HW608	1034889	S	6	0	6	0.00005
ERR6913101	Variovorax sp. PBL-H6	434009	S	5	11	16	0.00013
ERR6913101	Variovorax sp. RA8	662548	S	5	4	9	0.00007
ERR6913101	Variovorax paradoxus	34073	S	28	12	40	0.00033
ERR6913101	Variovorax boronicumulans	436515	S	10	8	18	0.00015
ERR6913101	Hydrogenophaga sp. SL48	2806347	S	12	3	15	0.00012
ERR6913101	Hydrogenophaga sp. PBC	795665	S	6	1	7	0.00006
ERR6913101	Hydrogenophaga sp. RAC07	1842537	S	6	1	7	0.00006
ERR6913101	Hydrogenophaga sp. PAMC20947	2565558	S	5	0	5	0.00004
ERR6913101	Hydrogenophaga taeniospiralis	65656	S	8	2	10	0.00008
ERR6913101	Comamonas aquatica	225991	S	8	1	9	0.00007
ERR6913101	Comamonas thiooxydans	363952	S	8	7	15	0.00012
ERR6913101	Comamonas testosteroni	285	S	6	4	10	0.00008
ERR6913101	Rhodoferax sp. AJA081-3	2752316	S	7	0	7	0.00006
ERR6913101	Rhodoferax sp. MIZ03	2798804	S	7	0	7	0.00006
ERR6913101	Rhodoferax koreense	1842727	S	9	1	10	0.00008
ERR6913101	Rhodoferax saidenbachensis	1484693	S	6	0	6	0.00005
ERR6913101	Diaphorobacter sp. HDW4A	2714924	S	25	7	32	0.00026
ERR6913101	Delftia acidovorans	80866	S	9	24	33	0.00027
ERR6913101	Polaromonas naphthalenivorans	216465	S	13	1	14	0.00012
ERR6913101	Ottowia oryzae	2109914	S	7	0	7	0.00006
ERR6913101	Ottowia testudinis	2816950	S	5	0	5	0.00004
ERR6913101	Alicycliphilus denitrificans	179636	S	12	13	25	0.00021
ERR6913101	Ramlibacter tataouinensis	94132	S	12	1	13	0.00011
ERR6913101	Curvibacter sp. AEP1-3	1844971	S	10	0	10	0.00008
ERR6913101	Limnohabitans sp. 63ED37-2	1678128	S	5	0	5	0.00004
ERR6913101	Serpentinimonas raichei	1458425	S	5	1	6	0.00005
ERR6913101	Simplicispira suum	2109915	S	5	0	5	0.00004
ERR6913101	Verminephrobacter eiseniae	364317	S	5	0	5	0.00004
ERR6913101	Massilia sp. H6	2970464	S	7	4	11	0.00009
ERR6913101	Massilia sp. LPB0304	2769491	S	5	6	11	0.00009
ERR6913101	Massilia violaceinigra	2045208	S	6	5	11	0.00009
ERR6913101	Janthinobacterium sp. LM6	1938606	S	8	5	13	0.00011
ERR6913101	Janthinobacterium sp. 1_2014MBL_MicDiv	1644131	S	5	1	6	0.00005
ERR6913101	Janthinobacterium svalbardensis	368607	S	8	5	13	0.00011
ERR6913101	Janthinobacterium lividum	29581	S	6	14	20	0.00017
ERR6913101	Janthinobacterium tructae	2590869	S	5	3	8	0.00007
ERR6913101	Herbaspirillum robiniae	2014887	S	5	4	9	0.00007
ERR6913101	Collimonas fungivorans	158899	S	10	0	10	0.00008
ERR6913101	Achromobacter sp. AONIH1	1758194	S	6	1	7	0.00006
ERR6913101	Achromobacter sp. MFA1 R4	1881016	S	6	2	8	0.00007
ERR6913101	Achromobacter xylosoxidans	85698	S	10	15	25	0.00021
ERR6913101	Achromobacter spanius	217203	S	5	1	6	0.00005
ERR6913101	Bordetella hinzii	103855	S	11	4	15	0.00012
ERR6913101	Bordetella genomosp. 9	1416803	S	6	0	6	0.00005
ERR6913101	Alcaligenes faecalis	511	S	7	1	8	0.00007
ERR6913101	Caldimonas thermodepolymerans	215580	S	11	2	13	0.00011
ERR6913101	Caldimonas brevitalea	413882	S	7	0	7	0.00006
ERR6913101	Schlegelella aquatica	376175	S	15	2	17	0.00014
ERR6913101	Sphaerotilus sp. FB-5	2914710	S	8	0	8	0.00007
ERR6913101	Sphaerotilus sulfidivorans	639200	S	6	0	6	0.00005
ERR6913101	Methylibium petroleiphilum	105560	S	5	1	6	0.00005
ERR6913101	Aquincola tertiaricarbonis	391953	S	9	1	10	0.00008
ERR6913101	Roseateles sp. BIM B-1768	2978473	S	5	0	5	0.00004
ERR6913101	Inhella inkyongensis	392593	S	5	0	5	0.00004
ERR6913101	Rhizobacter sp. AJA081-3	2753607	S	11	1	12	0.00010
ERR6913101	Rhizobacter gummiphilus	946333	S	8	0	8	0.00007
ERR6913101	Aquabacterium olei	1296669	S	10	0	10	0.00008
ERR6913101	Paucibacter sp. KCTC 42545	1768242	S	10	0	10	0.00008
ERR6913101	Leptothrix cholodnii	34029	S	7	0	7	0.00006
ERR6913101	Thauera aromatica	59405	S	6	1	7	0.00006
ERR6913101	Parazoarcus communis	41977	S	5	0	5	0.00004
ERR6913101	Aromatoleum aromaticum	551760	S	8	1	9	0.00007
ERR6913101	Aromatoleum bremense	76115	S	7	0	7	0.00006
ERR6913101	Ferribacterium limneticum	76259	S	10	5	15	0.00012
ERR6913101	Denitratisoma sp. DHT3	1981880	S	5	1	6	0.00005
ERR6913101	Sulfuritalea hydrogenivorans	748811	S	5	0	5	0.00004
ERR6913101	Sulfurimicrobium lacus	2715678	S	5	0	5	0.00004
ERR6913101	Bradyrhizobium sp. CCBAU 051011	858422	S	9	4	13	0.00011
ERR6913101	Bradyrhizobium sp. 200	2782665	S	8	5	13	0.00011
ERR6913101	Bradyrhizobium sp. CCGE-LA001	1223566	S	7	6	13	0.00011
ERR6913101	Bradyrhizobium sp. 1(2017)	1404888	S	6	4	10	0.00008
ERR6913101	Bradyrhizobium sp. CCBAU 51753	1325100	S	6	2	8	0.00007
ERR6913101	Bradyrhizobium sp. 170	2782641	S	5	3	8	0.00007
ERR6913101	Bradyrhizobium erythrophlei	1437360	S	7	1	8	0.00007
ERR6913101	Bradyrhizobium sediminis	2840469	S	7	1	8	0.00007
ERR6913101	Bradyrhizobium icense	1274631	S	7	1	8	0.00007
ERR6913101	Bradyrhizobium diazoefficiens	1355477	S	6	11	17	0.00014
ERR6913101	Bradyrhizobium lablabi	722472	S	6	6	12	0.00010
ERR6913101	Bradyrhizobium barranii	2992140	S	5	12	17	0.00014
ERR6913101	Bradyrhizobium oligotrophicum	44255	S	5	1	6	0.00005
ERR6913101	Bradyrhizobium japonicum	375	S	5	11	16	0.00013
ERR6913101	Bradyrhizobium canariense	255045	S	5	8	13	0.00011
ERR6913101	Rhodopseudomonas palustris	1076	S	10	3	13	0.00011
ERR6913101	Rhizobium leguminosarum	384	S	6	20	26	0.00022
ERR6913101	Agrobacterium tumefaciens	358	S	5	9	14	0.00012
ERR6913101	Shinella sp. XGS7	2877941	S	16	2	18	0.00015
ERR6913101	Shinella sp. HZN7	879274	S	5	6	11	0.00009
ERR6913101	Methylobacterium sp. 4-46	426117	S	8	7	15	0.00012
ERR6913101	Methylobacterium sp. FF17	2984843	S	8	4	12	0.00010
ERR6913101	Methylobacterium sp. WL1	2603276	S	5	10	15	0.00012
ERR6913101	Methylobacterium radiodurans	2202828	S	6	6	12	0.00010
ERR6913101	Methylorubrum populi	223967	S	8	8	16	0.00013
ERR6913101	Microvirga ossetica	1882682	S	5	0	5	0.00004
ERR6913101	Mesorhizobium sp. L-2-11	2744521	S	5	16	21	0.00017
ERR6913101	Devosia ginsengisoli	400770	S	5	3	8	0.00007
ERR6913101	Brucella anthropi	529	S	5	15	20	0.00017
ERR6913101	Rhodoplanes sp. Z2-YC6860	674703	S	5	0	5	0.00004
ERR6913101	Phreatobacter sp. NMCR1094	2570229	S	5	1	6	0.00005
ERR6913101	Blastochloris viridis	1079	S	5	1	6	0.00005
ERR6913101	Terrihabitans soli	708113	S	7	1	8	0.00007
ERR6913101	Sphingomonas sp. PAMC26645	2565555	S	7	5	12	0.00010
ERR6913101	Sphingomonas sp. S6-11	2991075	S	6	3	9	0.00007
ERR6913101	Sphingomonas sp. HMP9	1517554	S	5	4	9	0.00007
ERR6913101	Sphingomonas sp. AP4-R1	2735134	S	5	1	6	0.00005
ERR6913101	Sphingomonas hankookensis	563996	S	9	9	18	0.00015
ERR6913101	Sphingomonas paucimobilis	13689	S	8	9	17	0.00014
ERR6913101	Sphingomonas aerolata	185951	S	6	3	9	0.00007
ERR6913101	Sphingobium sp. MI1205	407020	S	6	14	20	0.00017
ERR6913101	Sphingobium yanoikuyae	13690	S	6	15	21	0.00017
ERR6913101	Sphingopyxis sp. BSN-002	2911495	S	9	6	15	0.00012
ERR6913101	Sphingopyxis fribergensis	1515612	S	6	10	16	0.00013
ERR6913101	Novosphingobium resinovorum	158500	S	6	6	12	0.00010
ERR6913101	Sphingorhabdus lacus	392610	S	6	0	6	0.00005
ERR6913101	Paracoccus aminovorans	34004	S	9	18	27	0.00022
ERR6913101	Cereibacter sphaeroides	1063	S	8	11	19	0.00016
ERR6913101	Polymorphum gilvum	991904	S	5	3	8	0.00007
ERR6913101	Tabrizicola piscis	2494374	S	5	2	7	0.00006
ERR6913101	Brevundimonas sp. PAMC22021	2861285	S	8	6	14	0.00012
ERR6913101	Brevundimonas sp. AJA228-03	2752515	S	7	5	12	0.00010
ERR6913101	Brevundimonas sp. NIBR11	3015999	S	6	3	9	0.00007
ERR6913101	Brevundimonas sp. M20	2591463	S	5	2	7	0.00006
ERR6913101	Brevundimonas nasdae	172043	S	52	20	72	0.00060
ERR6913101	Brevundimonas vesicularis	41276	S	8	13	21	0.00017
ERR6913101	Brevundimonas pondensis	2774189	S	7	2	9	0.00007
ERR6913101	Brevundimonas naejangsanensis	588932	S	5	1	6	0.00005
ERR6913101	Brevundimonas goettingensis	2774190	S	5	0	5	0.00004
ERR6913101	Caulobacter vibrioides	155892	S	5	4	9	0.00007
ERR6913101	Phenylobacterium sp. NIBR 498073	3015177	S	7	1	8	0.00007
ERR6913101	Nitrospirillum amazonense	28077	S	7	3	10	0.00008
ERR6913101	Hydrogenophilus thermoluteolus	297	S	5	0	5	0.00004
ERR6913101	Streptococcus mitis	28037	S	2679	967	3646	0.03018
ERR6913101	Streptococcus sp. LPB0220	2610896	S	299	107	406	0.00336
ERR6913101	Streptococcus sp. A12	1759399	S	268	68	336	0.00278
ERR6913101	Streptococcus sp. HSISM1	1316408	S	251	84	335	0.00277
ERR6913101	Streptococcus sp. Marseille-Q3533	2759692	S	238	39	277	0.00229
ERR6913101	Streptococcus sp. HSISS3	1316412	S	222	233	455	0.00377
ERR6913101	Streptococcus sp. oral taxon 061	712623	S	179	46	225	0.00186
ERR6913101	Streptococcus sp. oral taxon 431	712633	S	174	23	197	0.00163
ERR6913101	Streptococcus sp. 116-D4	2598453	S	167	37	204	0.00169
ERR6913101	Streptococcus sp. Marseille-Q6470	2972784	S	155	36	191	0.00158
ERR6913101	Streptococcus sp. HSISS2	1316411	S	107	118	225	0.00186
ERR6913101	Streptococcus sp. NPS 308	1902136	S	30	10	40	0.00033
ERR6913101	Streptococcus sp. KS 6	2598457	S	20	12	32	0.00026
ERR6913101	Streptococcus sp. 1643	2576376	S	15	12	27	0.00022
ERR6913101	Streptococcus sp. oral taxon 064	712624	S	10	16	26	0.00022
ERR6913101	Streptococcus sp. FDAARGOS_192	1839799	S	9	11	20	0.00017
ERR6913101	Streptococcus sp. FDAARGOS_522	2420310	S	5	207	212	0.00175
ERR6913101	Streptococcus pneumoniae	1313	S	914	2545	3459	0.02863
ERR6913101	Streptococcus oralis	1303	S	664	208	872	0.00722
ERR6913101	Streptococcus salivarius	1304	S	377	181	558	0.00462
ERR6913101	Streptococcus parasanguinis	1318	S	304	86	390	0.00323
ERR6913101	Streptococcus pseudopneumoniae	257758	S	241	93	334	0.00276
ERR6913101	Streptococcus thermophilus	1308	S	169	193	362	0.00300
ERR6913101	Streptococcus australis	113107	S	164	95	259	0.00214
ERR6913101	Streptococcus gwangjuense	1433513	S	142	57	199	0.00165
ERR6913101	Streptococcus sobrinus	1310	S	137	3	140	0.00116
ERR6913101	Streptococcus toyakuensis	2819619	S	133	71	204	0.00169
ERR6913101	Streptococcus infantis	68892	S	133	20	153	0.00127
ERR6913101	Streptococcus ilei	1156431	S	116	72	188	0.00156
ERR6913101	Streptococcus lactarius	684066	S	93	7	100	0.00083
ERR6913101	Streptococcus intermedius	1338	S	58	17	75	0.00062
ERR6913101	Streptococcus anginosus	1328	S	22	29	51	0.00042
ERR6913101	Streptococcus constellatus	76860	S	5	6	11	0.00009
ERR6913101	Streptococcus sanguinis	1305	S	78	5	83	0.00069
ERR6913101	Streptococcus rubneri	1234680	S	77	37	114	0.00094
ERR6913101	Streptococcus gordonii	1302	S	73	5	78	0.00065
ERR6913101	Streptococcus marmotae	1825069	S	49	5	54	0.00045
ERR6913101	Streptococcus cristatus	45634	S	42	2	44	0.00036
ERR6913101	Streptococcus koreensis	2382163	S	40	30	70	0.00058
ERR6913101	Streptococcus suis	1307	S	33	44	77	0.00064
ERR6913101	Streptococcus pyogenes	1314	S	21	1	22	0.00018
ERR6913101	Streptococcus vestibularis	1343	S	20	5	25	0.00021
ERR6913101	Streptococcus mutans	1309	S	19	1	20	0.00017
ERR6913101	Streptococcus equi	1336	S	8	0	8	0.00007
ERR6913101	Streptococcus ferus	1345	S	10	0	10	0.00008
ERR6913101	Streptococcus pluranimalium	82348	S	9	0	9	0.00007
ERR6913101	Streptococcus oriscaviae	2781599	S	8	0	8	0.00007
ERR6913101	Streptococcus pantholopis	1811193	S	6	0	6	0.00005
ERR6913101	Streptococcus merionis	400065	S	6	0	6	0.00005
ERR6913101	Streptococcus parauberis	1348	S	5	0	5	0.00004
ERR6913101	Streptococcus agalactiae	1311	S	5	21	26	0.00022
ERR6913101	Lactococcus lactis	1358	S	32	25	57	0.00047
ERR6913101	Lactococcus cremoris	1359	S	8	3	11	0.00009
ERR6913101	Lactobacillus gasseri	1596	S	18	914	932	0.00771
ERR6913101	Lactobacillus crispatus	47770	S	9	28	37	0.00031
ERR6913101	Lactobacillus intestinalis	151781	S	7	7	14	0.00012
ERR6913101	Lactobacillus johnsonii	33959	S	7	96	103	0.00085
ERR6913101	Lactobacillus acidophilus	1579	S	6	334	340	0.00281
ERR6913101	Lactobacillus amylolyticus	83683	S	6	12	18	0.00015
ERR6913101	Lacticaseibacillus rhamnosus	47715	S	694	161	855	0.00708
ERR6913101	Lacticaseibacillus paracasei	1597	S	7	221	228	0.00189
ERR6913101	Limosilactobacillus fermentum	1613	S	328	158	486	0.00402
ERR6913101	Limosilactobacillus oris	1632	S	34	15	49	0.00041
ERR6913101	Limosilactobacillus vaginalis	1633	S	32	65	97	0.00080
ERR6913101	Limosilactobacillus reuteri	1598	S	6	2	8	0.00007
ERR6913101	Ligilactobacillus salivarius	1624	S	210	55	265	0.00219
ERR6913101	Lactiplantibacillus plantarum	1590	S	12	41	53	0.00044
ERR6913101	Dolosigranulum pigrum	29394	S	520	13	533	0.00441
ERR6913101	Granulicatella adiacens	46124	S	232	15	247	0.00204
ERR6913101	Granulicatella elegans	137732	S	29	6	35	0.00029
ERR6913101	Enterococcus cecorum	44008	S	283	19	302	0.00250
ERR6913101	Enterococcus faecium	1352	S	5	3	8	0.00007
ERR6913101	Enterococcus faecalis	1351	S	5	3	8	0.00007
ERR6913101	Abiotrophia defectiva	46125	S	219	4	223	0.00185
ERR6913101	Gemella haemolysans	1379	S	216	77	293	0.00243
ERR6913101	Gemella sanguinis	84135	S	77	40	117	0.00097
ERR6913101	Gemella morbillorum	29391	S	18	10	28	0.00023
ERR6913101	Gemella sp. zg-570	2840371	S	7	2	9	0.00007
ERR6913101	Staphylococcus epidermidis	1282	S	127	18	145	0.00120
ERR6913101	Staphylococcus pettenkoferi	170573	S	42	2	44	0.00036
ERR6913101	Staphylococcus aureus	1280	S	21	92	113	0.00094
ERR6913101	Staphylococcus cohnii	29382	S	18	18	36	0.00030
ERR6913101	Staphylococcus hominis	1290	S	8	1	9	0.00007
ERR6913101	Bacillus atrophaeus	1452	S	63	39	102	0.00084
ERR6913101	Bacillus velezensis	492670	S	5	19	24	0.00020
ERR6913101	Bacillus mycoides	1405	S	5	4	9	0.00007
ERR6913101	Weizmannia coagulans	1398	S	6	7	13	0.00011
ERR6913101	Neobacillus drentensis	220684	S	5	0	5	0.00004
ERR6913101	Neobacillus mesonae	1193713	S	5	0	5	0.00004
ERR6913101	Listeria monocytogenes	1639	S	7	2	9	0.00007
ERR6913101	Veillonella atypica	39777	S	2282	434	2716	0.02248
ERR6913101	Veillonella rogosae	423477	S	861	510	1371	0.01135
ERR6913101	Veillonella nakazawae	2682456	S	718	1938	2656	0.02198
ERR6913101	Veillonella dispar	39778	S	596	760	1356	0.01122
ERR6913101	Veillonella sp. S12025-13	2682455	S	468	1151	1619	0.01340
ERR6913101	Veillonella parvula	29466	S	437	129	566	0.00468
ERR6913101	Veillonella rodentium	248315	S	71	9	80	0.00066
ERR6913101	Megasphaera stantonii	2144175	S	52	13	65	0.00054
ERR6913101	Megasphaera hexanoica	1675036	S	27	14	41	0.00034
ERR6913101	Megasphaera elsdenii	907	S	11	8	19	0.00016
ERR6913101	Dialister pneumosintes	39950	S	26	6	32	0.00026
ERR6913101	Selenomonas sp. oral taxon 478	712538	S	27	21	48	0.00040
ERR6913101	Selenomonas sp. oral taxon 136	713030	S	22	15	37	0.00031
ERR6913101	Selenomonas sp. oral taxon 126	712528	S	10	5	15	0.00012
ERR6913101	Selenomonas sp. oral taxon 920	1884263	S	7	2	9	0.00007
ERR6913101	Selenomonas sputigena	69823	S	22	1	23	0.00019
ERR6913101	Selenomonas ruminantium	971	S	13	0	13	0.00011
ERR6913101	Selenomonas timonae	2754044	S	12	11	23	0.00019
ERR6913101	Lachnoanaerobaculum umeaense	617123	S	458	19	477	0.00395
ERR6913101	Anaerostipes hadrus	649756	S	52	36	88	0.00073
ERR6913101	Anaerostipes caccae	105841	S	7	0	7	0.00006
ERR6913101	Butyrivibrio fibrisolvens	831	S	17	11	28	0.00023
ERR6913101	Butyrivibrio proteoclasticus	43305	S	11	14	25	0.00021
ERR6913101	Lachnospira eligens	39485	S	43	18	61	0.00050
ERR6913101	Blautia hansenii	1322	S	17	36	53	0.00044
ERR6913101	Blautia wexlerae	418240	S	5	11	16	0.00013
ERR6913101	Roseburia hominis	301301	S	19	25	44	0.00036
ERR6913101	Simiaoa sunii	2763672	S	33	33	66	0.00055
ERR6913101	Lacrimispora xylanolytica	29375	S	13	16	29	0.00024
ERR6913101	Dorea longicatena	88431	S	21	45	66	0.00055
ERR6913101	Dorea formicigenerans	39486	S	6	13	19	0.00016
ERR6913101	Lachnoclostridium phytofermentans	66219	S	21	1	22	0.00018
ERR6913101	[Clostridium] colinum	36835	S	25	0	25	0.00021
ERR6913101	Faecalicatena sp. Marseille-Q4148	2823316	S	17	16	33	0.00027
ERR6913101	Anaerobutyricum hallii	39488	S	17	21	38	0.00031
ERR6913101	Qiania dongpingensis	2763669	S	14	2	16	0.00013
ERR6913101	Enterocloster bolteae	208479	S	7	12	19	0.00016
ERR6913101	Pseudobutyrivibrio xylanivorans	185007	S	11	1	12	0.00010
ERR6913101	Herbinix luporum	1679721	S	7	1	8	0.00007
ERR6913101	Marvinbryantia formatexigens	168384	S	6	0	6	0.00005
ERR6913101	Clostridium sp. M62/1	411486	S	13	8	21	0.00017
ERR6913101	Clostridium sp. JN-1	2483110	S	7	2	9	0.00007
ERR6913101	Clostridium botulinum	1491	S	14	11	25	0.00021
ERR6913101	Clostridium pasteurianum	1501	S	10	0	10	0.00008
ERR6913101	Clostridium beijerinckii	1520	S	7	6	13	0.00011
ERR6913101	Clostridium formicaceticum	1497	S	6	0	6	0.00005
ERR6913101	Clostridium gasigenes	94869	S	5	0	5	0.00004
ERR6913101	Crassaminicella profunda	1286698	S	6	10	16	0.00013
ERR6913101	Hungatella hathewayi	154046	S	5	1	6	0.00005
ERR6913101	Paraclostridium bifermentans	1490	S	5	1	6	0.00005
ERR6913101	Mogibacterium diversum	114527	S	51	15	66	0.00055
ERR6913101	Mogibacterium pumilum	86332	S	9	3	12	0.00010
ERR6913101	Aminipila butyrica	433296	S	11	11	22	0.00018
ERR6913101	Emergencia timonensis	1776384	S	18	1	19	0.00016
ERR6913101	Faecalibacterium prausnitzii	853	S	9	15	24	0.00020
ERR6913101	Oscillibacter hominis	2763056	S	11	4	15	0.00012
ERR6913101	Ruminococcus bicirculans	1160721	S	5	0	5	0.00004
ERR6913101	Subdoligranulum variabile	214851	S	9	4	13	0.00011
ERR6913101	Filifactor alocis	143361	S	16	1	17	0.00014
ERR6913101	Clostridioides difficile	1496	S	8	113	121	0.00100
ERR6913101	Peptostreptococcus sp. CBA3647	3003601	S	7	0	7	0.00006
ERR6913101	Parvimonas micra	33033	S	171	20	191	0.00158
ERR6913101	Bulleidia sp. zg-1006	2806552	S	76	3	79	0.00065
ERR6913101	Longicatena caecimuris	1796635	S	6	0	6	0.00005
ERR6913101	Rothia mucilaginosa	43675	S	3918	741	4659	0.03856
ERR6913101	Rothia dentocariosa	2047	S	271	235	506	0.00419
ERR6913101	Rothia aeria	172042	S	27	17	44	0.00036
ERR6913101	Rothia amarae	169480	S	5	1	6	0.00005
ERR6913101	Kocuria rhizophila	72000	S	82	95	177	0.00147
ERR6913101	Kocuria palustris	71999	S	19	11	30	0.00025
ERR6913101	Kocuria flava	446860	S	6	4	10	0.00008
ERR6913101	Micrococcus luteus	1270	S	17	77	94	0.00078
ERR6913101	Auritidibacter sp. NML130574	2170745	S	7	1	8	0.00007
ERR6913101	Microbacterium sp. PAMC22086	2861281	S	16	33	49	0.00041
ERR6913101	Microbacterium sp. PM5	2014534	S	7	1	8	0.00007
ERR6913101	Microbacterium oxydans	82380	S	11	5	16	0.00013
ERR6913101	Microbacterium aurum	36805	S	8	2	10	0.00008
ERR6913101	Leucobacter muris	1935379	S	5	3	8	0.00007
ERR6913101	Rathayibacter sp. VKM Ac-2760	2609253	S	6	4	10	0.00008
ERR6913101	Clavibacter michiganensis	28447	S	7	12	19	0.00016
ERR6913101	Microcella sp. MMS21-STM10	2963406	S	8	2	10	0.00008
ERR6913101	Herbiconiux sp. SALV-R1	2735133	S	5	1	6	0.00005
ERR6913101	Frigoribacterium sp. SL97	2994664	S	5	1	6	0.00005
ERR6913101	Microterricola viridarii	412690	S	5	1	6	0.00005
ERR6913101	Cellulomonas fimi	1708	S	5	3	8	0.00007
ERR6913101	Cellulomonas flavigena	1711	S	5	3	8	0.00007
ERR6913101	Pseudactinotalea sp. HY158	2654547	S	5	1	6	0.00005
ERR6913101	Janibacter limosus	53458	S	5	12	17	0.00014
ERR6913101	Pedococcus dokdonensis	443156	S	9	3	12	0.00010
ERR6913101	Brachybacterium kimchii	2942909	S	7	3	10	0.00008
ERR6913101	Dermabacter vaginalis	1630135	S	6	1	7	0.00006
ERR6913101	Dermacoccus nishinomiyaensis	1274	S	12	5	17	0.00014
ERR6913101	Luteipulveratus mongoliensis	571913	S	5	0	5	0.00004
ERR6913101	Occultella kanbiaonis	2675754	S	6	1	7	0.00006
ERR6913101	Jonesia denitrificans	43674	S	6	0	6	0.00005
ERR6913101	Kytococcus sedentarius	1276	S	6	2	8	0.00007
ERR6913101	Schaalia odontolytica	1660	S	863	180	1043	0.00863
ERR6913101	Schaalia meyeri	52773	S	69	13	82	0.00068
ERR6913101	Schaalia cardiffensis	181487	S	7	0	7	0.00006
ERR6913101	Schaalia sp. 19OD2882	2794089	S	6	0	6	0.00005
ERR6913101	Actinomyces pacaensis	1852377	S	217	24	241	0.00199
ERR6913101	Actinomyces sp. oral taxon 169	712116	S	18	29	47	0.00039
ERR6913101	Actinomyces sp. oral taxon 414	712122	S	14	2	16	0.00013
ERR6913101	Actinomyces sp. oral taxon 171	706438	S	12	7	19	0.00016
ERR6913101	Actinomyces sp. HMT 175	2789425	S	8	30	38	0.00031
ERR6913101	Actinomyces sp. Z16	2079536	S	5	1	6	0.00005
ERR6913101	Actinomyces oris	544580	S	76	115	191	0.00158
ERR6913101	Actinomyces trachealis	2763540	S	17	2	19	0.00016
ERR6913101	Actinomyces naeslundii	1655	S	14	4	18	0.00015
ERR6913101	Actinomyces radicidentis	111015	S	10	2	12	0.00010
ERR6913101	Actinomyces faecalis	2722820	S	10	1	11	0.00009
ERR6913101	Actinomyces slackii	52774	S	9	1	10	0.00008
ERR6913101	Actinomyces viscosus	1656	S	7	2	9	0.00007
ERR6913101	Actinomyces howellii	52771	S	7	0	7	0.00006
ERR6913101	Winkia neuii	33007	S	9	2	11	0.00009
ERR6913101	Pauljensenia hongkongensis	178339	S	5	1	6	0.00005
ERR6913101	Corynebacterium pseudodiphtheriticum	37637	S	303	34	337	0.00279
ERR6913101	Corynebacterium matruchotii	43768	S	225	4	229	0.00190
ERR6913101	Corynebacterium propinquum	43769	S	80	9	89	0.00074
ERR6913101	Corynebacterium bovis	36808	S	13	1	14	0.00012
ERR6913101	Corynebacterium kroppenstedtii	161879	S	11	0	11	0.00009
ERR6913101	Corynebacterium tuberculostearicum	38304	S	10	1	11	0.00009
ERR6913101	Corynebacterium segmentosum	43990	S	8	8	16	0.00013
ERR6913101	Mycolicibacterium chitae	1792	S	6	4	10	0.00008
ERR6913101	Mycolicibacterium pulveris	36813	S	6	4	10	0.00008
ERR6913101	Mycolicibacterium baixiangningiae	2761578	S	5	4	9	0.00007
ERR6913101	Mycolicibacterium smegmatis	1772	S	5	5	10	0.00008
ERR6913101	Mycobacterium gordonae	1778	S	8	5	13	0.00011
ERR6913101	Mycobacterium kansasii	1768	S	7	13	20	0.00017
ERR6913101	Rhodococcus fascians	1828	S	6	47	53	0.00044
ERR6913101	Nocardia brasiliensis	37326	S	6	1	7	0.00006
ERR6913101	Nocardia cyriacigeorgica	135487	S	6	2	8	0.00007
ERR6913101	Nocardia yunnanensis	2382165	S	5	2	7	0.00006
ERR6913101	Nocardia nova	37330	S	5	0	5	0.00004
ERR6913101	Tsukamurella pulmonis	47312	S	7	1	8	0.00007
ERR6913101	Streptomyces sp. SirexAA-E	862751	S	7	17	24	0.00020
ERR6913101	Streptomyces sp. T12	477697	S	7	15	22	0.00018
ERR6913101	Streptomyces sp. HUAS 15-9	2981136	S	6	10	16	0.00013
ERR6913101	Streptomyces sp. So13.3	2136173	S	5	3	8	0.00007
ERR6913101	Streptomyces sp. YIM 121038	2136401	S	5	6	11	0.00009
ERR6913101	Streptomyces griseus	1911	S	6	12	18	0.00015
ERR6913101	Streptomyces hygroscopicus	1912	S	5	13	18	0.00015
ERR6913101	Streptomyces peucetius	1950	S	7	4	11	0.00009
ERR6913101	Streptomyces liliifuscus	2797636	S	7	6	13	0.00011
ERR6913101	Streptomyces venezuelae	54571	S	7	8	15	0.00012
ERR6913101	Streptomyces niveus	193462	S	6	5	11	0.00009
ERR6913101	Streptomyces griseorubiginosus	67304	S	6	6	12	0.00010
ERR6913101	Streptomyces formicae	1616117	S	6	8	14	0.00012
ERR6913101	Streptomyces kanamyceticus	1967	S	5	7	12	0.00010
ERR6913101	Streptomyces chartreusis	1969	S	5	14	19	0.00016
ERR6913101	Streptomyces rimosus	1927	S	5	2	7	0.00006
ERR6913101	Streptomyces coeruleorubidus	116188	S	5	10	15	0.00012
ERR6913101	Streptomyces marincola	2878388	S	5	1	6	0.00005
ERR6913101	Kitasatospora sp. YST-16	2998080	S	6	2	8	0.00007
ERR6913101	Cutibacterium acnes	1747	S	337	30	367	0.00304
ERR6913101	Cutibacterium modestum	2559073	S	11	0	11	0.00009
ERR6913101	Propionibacterium acidifaciens	556499	S	10	0	10	0.00008
ERR6913101	Arachnia propionica	1750	S	6	0	6	0.00005
ERR6913101	Nocardioides aromaticivorans	200618	S	5	6	11	0.00009
ERR6913101	Kribbella qitaiheensis	1544730	S	5	11	16	0.00013
ERR6913101	Amycolatopsis sp. WQ 127309	2932773	S	8	7	15	0.00012
ERR6913101	Amycolatopsis thermalba	944492	S	5	5	10	0.00008
ERR6913101	Pseudonocardia sp. HH130629-09	1641402	S	5	1	6	0.00005
ERR6913101	Pseudonocardia broussonetiae	2736640	S	6	0	6	0.00005
ERR6913101	Saccharopolyspora erythraea	1836	S	6	3	9	0.00007
ERR6913101	Kutzneria chonburiensis	1483604	S	7	0	7	0.00006
ERR6913101	Actinoplanes ianthinogenes	122358	S	8	3	11	0.00009
ERR6913101	Bifidobacterium dentium	1689	S	18	1	19	0.00016
ERR6913101	Bifidobacterium longum	216816	S	5	13	18	0.00015
ERR6913101	Nonomuraea gerenzanensis	93944	S	6	1	7	0.00006
ERR6913101	Nonomuraea sp. ATCC 55076	1909395	S	5	1	6	0.00005
ERR6913101	Candidatus Planktophila sulfonica	1884904	S	16	1	17	0.00014
ERR6913101	Candidatus Planktophila lacus	1884913	S	6	0	6	0.00005
ERR6913101	Frankia sp. QA3	710111	S	5	0	5	0.00004
ERR6913101	Jiangella alkaliphila	419479	S	6	1	7	0.00006
ERR6913101	Jiangella sp. DSM 45060	1798224	S	6	1	7	0.00006
ERR6913101	Lancefieldella parvula	1382	S	316	10	326	0.00270
ERR6913101	Olsenella sp. oral taxon 807	712411	S	5	0	5	0.00004
ERR6913101	Iamia majanohamensis	467976	S	6	0	6	0.00005
ERR6913101	Aquihabitans sp. G128	2849779	S	5	0	5	0.00004
ERR6913101	Actinomarinicola tropica	2789776	S	5	0	5	0.00004
ERR6913101	Conexibacter woesei	191495	S	5	0	5	0.00004
ERR6913101	Capillimicrobium parvum	2884022	S	6	0	6	0.00005
ERR6913101	Paraconexibacter antarcticus	2949664	S	5	0	5	0.00004
ERR6913101	Baekduia sp. 0141_2	2997333	S	6	0	6	0.00005
ERR6913101	Thermus sp. NEB1569	2918899	S	48	45	93	0.00077
ERR6913101	Thermus scotoductus	37636	S	19	25	44	0.00036
ERR6913101	Thermus antranikianii	88190	S	18	9	27	0.00022
ERR6913101	Thermus thermophilus	274	S	13	5	18	0.00015
ERR6913101	Thermus aquaticus	271	S	5	0	5	0.00004
ERR6913101	Thermus parvatiensis	456163	S	5	9	14	0.00012
ERR6913101	Deinococcus geothermalis	68909	S	11	6	17	0.00014
ERR6913101	Microcoleus vaginatus	119532	S	18	8	26	0.00022
ERR6913101	Oscillatoria nigro-viridis	482564	S	10	5	15	0.00012
ERR6913101	Candidatus Atelocyanobacterium thalassa	713887	S	5	1	6	0.00005
ERR6913101	Calothrix sp. NIES-3974	2005462	S	6	4	10	0.00008
ERR6913101	Chroococcidiopsis thermalis	54299	S	12	25	37	0.00031
ERR6913101	Metamycoplasma salivarium	2124	S	19	4	23	0.00019
ERR6913101	Prevotella melaninogenica	28132	S	1657	628	2285	0.01891
ERR6913101	Prevotella histicola	470565	S	1130	190	1320	0.01093
ERR6913101	Prevotella oris	28135	S	468	58	526	0.00435
ERR6913101	Prevotella nigrescens	28133	S	425	290	715	0.00592
ERR6913101	Prevotella sp. oral taxon 299	652716	S	202	24	226	0.00187
ERR6913101	Prevotella sp. oral taxon 475	712471	S	65	5	70	0.00058
ERR6913101	Prevotella sp. E15-22	2937774	S	14	20	34	0.00028
ERR6913101	Prevotella sp. Rep29	2691580	S	10	1	11	0.00009
ERR6913101	Prevotella sp. E13-17	2913616	S	7	5	12	0.00010
ERR6913101	Prevotella sp. E9-3	2913621	S	5	3	8	0.00007
ERR6913101	Prevotella veroralis	28137	S	337	92	429	0.00355
ERR6913101	Prevotella jejuni	1177574	S	321	151	472	0.00391
ERR6913101	Prevotella intermedia	28131	S	218	100	318	0.00263
ERR6913101	Prevotella scopos	589437	S	78	46	124	0.00103
ERR6913101	Prevotella denticola	28129	S	74	32	106	0.00088
ERR6913101	Prevotella herbatica	2801997	S	32	0	32	0.00026
ERR6913101	Prevotella dentalis	52227	S	29	3	32	0.00026
ERR6913101	Prevotella copri	165179	S	25	1	26	0.00022
ERR6913101	Prevotella corporis	28128	S	24	5	29	0.00024
ERR6913101	Prevotella multiformis	282402	S	22	11	33	0.00027
ERR6913101	Prevotella bryantii	77095	S	18	0	18	0.00015
ERR6913101	Prevotella ruminicola	839	S	18	0	18	0.00015
ERR6913101	Prevotella fusca	589436	S	16	4	20	0.00017
ERR6913101	Pseudoprevotella muciniphila	2133944	S	220	3	223	0.00185
ERR6913101	Hoylesella enoeca	76123	S	76	28	104	0.00086
ERR6913101	Hoylesella buccalis	28127	S	14	4	18	0.00015
ERR6913101	Paraprevotella xylaniphila	454155	S	28	5	33	0.00027
ERR6913101	Porphyromonas sp. oral taxon 275	712435	S	613	34	647	0.00536
ERR6913101	Porphyromonas endodontalis	28124	S	236	44	280	0.00232
ERR6913101	Porphyromonas gingivalis	837	S	45	17	62	0.00051
ERR6913101	Porphyromonas asaccharolytica	28123	S	5	2	7	0.00006
ERR6913101	Tannerella serpentiformis	712710	S	190	5	195	0.00161
ERR6913101	Tannerella forsythia	28112	S	127	22	149	0.00123
ERR6913101	Parabacteroides goldsteinii	328812	S	10	11	21	0.00017
ERR6913101	Bacteroides heparinolyticus	28113	S	12	8	20	0.00017
ERR6913101	Bacteroides thetaiotaomicron	818	S	9	8	17	0.00014
ERR6913101	Bacteroides caccae	47678	S	8	4	12	0.00010
ERR6913101	Bacteroides stercoris	46506	S	8	5	13	0.00011
ERR6913101	Bacteroides zoogleoformans	28119	S	7	5	12	0.00010
ERR6913101	Bacteroides salyersiae	291644	S	6	1	7	0.00006
ERR6913101	Bacteroides fragilis	817	S	6	22	28	0.00023
ERR6913101	Bacteroides nordii	291645	S	5	0	5	0.00004
ERR6913101	Bacteroides xylanisolvens	371601	S	5	39	44	0.00036
ERR6913101	Phocaeicola salanitronis	376805	S	20	2	22	0.00018
ERR6913101	Phocaeicola coprophilus	387090	S	19	8	27	0.00022
ERR6913101	Phocaeicola dorei	357276	S	18	16	34	0.00028
ERR6913101	Phocaeicola vulgatus	821	S	8	8	16	0.00013
ERR6913101	Alistipes onderdonkii	328813	S	8	16	24	0.00020
ERR6913101	Coprobacter secundus	1501392	S	24	4	28	0.00023
ERR6913101	Petrimonas mucosa	1642646	S	6	3	9	0.00007
ERR6913101	Odoribacter splanchnicus	28118	S	7	0	7	0.00006
ERR6913101	Paludibacter propionicigenes	185300	S	9	0	9	0.00007
ERR6913101	Candidatus Azobacteroides pseudotrichonymphae	511435	S	8	0	8	0.00007
ERR6913101	Capnocytophaga gingivalis	1017	S	149	40	189	0.00156
ERR6913101	Capnocytophaga sputigena	1019	S	21	27	48	0.00040
ERR6913101	Capnocytophaga sp. FDAARGOS_737	2545799	S	8	19	27	0.00022
ERR6913101	Capnocytophaga sp. oral taxon 878	1316596	S	6	4	10	0.00008
ERR6913101	Capnocytophaga leadbetteri	327575	S	9	23	32	0.00026
ERR6913101	Flavobacterium sp. CLA17	2724135	S	7	3	10	0.00008
ERR6913101	Flavobacterium sp. IMCC36791	3003262	S	6	1	7	0.00006
ERR6913101	Flavobacterium sp. Sr18	935222	S	5	1	6	0.00005
ERR6913101	Flavobacterium sp. CECT 9288	2845819	S	5	5	10	0.00008
ERR6913101	Flavobacterium psychrophilum	96345	S	34	10	44	0.00036
ERR6913101	Flavobacterium ammonificans	1751056	S	16	11	27	0.00022
ERR6913101	Flavobacterium ammoniigenes	1751095	S	6	4	10	0.00008
ERR6913101	Zunongwangia profunda	398743	S	75	48	123	0.00102
ERR6913101	Polaribacter sp. SA4-10	754397	S	5	6	11	0.00009
ERR6913101	Maribacter hydrothermalis	1836467	S	6	0	6	0.00005
ERR6913101	Amniculibacterium sp. G2-70	2767188	S	7	12	19	0.00016
ERR6913101	Abyssalbus ytuae	2926907	S	7	0	7	0.00006
ERR6913101	Chryseobacterium camelliae	1265445	S	7	9	16	0.00013
ERR6913101	Chryseobacterium indoltheticum	254	S	5	15	20	0.00017
ERR6913101	Chryseobacterium manosquense	2754694	S	5	17	22	0.00018
ERR6913101	Kaistella sp. 97-N-M2	2908645	S	6	3	9	0.00007
ERR6913101	Bergeyella cardium	1585976	S	15	5	20	0.00017
ERR6913101	Cloacibacterium caeni	2004710	S	7	23	30	0.00025
ERR6913101	Riemerella anatipestifer	34085	S	9	2	11	0.00009
ERR6913101	Blattabacterium cuenoti	1653831	S	9	2	11	0.00009
ERR6913101	Tellurirhabdus rosea	2674997	S	6	10	16	0.00013
ERR6913101	Runella slithyformis	106	S	6	1	7	0.00006
ERR6913101	Chitinophaga oryzae	2725414	S	12	3	15	0.00012
ERR6913101	Gemmatirosa kalamazoonensis	861299	S	5	0	5	0.00004
ERR6913101	Fusobacterium nucleatum	851	S	404	446	850	0.00704
ERR6913101	Fusobacterium pseudoperiodonticum	2663009	S	134	186	320	0.00265
ERR6913101	Fusobacterium periodonticum	860	S	17	90	107	0.00089
ERR6913101	Fusobacterium gastrosuis	1755100	S	8	0	8	0.00007
ERR6913101	Fusobacterium mortiferum	850	S	5	0	5	0.00004
ERR6913101	Leptotrichia sp. oral taxon 212	712357	S	287	19	306	0.00253
ERR6913101	Leptotrichia sp. oral taxon 221	712362	S	119	22	141	0.00117
ERR6913101	Leptotrichia sp. oral taxon 218	712361	S	17	5	22	0.00018
ERR6913101	Leptotrichia sp. oral taxon 498	712368	S	5	1	6	0.00005
ERR6913101	Leptotrichia wadei	157687	S	247	63	310	0.00257
ERR6913101	Leptotrichia hofstadii	157688	S	28	7	35	0.00029
ERR6913101	Leptotrichia shahii	157691	S	11	3	14	0.00012
ERR6913101	Leptotrichia hongkongensis	554406	S	9	2	11	0.00009
ERR6913101	Leptotrichia trevisanii	109328	S	8	1	9	0.00007
ERR6913101	Streptobacillus moniliformis	34105	S	20	1	21	0.00017
ERR6913101	Pseudoleptotrichia goodfellowii	157692	S	20	1	21	0.00017
ERR6913101	Sebaldella termitidis	826	S	9	0	9	0.00007
ERR6913101	Sneathia vaginalis	187101	S	6	0	6	0.00005
ERR6913101	Campylobacter concisus	199	S	292	0	292	0.00242
ERR6913101	Campylobacter rectus	203	S	38	0	38	0.00031
ERR6913101	Campylobacter gracilis	824	S	35	0	35	0.00029
ERR6913101	Campylobacter showae	204	S	31	0	31	0.00026
ERR6913101	Campylobacter jejuni	197	S	6	214	220	0.00182
ERR6913101	Campylobacter lari	201	S	5	0	5	0.00004
ERR6913101	Aliarcobacter cryaerophilus	28198	S	6	2	8	0.00007
ERR6913101	Malaciobacter halophilus	197482	S	5	1	6	0.00005
ERR6913101	Treponema sp. OMZ 803	120682	S	11	52	63	0.00052
ERR6913101	Treponema sp. OMZ 906	2563662	S	11	51	62	0.00051
ERR6913101	Treponema denticola	158	S	32	34	66	0.00055
ERR6913101	Treponema vincentii	69710	S	23	18	41	0.00034
ERR6913101	Treponema socranskii	53419	S	19	3	22	0.00018
ERR6913101	Treponema medium	58231	S	6	4	10	0.00008
ERR6913101	Treponema pedis	409322	S	6	0	6	0.00005
ERR6913101	Treponema brennaborense	81028	S	5	0	5	0.00004
ERR6913101	Candidatus Nanosynbacter sp. HMT-352	2899133	S	138	78	216	0.00179
ERR6913101	Candidatus Saccharimonas aalborgensis	1332188	S	9	0	9	0.00007
ERR6913101	Candidatus Minimicrobia vallesae	2841264	S	13	8	21	0.00017
ERR6913101	Candidatus Mycosynbacter amalyticus	2665156	S	7	0	7	0.00006
ERR6913101	Lacipirellula limnantheis	2528024	S	7	4	11	0.00009
ERR6913101	Urbifossiella limnaea	2528023	S	11	1	12	0.00010
ERR6913101	Gemmata obscuriglobus	114	S	5	1	6	0.00005
ERR6913101	Limnoglobus roseus	2598579	S	8	0	8	0.00007
ERR6913101	Frigoriglobus tundricola	2774151	S	6	1	7	0.00006
ERR6913101	Planctomyces sp. SH-PL14	1632864	S	9	3	12	0.00010
ERR6913101	Aquisphaera giovannonii	406548	S	6	0	6	0.00005
ERR6913101	Tautonia plasticadhaerens	2527974	S	5	0	5	0.00004
ERR6913101	Luteolibacter luteus	2728835	S	5	1	6	0.00005
ERR6913101	Verrucomicrobium spinosum	2736	S	5	0	5	0.00004
ERR6913101	Roseimicrobium sp. ORNL1	2711231	S	7	0	7	0.00006
ERR6913101	Opitutus sp. GAS368	1882749	S	7	2	9	0.00007
ERR6913101	Ruficoccus sp. ZRK36	2866311	S	7	0	7	0.00006
ERR6913101	Pyxidicoccus sp. SCPEA002	2813578	S	8	4	12	0.00010
ERR6913101	Archangium violaceum	83451	S	8	2	10	0.00008
ERR6913101	Sorangium cellulosum	56	S	15	6	21	0.00017
ERR6913101	Chondromyces crocatus	52	S	8	0	8	0.00007
ERR6913101	Sandaracinus amylolyticus	927083	S	10	0	10	0.00008
ERR6913101	Luteitalea sp. TBR-22	2802971	S	5	2	7	0.00006
ERR6913101	Fervidobacterium nodosum	2424	S	13	5	18	0.00015
ERR6913101	Fretibacterium fastidiosum	651822	S	5	0	5	0.00004
ERR6913101	Pyramidobacter piscolens	638849	S	6	0	6	0.00005
ERR6913101	Bdellovibrio bacteriovorus	959	S	8	0	8	0.00007
ERR6913101	Bdellovibrio sp. ZAP7	2231053	S	6	0	6	0.00005
ERR6913101	Homo sapiens	9606	S	348	5	353	0.00292
ERR6913101	Ustilaginoidea virens	1159556	S	7	2	9	0.00007
ERR6913101	Drechmeria coniospora	98403	S	6	3	9	0.00007
ERR6913101	Colletotrichum lupini	145971	S	6	2	8	0.00007
ERR6913101	Candida albicans	5476	S	7	5	12	0.00010
ERR6913101	Malassezia restricta	76775	S	19	3	22	0.00018
ERR6913101	Babesia bigemina	5866	S	12	2	14	0.00012
ERR6913101	Phaeodactylum tricornutum	2850	S	12	0	12	0.00010
ERR6913101	Thalassiosira pseudonana	35128	S	10	1	11	0.00009
ERR6913101	Mimasvirus GAP32	2560400	S	18	1	19	0.00016
ERR6913101	Mimasvirus CBB	2560628	S	5	0	5	0.00004
ERR6913101	Muminvirus filifjonk	2844286	S	8	7	15	0.00012
ERR6913101	Muminvirus tooticki	2844301	S	7	15	22	0.00018
ERR6913101	Asteriusvirus av121Q	2560436	S	8	3	11	0.00009
ERR6913101	Asteriusvirus PBECO4	2560463	S	5	2	7	0.00006
ERR6913101	Eneladusvirus BF	2560751	S	7	1	8	0.00007
ERR6913101	Eneladusvirus Yen904	2560849	S	6	1	7	0.00006
ERR6913101	Alcyoneusvirus K641	2560541	S	8	3	11	0.00009
ERR6913101	Human gammaherpesvirus 4	10376	S	5	0	5	0.00004
ERR6913101	Severe acute respiratory syndrome-related coronavirus	694009	S	128	0	128	0.00106
ERR6913197	Klebsiella pneumoniae	573	S	15990	55831	71821	0.32262
ERR6913197	Klebsiella quasipneumoniae	1463165	S	195	145	340	0.00153
ERR6913197	Klebsiella variicola	244366	S	120	156	276	0.00124
ERR6913197	Klebsiella michiganensis	1134687	S	62	202	264	0.00119
ERR6913197	Klebsiella oxytoca	571	S	35	3	38	0.00017
ERR6913197	Klebsiella aerogenes	548	S	29	2	31	0.00014
ERR6913197	Klebsiella quasivariicola	2026240	S	22	4	26	0.00012
ERR6913197	Klebsiella africana	2489010	S	21	3	24	0.00011
ERR6913197	Klebsiella sp. RHBSTW-00465	2742650	S	6	4	10	0.00004
ERR6913197	Klebsiella sp. CTHL.F3a	2873296	S	5	7	12	0.00005
ERR6913197	Klebsiella grimontii	2058152	S	16	23	39	0.00018
ERR6913197	Klebsiella huaxiensis	2153354	S	5	0	5	0.00002
ERR6913197	Raoultella terrigena	577	S	7	0	7	0.00003
ERR6913197	Raoultella ornithinolytica	54291	S	7	4	11	0.00005
ERR6913197	Escherichia coli	562	S	1010	1291	2301	0.01034
ERR6913197	Escherichia albertii	208962	S	5	0	5	0.00002
ERR6913197	Enterobacter cloacae	550	S	9	2	11	0.00005
ERR6913197	Enterobacter asburiae	61645	S	8	6	14	0.00006
ERR6913197	Enterobacter hormaechei	158836	S	8	17	25	0.00011
ERR6913197	Enterobacter roggenkampii	1812935	S	8	5	13	0.00006
ERR6913197	Enterobacter kobei	208224	S	7	10	17	0.00008
ERR6913197	Citrobacter portucalensis	1639133	S	12	11	23	0.00010
ERR6913197	Citrobacter freundii	546	S	6	2	8	0.00004
ERR6913197	Salmonella enterica	28901	S	33	435	468	0.00210
ERR6913197	Siccibacter colletis	1505757	S	5	0	5	0.00002
ERR6913197	Pantoea agglomerans	549	S	22	1	23	0.00010
ERR6913197	Duffyella gerundensis	1619313	S	16	0	16	0.00007
ERR6913197	Buchnera aphidicola	9	S	11	-1	10	0.00004
ERR6913197	Dickeya solani	1089444	S	22	5	27	0.00012
ERR6913197	Serratia marcescens	615	S	6	5	11	0.00005
ERR6913197	Yersinia enterocolitica	630	S	5	4	9	0.00004
ERR6913197	Morganella morganii	582	S	6	5	11	0.00005
ERR6913197	Haemophilus parainfluenzae	729	S	3816	688	4504	0.02023
ERR6913197	Haemophilus parahaemolyticus	735	S	1266	117	1383	0.00621
ERR6913197	Haemophilus influenzae	727	S	69	176	245	0.00110
ERR6913197	Haemophilus haemolyticus	726	S	58	40	98	0.00044
ERR6913197	Haemophilus pittmaniae	249188	S	10	1	11	0.00005
ERR6913197	Haemophilus sp. oral taxon 036	712310	S	9	7	16	0.00007
ERR6913197	Mannheimia ovis	2679994	S	83	25	108	0.00049
ERR6913197	Mannheimia varigena	85404	S	6	0	6	0.00003
ERR6913197	Mannheimia haemolytica	75985	S	5	0	5	0.00002
ERR6913197	Aggregatibacter sp. 2125159857	2820817	S	18	5	23	0.00010
ERR6913197	Aggregatibacter sp. Marseille-P9115	2866570	S	9	5	14	0.00006
ERR6913197	Aggregatibacter sp. oral taxon 513	712150	S	7	5	12	0.00005
ERR6913197	Aggregatibacter aphrophilus	732	S	19	6	25	0.00011
ERR6913197	Aggregatibacter segnis	739	S	8	6	14	0.00006
ERR6913197	Aggregatibacter actinomycetemcomitans	714	S	5	0	5	0.00002
ERR6913197	Actinobacillus indolicus	51049	S	41	23	64	0.00029
ERR6913197	Actinobacillus suis	716	S	10	1	11	0.00005
ERR6913197	Actinobacillus pleuropneumoniae	715	S	5	716	721	0.00324
ERR6913197	Pasteurella multocida	747	S	25	32	57	0.00026
ERR6913197	Pasteurella atlantica	2827233	S	7	0	7	0.00003
ERR6913197	Bibersteinia trehalosi	47735	S	14	167	181	0.00081
ERR6913197	Glaesserella parasuis	738	S	5	10	15	0.00007
ERR6913197	Rodentibacter heylii	1906744	S	5	0	5	0.00002
ERR6913197	Stenotrophomonas maltophilia	40324	S	2047	578	2625	0.01179
ERR6913197	Stenotrophomonas sp. ESTM1D_MKCIP4_1	2072414	S	9	1	10	0.00004
ERR6913197	Stenotrophomonas sp. ZAC14D2_NAIMI4_7	2072405	S	5	7	12	0.00005
ERR6913197	Stenotrophomonas sp. ASS1	2282124	S	17	25	42	0.00019
ERR6913197	Stenotrophomonas sp. LM091	1904944	S	15	1	16	0.00007
ERR6913197	Stenotrophomonas acidaminiphila	128780	S	15	5	20	0.00009
ERR6913197	Stenotrophomonas rhizophila	216778	S	9	0	9	0.00004
ERR6913197	Xanthomonas campestris	339	S	265	17	282	0.00127
ERR6913197	Xanthomonas translucens	343	S	7	1	8	0.00004
ERR6913197	Xanthomonas oryzae	347	S	6	2	8	0.00004
ERR6913197	Xanthomonas arboricola	56448	S	6	1	7	0.00003
ERR6913197	Xanthomonas euvesicatoria	456327	S	5	9	14	0.00006
ERR6913197	Xanthomonas hortorum	56454	S	5	2	7	0.00003
ERR6913197	Lysobacter sp. CW239	2762611	S	6	0	6	0.00003
ERR6913197	Lysobacter enzymogenes	69	S	12	3	15	0.00007
ERR6913197	Lysobacter capsici	435897	S	7	6	13	0.00006
ERR6913197	Luteimonas sp. YGD11-2	2508168	S	13	1	14	0.00006
ERR6913197	Luteimonas chenhongjianii	2006110	S	5	0	5	0.00002
ERR6913197	Thermomonas carbonis	1463158	S	14	4	18	0.00008
ERR6913197	Pseudoxanthomonas sp. SL93	2995142	S	5	0	5	0.00002
ERR6913197	Pseudoxanthomonas suwonensis	314722	S	5	0	5	0.00002
ERR6913197	Pseudoxanthomonas spadix	415229	S	5	0	5	0.00002
ERR6913197	Arenimonas daejeonensis	370777	S	5	0	5	0.00002
ERR6913197	Vibrio kanaloae	170673	S	479	161	640	0.00287
ERR6913197	Vibrio plantisponsor	664643	S	298	10	308	0.00138
ERR6913197	Vibrio fluvialis	676	S	123	79	202	0.00091
ERR6913197	Vibrio parahaemolyticus	670	S	6	5	11	0.00005
ERR6913197	Vibrio alginolyticus	663	S	5	14	19	0.00009
ERR6913197	Vibrio toranzoniae	1194427	S	20	10	30	0.00013
ERR6913197	Vibrio ziniensis	2711221	S	14	0	14	0.00006
ERR6913197	Vibrio cholerae	666	S	11	5	16	0.00007
ERR6913197	Vibrio anguillarum	55601	S	6	5	11	0.00005
ERR6913197	Vibrio cyclitrophicus	47951	S	6	2	8	0.00004
ERR6913197	Vibrio breoganii	553239	S	5	0	5	0.00002
ERR6913197	Aliivibrio fischeri	668	S	8	0	8	0.00004
ERR6913197	Pseudomonas sp. GCEP-101	2974552	S	7	3	10	0.00004
ERR6913197	Pseudomonas sp. J380	2605424	S	7	25	32	0.00014
ERR6913197	Pseudomonas sp. FDAARGOS_380	2018067	S	6	5	11	0.00005
ERR6913197	Pseudomonas sp. Z8(2022)	2962597	S	5	1	6	0.00003
ERR6913197	Pseudomonas sp. T1-3-2	2908006	S	5	0	5	0.00002
ERR6913197	Pseudomonas sp. SCA2728.1_7	2825975	S	5	8	13	0.00006
ERR6913197	Pseudomonas sp. SL4(2022)	2994661	S	5	0	5	0.00002
ERR6913197	Pseudomonas sp. SCB32	2653853	S	5	2	7	0.00003
ERR6913197	Pseudomonas fluorescens	294	S	51	18	69	0.00031
ERR6913197	Pseudomonas synxantha	47883	S	14	6	20	0.00009
ERR6913197	Pseudomonas azotoformans	47878	S	10	5	15	0.00007
ERR6913197	Pseudomonas veronii	76761	S	5	6	11	0.00005
ERR6913197	Pseudomonas poae	200451	S	5	1	6	0.00003
ERR6913197	Pseudomonas aeruginosa	287	S	31	208	239	0.00107
ERR6913197	Pseudomonas multiresinivorans	95301	S	7	3	10	0.00004
ERR6913197	Pseudomonas mendocina	300	S	5	1	6	0.00003
ERR6913197	Pseudomonas alcaligenes	43263	S	5	0	5	0.00002
ERR6913197	Pseudomonas putida	303	S	36	18	54	0.00024
ERR6913197	Pseudomonas oryzihabitans	47885	S	12	2	14	0.00006
ERR6913197	Pseudomonas simiae	321846	S	51	7	58	0.00026
ERR6913197	Pseudomonas fragi	296	S	13	3	16	0.00007
ERR6913197	Pseudomonas chlororaphis	587753	S	7	4	11	0.00005
ERR6913197	Pseudomonas syringae	317	S	6	4	10	0.00004
ERR6913197	Pseudomonas viridiflava	33069	S	5	0	5	0.00002
ERR6913197	Pseudomonas sessilinigenes	658629	S	10	15	25	0.00011
ERR6913197	Pseudomonas lurida	244566	S	9	1	10	0.00004
ERR6913197	Pseudomonas psychrotolerans	237610	S	7	0	7	0.00003
ERR6913197	Pseudomonas lactis	1615674	S	6	2	8	0.00004
ERR6913197	Pseudomonas psychrophila	122355	S	6	0	6	0.00003
ERR6913197	Pseudomonas eucalypticola	2599595	S	6	0	6	0.00003
ERR6913197	Pseudomonas extremaustralis	359110	S	5	0	5	0.00002
ERR6913197	Stutzerimonas stutzeri	316	S	28	8	36	0.00016
ERR6913197	Acinetobacter junii	40215	S	169	19	188	0.00084
ERR6913197	Acinetobacter sp. TTH0-4	1646498	S	9	0	9	0.00004
ERR6913197	Acinetobacter sp. WCHA45	2004644	S	8	11	19	0.00009
ERR6913197	Acinetobacter sp. CS-2	2798861	S	6	1	7	0.00003
ERR6913197	Acinetobacter johnsonii	40214	S	44	33	77	0.00035
ERR6913197	Acinetobacter baumannii	470	S	23	80	103	0.00046
ERR6913197	Acinetobacter pittii	48296	S	10	12	22	0.00010
ERR6913197	Acinetobacter lwoffii	28090	S	34	26	60	0.00027
ERR6913197	Acinetobacter ursingii	108980	S	18	15	33	0.00015
ERR6913197	Acinetobacter schindleri	108981	S	13	2	15	0.00007
ERR6913197	Acinetobacter variabilis	70346	S	7	5	12	0.00005
ERR6913197	Acinetobacter pseudolwoffii	2053287	S	7	5	12	0.00005
ERR6913197	Acinetobacter piscicola	2006115	S	6	0	6	0.00003
ERR6913197	Acinetobacter lanii	2715163	S	6	0	6	0.00003
ERR6913197	Moraxella osloensis	34062	S	138	7	145	0.00065
ERR6913197	Moraxella nonliquefaciens	478	S	12	9	21	0.00009
ERR6913197	Moraxella catarrhalis	480	S	7	3	10	0.00004
ERR6913197	Psychrobacter sp. P11F6	1699621	S	8	12	20	0.00009
ERR6913197	Psychrobacter sp. WY6	2708350	S	5	7	12	0.00005
ERR6913197	Psychrobacter sp. DAB_AL43B	1028416	S	5	1	6	0.00003
ERR6913197	Psychrobacter sanguinis	861445	S	20	9	29	0.00013
ERR6913197	Pseudoalteromonas prydzensis	182141	S	309	19	328	0.00147
ERR6913197	Pseudoalteromonas rhizosphaerae	2518973	S	101	6	107	0.00048
ERR6913197	Pseudoalteromonas sp. KAN5	2916633	S	7	24	31	0.00014
ERR6913197	Pseudoalteromonas mariniglutinosa	206042	S	14	17	31	0.00014
ERR6913197	Pseudoalteromonas aliena	247523	S	6	0	6	0.00003
ERR6913197	Pseudoalteromonas nigrifaciens	28109	S	5	10	15	0.00007
ERR6913197	Psychrosphaera aestuarii	1266052	S	12	0	12	0.00005
ERR6913197	Shewanella algae	38313	S	66	3	69	0.00031
ERR6913197	Shewanella baltica	62322	S	6	13	19	0.00009
ERR6913197	Idiomarina loihiensis	135577	S	10	0	10	0.00004
ERR6913197	Halomonas sp. JS92-SW72	2306583	S	22	28	50	0.00022
ERR6913197	Rheinheimera sp. D18	2545632	S	5	2	7	0.00003
ERR6913197	Candidatus Thiodictyon syntrophicum	1166950	S	8	0	8	0.00004
ERR6913197	Alkalilimnicola ehrlichii	351052	S	6	0	6	0.00003
ERR6913197	Aeromonas hydrophila	644	S	10	7	17	0.00008
ERR6913197	Aeromonas media	651	S	10	1	11	0.00005
ERR6913197	Aeromonas caviae	648	S	8	14	22	0.00010
ERR6913197	Cardiobacterium hominis	2718	S	24	6	30	0.00013
ERR6913197	Cardiobacterium sp. Marseille-Q4385	2866573	S	5	1	6	0.00003
ERR6913197	Sulfurifustis variabilis	1675686	S	5	0	5	0.00002
ERR6913197	Neisseria sicca	490	S	1213	1259	2472	0.01110
ERR6913197	Neisseria mucosa	488	S	1118	3048	4166	0.01871
ERR6913197	Neisseria subflava	28449	S	717	611	1328	0.00597
ERR6913197	Neisseria flavescens	484	S	568	443	1011	0.00454
ERR6913197	Neisseria meningitidis	487	S	342	3192	3534	0.01587
ERR6913197	Neisseria arctica	1470200	S	254	18	272	0.00122
ERR6913197	Neisseria elongata	495	S	128	81	209	0.00094
ERR6913197	Neisseria lactamica	486	S	89	91	180	0.00081
ERR6913197	Neisseria cinerea	483	S	66	44	110	0.00049
ERR6913197	Neisseria sp. oral taxon 014	641148	S	29	18	47	0.00021
ERR6913197	Neisseria sp. KEM232	655307	S	12	2	14	0.00006
ERR6913197	Neisseria sp. ZJ785	2709396	S	12	1	13	0.00006
ERR6913197	Neisseria sp. ZJ106	2912188	S	8	1	9	0.00004
ERR6913197	Neisseria gonorrhoeae	485	S	60	53	113	0.00051
ERR6913197	Neisseria macacae	496	S	37	126	163	0.00073
ERR6913197	Neisseria bacilliformis	267212	S	11	3	14	0.00006
ERR6913197	Neisseria dentiae	194197	S	9	1	10	0.00004
ERR6913197	Neisseria animalis	492	S	9	1	10	0.00004
ERR6913197	Neisseria dumasiana	1931275	S	8	2	10	0.00004
ERR6913197	Neisseria chenwenguii	1853278	S	6	0	6	0.00003
ERR6913197	Neisseria brasiliensis	2666100	S	6	0	6	0.00003
ERR6913197	Neisseria zalophi	640030	S	5	0	5	0.00002
ERR6913197	Neisseria musculi	1815583	S	5	0	5	0.00002
ERR6913197	Kingella denitrificans	502	S	31	13	44	0.00020
ERR6913197	Kingella oralis	505	S	27	4	31	0.00014
ERR6913197	Eikenella corrodens	539	S	25	15	40	0.00018
ERR6913197	Eikenella exigua	2528037	S	5	2	7	0.00003
ERR6913197	Morococcus cerebrosus	1056807	S	25	246	271	0.00122
ERR6913197	Simonsiella muelleri	72	S	12	1	13	0.00006
ERR6913197	Aquella oligotrophica	2067065	S	8	0	8	0.00004
ERR6913197	Wielerella bovis	2917790	S	8	1	9	0.00004
ERR6913197	Chromobacterium sp. ATCC 53434	2059672	S	17	11	28	0.00013
ERR6913197	Aquaspirillum sp. LM1	1938604	S	13	1	14	0.00006
ERR6913197	Pseudogulbenkiania sp. NH8B	748280	S	5	1	6	0.00003
ERR6913197	Acidovorax sp. JMULE5	2518343	S	15	5	20	0.00009
ERR6913197	Acidovorax sp. KKS102	358220	S	14	7	21	0.00009
ERR6913197	Acidovorax sp. T1	1858609	S	14	13	27	0.00012
ERR6913197	Acidovorax sp. 1608163	2478662	S	12	3	15	0.00007
ERR6913197	Acidovorax sp. RAC01	1842533	S	11	4	15	0.00007
ERR6913197	Acidovorax sp. NCPPB 3576	2940488	S	9	6	15	0.00007
ERR6913197	Acidovorax sp. YS12	2738413	S	8	4	12	0.00005
ERR6913197	Acidovorax sp. HDW3	2714923	S	7	2	9	0.00004
ERR6913197	Acidovorax sp. NCPPB 2350	2940487	S	5	2	7	0.00003
ERR6913197	Acidovorax sp. GBBC 1281	2940492	S	5	3	8	0.00004
ERR6913197	Acidovorax temperans	80878	S	34	24	58	0.00026
ERR6913197	Acidovorax carolinensis	553814	S	19	17	36	0.00016
ERR6913197	Acidovorax radicis	758826	S	14	3	17	0.00008
ERR6913197	Acidovorax monticola	1926868	S	10	5	15	0.00007
ERR6913197	Acidovorax avenae	80867	S	7	11	18	0.00008
ERR6913197	Acidovorax antarcticus	2743470	S	6	2	8	0.00004
ERR6913197	Variovorax sp. PAMC28562	2762323	S	10	1	11	0.00005
ERR6913197	Variovorax sp. HW608	1034889	S	9	2	11	0.00005
ERR6913197	Variovorax sp. RKNM96	2681552	S	9	7	16	0.00007
ERR6913197	Variovorax sp. 38R	2774875	S	7	9	16	0.00007
ERR6913197	Variovorax sp. WDL1	207745	S	6	20	26	0.00012
ERR6913197	Variovorax sp. PBS-H4	434008	S	5	5	10	0.00004
ERR6913197	Variovorax sp. PAMC 28711	1795631	S	5	1	6	0.00003
ERR6913197	Variovorax paradoxus	34073	S	31	16	47	0.00021
ERR6913197	Variovorax boronicumulans	436515	S	12	11	23	0.00010
ERR6913197	Rhodoferax sp. AJA081-3	2752316	S	21	3	24	0.00011
ERR6913197	Rhodoferax sp. PAMC 29310	2822760	S	11	1	12	0.00005
ERR6913197	Rhodoferax sp. BAB1	2741720	S	7	2	9	0.00004
ERR6913197	Rhodoferax antarcticus	81479	S	9	1	10	0.00004
ERR6913197	Rhodoferax ferrireducens	192843	S	9	1	10	0.00004
ERR6913197	Rhodoferax koreense	1842727	S	9	2	11	0.00005
ERR6913197	Rhodoferax sediminis	2509614	S	6	1	7	0.00003
ERR6913197	Comamonas testosteroni	285	S	20	16	36	0.00016
ERR6913197	Comamonas sp. NLF-1-9	2853163	S	5	1	6	0.00003
ERR6913197	Comamonas aquatica	225991	S	11	4	15	0.00007
ERR6913197	Comamonas odontotermitis	379895	S	7	1	8	0.00004
ERR6913197	Comamonas thiooxydans	363952	S	6	4	10	0.00004
ERR6913197	Polaromonas sp. JS666	296591	S	11	21	32	0.00014
ERR6913197	Polaromonas naphthalenivorans	216465	S	29	12	41	0.00018
ERR6913197	Hydrogenophaga sp. RAC07	1842537	S	12	8	20	0.00009
ERR6913197	Hydrogenophaga sp. SL48	2806347	S	7	4	11	0.00005
ERR6913197	Hydrogenophaga sp. PBC	795665	S	6	4	10	0.00004
ERR6913197	Hydrogenophaga sp. PAMC20947	2565558	S	5	0	5	0.00002
ERR6913197	Hydrogenophaga taeniospiralis	65656	S	11	8	19	0.00009
ERR6913197	Limnohabitans sp. 103DPR2	1678129	S	16	1	17	0.00008
ERR6913197	Limnohabitans sp. 63ED37-2	1678128	S	14	2	16	0.00007
ERR6913197	Delftia tsuruhatensis	180282	S	7	12	19	0.00009
ERR6913197	Delftia acidovorans	80866	S	6	11	17	0.00008
ERR6913197	Diaphorobacter sp. HDW4A	2714924	S	12	9	21	0.00009
ERR6913197	Ramlibacter tataouinensis	94132	S	21	7	28	0.00013
ERR6913197	Ottowia sp. oral taxon 894	1658672	S	9	1	10	0.00004
ERR6913197	Ottowia testudinis	2816950	S	7	2	9	0.00004
ERR6913197	Kinneretia sp. DAIF2	2714952	S	8	2	10	0.00004
ERR6913197	Serpentinimonas raichei	1458425	S	6	3	9	0.00004
ERR6913197	Alicycliphilus denitrificans	179636	S	7	12	19	0.00009
ERR6913197	Curvibacter sp. AEP1-3	1844971	S	7	0	7	0.00003
ERR6913197	Hylemonella gracilis	80880	S	6	1	7	0.00003
ERR6913197	Simplicispira suum	2109915	S	6	1	7	0.00003
ERR6913197	Burkholderia multivorans	87883	S	147	74	221	0.00099
ERR6913197	Burkholderia contaminans	488447	S	7	6	13	0.00006
ERR6913197	Burkholderia ubonensis	101571	S	6	4	10	0.00004
ERR6913197	Burkholderia sp. Bp7605	1740163	S	5	0	5	0.00002
ERR6913197	Burkholderia pseudomallei	28450	S	5	12	17	0.00008
ERR6913197	Burkholderia glumae	337	S	5	1	6	0.00003
ERR6913197	Burkholderia gladioli	28095	S	5	0	5	0.00002
ERR6913197	Cupriavidus sp. EM10	2839983	S	104	42	146	0.00066
ERR6913197	Cupriavidus pauculus	82633	S	13	3	16	0.00007
ERR6913197	Cupriavidus taiwanensis	164546	S	12	11	23	0.00010
ERR6913197	Lautropia mirabilis	47671	S	76	8	84	0.00038
ERR6913197	Paraburkholderia pallida	2547399	S	7	7	14	0.00006
ERR6913197	Ralstonia solanacearum	305	S	11	12	23	0.00010
ERR6913197	Ralstonia mannitolilytica	105219	S	7	3	10	0.00004
ERR6913197	Ralstonia insidiosa	190721	S	6	0	6	0.00003
ERR6913197	Polynucleobacter necessarius	576610	S	7	6	13	0.00006
ERR6913197	Chitinimonas koreensis	356302	S	5	0	5	0.00002
ERR6913197	Massilia sp. NP310	2861282	S	13	17	30	0.00013
ERR6913197	Massilia sp. PAMC28688	2861283	S	7	2	9	0.00004
ERR6913197	Massilia sp. WG5	1707785	S	6	5	11	0.00005
ERR6913197	Massilia sp. DM-R-R2A-13	2899220	S	5	3	8	0.00004
ERR6913197	Massilia violaceinigra	2045208	S	18	8	26	0.00012
ERR6913197	Massilia forsythiae	2728020	S	10	3	13	0.00006
ERR6913197	Massilia oculi	945844	S	5	4	9	0.00004
ERR6913197	Pseudoduganella plicata	321984	S	5	2	7	0.00003
ERR6913197	Pseudoduganella armeniaca	2072590	S	5	4	9	0.00004
ERR6913197	Duganella dendranthematis	2728021	S	5	1	6	0.00003
ERR6913197	Janthinobacterium sp. LM6	1938606	S	6	9	15	0.00007
ERR6913197	Janthinobacterium sp. 17J80-10	2497863	S	6	1	7	0.00003
ERR6913197	Janthinobacterium svalbardensis	368607	S	9	13	22	0.00010
ERR6913197	Janthinobacterium agaricidamnosum	55508	S	8	14	22	0.00010
ERR6913197	Janthinobacterium tructae	2590869	S	5	7	12	0.00005
ERR6913197	Collimonas arenae	279058	S	13	4	17	0.00008
ERR6913197	Collimonas fungivorans	158899	S	11	7	18	0.00008
ERR6913197	Achromobacter xylosoxidans	85698	S	17	16	33	0.00015
ERR6913197	Achromobacter deleyi	1353891	S	13	7	20	0.00009
ERR6913197	Achromobacter spanius	217203	S	9	2	11	0.00005
ERR6913197	Bordetella petrii	94624	S	5	3	8	0.00004
ERR6913197	Bordetella genomosp. 13	463040	S	5	2	7	0.00003
ERR6913197	Alcaligenes faecalis	511	S	10	10	20	0.00009
ERR6913197	Sphaerotilus sulfidivorans	639200	S	10	3	13	0.00006
ERR6913197	Sphaerotilus sp. FB-5	2914710	S	9	2	11	0.00005
ERR6913197	Schlegelella aquatica	376175	S	19	6	25	0.00011
ERR6913197	Roseateles sp. BIM B-1768	2978473	S	8	1	9	0.00004
ERR6913197	Methylibium petroleiphilum	105560	S	7	3	10	0.00004
ERR6913197	Aquincola tertiaricarbonis	391953	S	10	2	12	0.00005
ERR6913197	Ideonella dechloratans	36863	S	7	3	10	0.00004
ERR6913197	Caldimonas thermodepolymerans	215580	S	5	2	7	0.00003
ERR6913197	Rubrivivax gelatinosus	28068	S	6	1	7	0.00003
ERR6913197	Aquabacterium sp. J223	2898431	S	10	3	13	0.00006
ERR6913197	Aquabacterium olei	1296669	S	7	1	8	0.00004
ERR6913197	Paucibacter sp. KCTC 42545	1768242	S	15	2	17	0.00008
ERR6913197	Rhizobacter sp. AJA081-3	2753607	S	8	2	10	0.00004
ERR6913197	Rhizobacter gummiphilus	946333	S	6	1	7	0.00003
ERR6913197	Leptothrix cholodnii	34029	S	10	3	13	0.00006
ERR6913197	Thiomonas sp. X19	1050370	S	5	4	9	0.00004
ERR6913197	Tepidimonas taiwanensis	307486	S	7	2	9	0.00004
ERR6913197	Dechloromonas sp. A34	447588	S	10	2	12	0.00005
ERR6913197	Dechloromonas denitrificans	281362	S	11	9	20	0.00009
ERR6913197	Ferribacterium limneticum	76259	S	27	4	31	0.00014
ERR6913197	Quatrionicoccus australiensis	138118	S	12	3	15	0.00007
ERR6913197	Thauera sp. MZ1T	85643	S	6	5	11	0.00005
ERR6913197	Thauera sp. K11	2005884	S	6	3	9	0.00004
ERR6913197	Pseudazoarcus pumilus	2067960	S	6	1	7	0.00003
ERR6913197	Azospira restricta	404405	S	10	10	20	0.00009
ERR6913197	Methylotenera versatilis	1055487	S	7	2	9	0.00004
ERR6913197	Denitratisoma sp. DHT3	1981880	S	9	3	12	0.00005
ERR6913197	Sulfuritalea hydrogenivorans	748811	S	5	1	6	0.00003
ERR6913197	Casimicrobium huifangae	2591109	S	7	0	7	0.00003
ERR6913197	Bradyrhizobium sp. SK17	2057741	S	23	27	50	0.00022
ERR6913197	Bradyrhizobium sp. 200	2782665	S	8	11	19	0.00009
ERR6913197	Bradyrhizobium sp. BTAi1	288000	S	6	4	10	0.00004
ERR6913197	Bradyrhizobium sp. 6(2017)	1197460	S	6	11	17	0.00008
ERR6913197	Bradyrhizobium erythrophlei	1437360	S	18	4	22	0.00010
ERR6913197	Bradyrhizobium sediminis	2840469	S	15	6	21	0.00009
ERR6913197	Bradyrhizobium canariense	255045	S	9	32	41	0.00018
ERR6913197	Bradyrhizobium diazoefficiens	1355477	S	8	31	39	0.00018
ERR6913197	Bradyrhizobium paxllaeri	190148	S	5	3	8	0.00004
ERR6913197	Bradyrhizobium quebecense	2748629	S	5	9	14	0.00006
ERR6913197	Rhodopseudomonas palustris	1076	S	17	7	24	0.00011
ERR6913197	Rhodopseudomonas boonkerdii	475937	S	6	3	9	0.00004
ERR6913197	Afipia sp. GAS231	1882747	S	7	6	13	0.00006
ERR6913197	Mesorhizobium sp. M1D.F.Ca.ET.043.01.1.1	2493669	S	5	29	34	0.00015
ERR6913197	Mesorhizobium terrae	2725666	S	44	65	109	0.00049
ERR6913197	Nitratireductor sp. SY7	2599600	S	7	5	12	0.00005
ERR6913197	Rhizobium leguminosarum	384	S	13	33	46	0.00021
ERR6913197	Sinorhizobium fredii	380	S	6	6	12	0.00005
ERR6913197	Sinorhizobium meliloti	382	S	5	1	6	0.00003
ERR6913197	Ensifer adhaerens	106592	S	7	2	9	0.00004
ERR6913197	Shinella sp. XGS7	2877941	S	5	0	5	0.00002
ERR6913197	Shinella zoogloeoides	352475	S	5	9	14	0.00006
ERR6913197	Methylobacterium sp. FF17	2984843	S	13	5	18	0.00008
ERR6913197	Methylobacterium aquaticum	270351	S	10	18	28	0.00013
ERR6913197	Methylobacterium radiodurans	2202828	S	8	4	12	0.00005
ERR6913197	Methylobacterium brachiatum	269660	S	6	6	12	0.00005
ERR6913197	Methylorubrum populi	223967	S	16	9	25	0.00011
ERR6913197	Methylorubrum extorquens	408	S	7	13	20	0.00009
ERR6913197	Microvirga ossetica	1882682	S	5	1	6	0.00003
ERR6913197	Devosia sp. A16	1736675	S	8	3	11	0.00005
ERR6913197	Devosia beringensis	2657486	S	5	6	11	0.00005
ERR6913197	Rhodoplanes sp. Z2-YC6860	674703	S	14	4	18	0.00008
ERR6913197	Caenibius tardaugens	169176	S	7	7	14	0.00006
ERR6913197	Ancylobacter sp. TS-1	1850374	S	6	7	13	0.00006
ERR6913197	Pseudolabrys sp. FHR47	2562284	S	5	1	6	0.00003
ERR6913197	Bosea vaviloviae	1526658	S	9	3	12	0.00005
ERR6913197	Phreatobacter stygius	1940610	S	5	2	7	0.00003
ERR6913197	Sphingomonas sp. PAMC26645	2565555	S	19	9	28	0.00013
ERR6913197	Sphingomonas sp. HMP9	1517554	S	9	5	14	0.00006
ERR6913197	Sphingomonas sp. AAP5	1523415	S	8	3	11	0.00005
ERR6913197	Sphingomonas sp. ZFBP2030	2972485	S	7	1	8	0.00004
ERR6913197	Sphingomonas sp. QA11	2950605	S	7	1	8	0.00004
ERR6913197	Sphingomonas sp. SUN039	2937787	S	6	1	7	0.00003
ERR6913197	Sphingomonas sp. CV7422	3018036	S	5	3	8	0.00004
ERR6913197	Sphingomonas sp. RMG20	2949093	S	5	2	7	0.00003
ERR6913197	Sphingomonas sp. CL5.1	2653203	S	5	3	8	0.00004
ERR6913197	Sphingomonas aliaeris	2759526	S	15	3	18	0.00008
ERR6913197	Sphingomonas glaciei	2938948	S	13	3	16	0.00007
ERR6913197	Sphingomonas paucimobilis	13689	S	11	9	20	0.00009
ERR6913197	Sphingomonas sanxanigenens	397260	S	9	8	17	0.00008
ERR6913197	Sphingomonas insulae	424800	S	8	3	11	0.00005
ERR6913197	Sphingomonas morindae	1541170	S	6	1	7	0.00003
ERR6913197	Sphingomonas aerolata	185951	S	5	1	6	0.00003
ERR6913197	Sphingomonas melonis	152682	S	5	31	36	0.00016
ERR6913197	Sphingomonas hankookensis	563996	S	5	3	8	0.00004
ERR6913197	Sphingomonas paeninsulae	2319844	S	5	0	5	0.00002
ERR6913197	Sphingomonas taxi	1549858	S	5	2	7	0.00003
ERR6913197	Sphingobium yanoikuyae	13690	S	5	24	29	0.00013
ERR6913197	Sphingobium xenophagum	121428	S	5	8	13	0.00006
ERR6913197	Novosphingobium sp. EMRT-2	2571749	S	11	11	22	0.00010
ERR6913197	Novosphingobium aromaticivorans	48935	S	5	8	13	0.00006
ERR6913197	Sphingopyxis sp. DBS4	2968500	S	6	14	20	0.00009
ERR6913197	Porphyrobacter sp. ULC335	2854260	S	7	14	21	0.00009
ERR6913197	Sphingosinicella microcystinivorans	335406	S	5	1	6	0.00003
ERR6913197	Sphingosinicella sp. BN140058	1892855	S	5	0	5	0.00002
ERR6913197	Paracoccus sp. MC1862	2760307	S	7	2	9	0.00004
ERR6913197	Paracoccus sp. SCSIO 76264	3017783	S	5	3	8	0.00004
ERR6913197	Paracoccus yeei	147645	S	20	39	59	0.00027
ERR6913197	Paracoccus sanguinis	1545044	S	15	10	25	0.00011
ERR6913197	Paracoccus aminovorans	34004	S	7	4	11	0.00005
ERR6913197	Paracoccus marcusii	59779	S	5	8	13	0.00006
ERR6913197	Gemmobacter fulva	2840474	S	9	4	13	0.00006
ERR6913197	Gemmobacter aquarius	2169400	S	5	1	6	0.00003
ERR6913197	Rhodovulum sulfidophilum	35806	S	10	7	17	0.00008
ERR6913197	Tabrizicola piscis	2494374	S	8	2	10	0.00004
ERR6913197	Yangia pacifica	311180	S	7	4	11	0.00005
ERR6913197	Jannaschia sp. W003	2867012	S	5	1	6	0.00003
ERR6913197	Sagittula sp. P11	2009329	S	5	10	15	0.00007
ERR6913197	Brevundimonas sp. PAMC22021	2861285	S	11	3	14	0.00006
ERR6913197	Brevundimonas sp. LM2	1938605	S	7	2	9	0.00004
ERR6913197	Brevundimonas sp. Bb-A	2560058	S	5	13	18	0.00008
ERR6913197	Brevundimonas sp. MF30-B	2561924	S	5	1	6	0.00003
ERR6913197	Brevundimonas sp. NIBR11	3015999	S	5	1	6	0.00003
ERR6913197	Brevundimonas nasdae	172043	S	19	10	29	0.00013
ERR6913197	Brevundimonas naejangsanensis	588932	S	13	8	21	0.00009
ERR6913197	Brevundimonas albigilva	1312364	S	10	8	18	0.00008
ERR6913197	Brevundimonas vesicularis	41276	S	6	20	26	0.00012
ERR6913197	Brevundimonas subvibrioides	74313	S	6	2	8	0.00004
ERR6913197	Caulobacter sp. NIBR2454	3015996	S	6	1	7	0.00003
ERR6913197	Caulobacter sp. NIBR1757	3016000	S	5	1	6	0.00003
ERR6913197	Caulobacter segnis	88688	S	12	4	16	0.00007
ERR6913197	Caulobacter vibrioides	155892	S	6	2	8	0.00004
ERR6913197	Caulobacter flavus	1679497	S	5	1	6	0.00003
ERR6913197	Caulobacter soli	2708539	S	5	1	6	0.00003
ERR6913197	Phenylobacterium sp. NIBR 498073	3015177	S	13	3	16	0.00007
ERR6913197	Phenylobacterium zucineum	284016	S	7	1	8	0.00004
ERR6913197	Roseomonas sp. OT10	2897332	S	6	3	9	0.00004
ERR6913197	Roseomonas cervicalis	204525	S	5	2	7	0.00003
ERR6913197	Roseomonas gilardii	257708	S	5	9	14	0.00006
ERR6913197	Komagataeibacter xylinus	28448	S	8	4	12	0.00005
ERR6913197	Roseococcus microcysteis	2771361	S	6	1	7	0.00003
ERR6913197	Rhodovastum atsumiense	504468	S	5	0	5	0.00002
ERR6913197	Nitrospirillum amazonense	28077	S	5	0	5	0.00002
ERR6913197	Thalassospira sp. GO-4	2946605	S	7	0	7	0.00003
ERR6913197	Tistrella mobilis	171437	S	5	0	5	0.00002
ERR6913197	Candidatus Viadribacter manganicus	1759059	S	6	0	6	0.00003
ERR6913197	Streptococcus sp. LPB0220	2610896	S	632	187	819	0.00368
ERR6913197	Streptococcus sp. HSISM1	1316408	S	576	160	736	0.00331
ERR6913197	Streptococcus sp. oral taxon 061	712623	S	565	120	685	0.00308
ERR6913197	Streptococcus sp. Marseille-Q6470	2972784	S	530	104	634	0.00285
ERR6913197	Streptococcus sp. Marseille-Q3533	2759692	S	522	71	593	0.00266
ERR6913197	Streptococcus sp. A12	1759399	S	449	87	536	0.00241
ERR6913197	Streptococcus sp. HSISS3	1316412	S	429	396	825	0.00371
ERR6913197	Streptococcus sp. oral taxon 431	712633	S	377	41	418	0.00188
ERR6913197	Streptococcus sp. 116-D4	2598453	S	357	61	418	0.00188
ERR6913197	Streptococcus sp. HSISS2	1316411	S	225	220	445	0.00200
ERR6913197	Streptococcus sp. NPS 308	1902136	S	43	11	54	0.00024
ERR6913197	Streptococcus sp. KS 6	2598457	S	43	19	62	0.00028
ERR6913197	Streptococcus sp. 1643	2576376	S	37	23	60	0.00027
ERR6913197	Streptococcus sp. FDAARGOS_192	1839799	S	36	34	70	0.00031
ERR6913197	Streptococcus sp. oral taxon 064	712624	S	28	35	63	0.00028
ERR6913197	Streptococcus sp. HSISS1	1316410	S	5	77	82	0.00037
ERR6913197	Streptococcus mitis	28037	S	5555	1271	6826	0.03066
ERR6913197	Streptococcus pneumoniae	1313	S	1843	3127	4970	0.02233
ERR6913197	Streptococcus oralis	1303	S	1537	351	1888	0.00848
ERR6913197	Streptococcus salivarius	1304	S	899	323	1222	0.00549
ERR6913197	Streptococcus parasanguinis	1318	S	757	152	909	0.00408
ERR6913197	Streptococcus pseudopneumoniae	257758	S	532	152	684	0.00307
ERR6913197	Streptococcus gwangjuense	1433513	S	350	107	457	0.00205
ERR6913197	Streptococcus australis	113107	S	322	140	462	0.00208
ERR6913197	Streptococcus infantis	68892	S	311	34	345	0.00155
ERR6913197	Streptococcus toyakuensis	2819619	S	306	120	426	0.00191
ERR6913197	Streptococcus thermophilus	1308	S	280	181	461	0.00207
ERR6913197	Streptococcus sobrinus	1310	S	217	3	220	0.00099
ERR6913197	Streptococcus lactarius	684066	S	212	12	224	0.00101
ERR6913197	Streptococcus ilei	1156431	S	198	93	291	0.00131
ERR6913197	Streptococcus sanguinis	1305	S	196	9	205	0.00092
ERR6913197	Streptococcus rubneri	1234680	S	154	55	209	0.00094
ERR6913197	Streptococcus gordonii	1302	S	147	7	154	0.00069
ERR6913197	Streptococcus intermedius	1338	S	98	28	126	0.00057
ERR6913197	Streptococcus anginosus	1328	S	36	20	56	0.00025
ERR6913197	Streptococcus cristatus	45634	S	95	4	99	0.00044
ERR6913197	Streptococcus koreensis	2382163	S	81	46	127	0.00057
ERR6913197	Streptococcus suis	1307	S	69	22	91	0.00041
ERR6913197	Streptococcus mutans	1309	S	51	4	55	0.00025
ERR6913197	Streptococcus marmotae	1825069	S	47	3	50	0.00022
ERR6913197	Streptococcus pyogenes	1314	S	34	29	63	0.00028
ERR6913197	Streptococcus vestibularis	1343	S	28	5	33	0.00015
ERR6913197	Streptococcus equi	1336	S	19	0	19	0.00009
ERR6913197	Streptococcus dysgalactiae	1334	S	7	1	8	0.00004
ERR6913197	Streptococcus ferus	1345	S	22	0	22	0.00010
ERR6913197	Streptococcus merionis	400065	S	20	0	20	0.00009
ERR6913197	Streptococcus agalactiae	1311	S	17	982	999	0.00449
ERR6913197	Streptococcus oriscaviae	2781599	S	12	0	12	0.00005
ERR6913197	Streptococcus pluranimalium	82348	S	9	0	9	0.00004
ERR6913197	Streptococcus parasuis	1501662	S	7	3	10	0.00004
ERR6913197	Streptococcus porcinus	1340	S	7	0	7	0.00003
ERR6913197	Streptococcus milleri	33040	S	6	6	12	0.00005
ERR6913197	Streptococcus troglodytae	1111760	S	6	0	6	0.00003
ERR6913197	Streptococcus iniae	1346	S	5	0	5	0.00002
ERR6913197	Streptococcus periodonticum	2490633	S	5	3	8	0.00004
ERR6913197	Lactococcus lactis	1358	S	35	24	59	0.00027
ERR6913197	Lactococcus cremoris	1359	S	18	10	28	0.00013
ERR6913197	Lactococcus garvieae	1363	S	5	2	7	0.00003
ERR6913197	Lactobacillus gasseri	1596	S	34	1199	1233	0.00554
ERR6913197	Lactobacillus crispatus	47770	S	13	23	36	0.00016
ERR6913197	Lactobacillus acidophilus	1579	S	12	201	213	0.00096
ERR6913197	Lactobacillus amylolyticus	83683	S	12	14	26	0.00012
ERR6913197	Lactobacillus paragasseri	2107999	S	9	863	872	0.00392
ERR6913197	Lactobacillus delbrueckii	1584	S	8	7	15	0.00007
ERR6913197	Lactobacillus johnsonii	33959	S	7	33	40	0.00018
ERR6913197	Lactobacillus helveticus	1587	S	6	26	32	0.00014
ERR6913197	Lactobacillus acetotolerans	1600	S	6	4	10	0.00004
ERR6913197	Lactobacillus intestinalis	151781	S	6	3	9	0.00004
ERR6913197	Lactobacillus iners	147802	S	5	0	5	0.00002
ERR6913197	Lactobacillus panisapium	2012495	S	5	0	5	0.00002
ERR6913197	Lacticaseibacillus rhamnosus	47715	S	1266	514	1780	0.00800
ERR6913197	Lacticaseibacillus paracasei	1597	S	11	374	385	0.00173
ERR6913197	Lacticaseibacillus sp. KACC 23028	3025672	S	7	2	9	0.00004
ERR6913197	Limosilactobacillus fermentum	1613	S	651	392	1043	0.00469
ERR6913197	Limosilactobacillus vaginalis	1633	S	88	154	242	0.00109
ERR6913197	Limosilactobacillus oris	1632	S	44	17	61	0.00027
ERR6913197	Limosilactobacillus reuteri	1598	S	6	9	15	0.00007
ERR6913197	Ligilactobacillus salivarius	1624	S	412	70	482	0.00217
ERR6913197	Lactiplantibacillus plantarum	1590	S	24	14	38	0.00017
ERR6913197	Leuconostoc lactis	1246	S	5	9	14	0.00006
ERR6913197	Dolosigranulum pigrum	29394	S	746	18	764	0.00343
ERR6913197	Granulicatella adiacens	46124	S	482	29	511	0.00230
ERR6913197	Granulicatella elegans	137732	S	59	9	68	0.00031
ERR6913197	Abiotrophia defectiva	46125	S	412	7	419	0.00188
ERR6913197	Enterococcus cecorum	44008	S	81	5	86	0.00039
ERR6913197	Enterococcus faecalis	1351	S	6	8	14	0.00006
ERR6913197	Gemella haemolysans	1379	S	444	111	555	0.00249
ERR6913197	Gemella sanguinis	84135	S	186	69	255	0.00115
ERR6913197	Gemella morbillorum	29391	S	20	8	28	0.00013
ERR6913197	Gemella sp. zg-570	2840371	S	8	5	13	0.00006
ERR6913197	Staphylococcus epidermidis	1282	S	200	18	218	0.00098
ERR6913197	Staphylococcus cohnii	29382	S	42	31	73	0.00033
ERR6913197	Staphylococcus aureus	1280	S	36	124	160	0.00072
ERR6913197	Staphylococcus hominis	1290	S	21	3	24	0.00011
ERR6913197	Staphylococcus capitis	29388	S	15	2	17	0.00008
ERR6913197	Staphylococcus saprophyticus	29385	S	9	1	10	0.00004
ERR6913197	Staphylococcus warneri	1292	S	9	5	14	0.00006
ERR6913197	Staphylococcus pettenkoferi	170573	S	7	0	7	0.00003
ERR6913197	Staphylococcus pasteuri	45972	S	7	0	7	0.00003
ERR6913197	Bacillus atrophaeus	1452	S	82	70	152	0.00068
ERR6913197	Bacillus velezensis	492670	S	5	2	7	0.00003
ERR6913197	Bacillus cereus	1396	S	7	30	37	0.00017
ERR6913197	Bacillus mycoides	1405	S	5	0	5	0.00002
ERR6913197	Veillonella atypica	39777	S	4160	182	4342	0.01950
ERR6913197	Veillonella rogosae	423477	S	1792	245	2037	0.00915
ERR6913197	Veillonella nakazawae	2682456	S	1735	1083	2818	0.01266
ERR6913197	Veillonella sp. S12025-13	2682455	S	1135	640	1775	0.00797
ERR6913197	Veillonella dispar	39778	S	1101	322	1423	0.00639
ERR6913197	Veillonella parvula	29466	S	838	4696	5534	0.02486
ERR6913197	Veillonella rodentium	248315	S	73	2	75	0.00034
ERR6913197	Megasphaera stantonii	2144175	S	66	25	91	0.00041
ERR6913197	Megasphaera hexanoica	1675036	S	22	19	41	0.00018
ERR6913197	Megasphaera elsdenii	907	S	12	23	35	0.00016
ERR6913197	Dialister pneumosintes	39950	S	51	6	57	0.00026
ERR6913197	Dialister succinatiphilus	487173	S	14	3	17	0.00008
ERR6913197	Selenomonas sp. oral taxon 478	712538	S	46	29	75	0.00034
ERR6913197	Selenomonas sp. oral taxon 136	713030	S	42	24	66	0.00030
ERR6913197	Selenomonas sp. oral taxon 920	1884263	S	12	4	16	0.00007
ERR6913197	Selenomonas sp. oral taxon 126	712528	S	6	3	9	0.00004
ERR6913197	Selenomonas sputigena	69823	S	25	1	26	0.00012
ERR6913197	Selenomonas ruminantium	971	S	13	0	13	0.00006
ERR6913197	Selenomonas timonae	2754044	S	7	7	14	0.00006
ERR6913197	Lachnoanaerobaculum umeaense	617123	S	718	32	750	0.00337
ERR6913197	Blautia hansenii	1322	S	33	51	84	0.00038
ERR6913197	Blautia wexlerae	418240	S	22	41	63	0.00028
ERR6913197	Blautia obeum	40520	S	9	13	22	0.00010
ERR6913197	Blautia sp. SC05B48	2479767	S	5	28	33	0.00015
ERR6913197	Butyrivibrio fibrisolvens	831	S	28	14	42	0.00019
ERR6913197	Butyrivibrio proteoclasticus	43305	S	16	16	32	0.00014
ERR6913197	Anaerostipes hadrus	649756	S	67	43	110	0.00049
ERR6913197	Anaerostipes caccae	105841	S	6	0	6	0.00003
ERR6913197	[Ruminococcus] gnavus	33038	S	9	21	30	0.00013
ERR6913197	[Ruminococcus] torques	33039	S	9	35	44	0.00020
ERR6913197	[Ruminococcus] lactaris	46228	S	5	14	19	0.00009
ERR6913197	Lachnospira eligens	39485	S	52	19	71	0.00032
ERR6913197	Roseburia hominis	301301	S	35	34	69	0.00031
ERR6913197	Roseburia intestinalis	166486	S	7	17	24	0.00011
ERR6913197	Anaerobutyricum hallii	39488	S	41	40	81	0.00036
ERR6913197	Simiaoa sunii	2763672	S	37	36	73	0.00033
ERR6913197	Dorea longicatena	88431	S	26	44	70	0.00031
ERR6913197	Dorea formicigenerans	39486	S	10	18	28	0.00013
ERR6913197	[Clostridium] colinum	36835	S	35	1	36	0.00016
ERR6913197	Faecalicatena sp. Marseille-Q4148	2823316	S	32	34	66	0.00030
ERR6913197	Lacrimispora xylanolytica	29375	S	13	13	26	0.00012
ERR6913197	Lachnoclostridium phytofermentans	66219	S	18	3	21	0.00009
ERR6913197	Pseudobutyrivibrio xylanivorans	185007	S	23	2	25	0.00011
ERR6913197	Enterocloster bolteae	208479	S	5	11	16	0.00007
ERR6913197	Enterocloster asparagiformis	333367	S	5	1	6	0.00003
ERR6913197	Qiania dongpingensis	2763669	S	14	3	17	0.00008
ERR6913197	Anaeromicropila herbilytica	2785025	S	8	0	8	0.00004
ERR6913197	Herbinix luporum	1679721	S	7	3	10	0.00004
ERR6913197	Marvinbryantia formatexigens	168384	S	7	1	8	0.00004
ERR6913197	Wansuia hejianensis	2763667	S	5	0	5	0.00002
ERR6913197	Mogibacterium diversum	114527	S	100	26	126	0.00057
ERR6913197	Mogibacterium pumilum	86332	S	8	2	10	0.00004
ERR6913197	Aminipila butyrica	433296	S	15	8	23	0.00010
ERR6913197	Aminipila luticellarii	2507160	S	5	4	9	0.00004
ERR6913197	Emergencia timonensis	1776384	S	20	2	22	0.00010
ERR6913197	Fenollaria massiliensis	938288	S	5	0	5	0.00002
ERR6913197	Clostridium sp. M62/1	411486	S	21	23	44	0.00020
ERR6913197	Clostridium sp. MD294	97138	S	6	0	6	0.00003
ERR6913197	Clostridium sp. JN-1	2483110	S	6	1	7	0.00003
ERR6913197	Clostridium sp. SY8519	1042156	S	5	0	5	0.00002
ERR6913197	Clostridium botulinum	1491	S	30	20	50	0.00022
ERR6913197	Clostridium pasteurianum	1501	S	16	0	16	0.00007
ERR6913197	Clostridium tetani	1513	S	6	0	6	0.00003
ERR6913197	Clostridium perfringens	1502	S	5	2	7	0.00003
ERR6913197	Clostridium tyrobutyricum	1519	S	5	0	5	0.00002
ERR6913197	Clostridium beijerinckii	1520	S	5	1	6	0.00003
ERR6913197	Faecalibacterium prausnitzii	853	S	12	34	46	0.00021
ERR6913197	Ruminococcus bicirculans	1160721	S	8	1	9	0.00004
ERR6913197	Oscillibacter hominis	2763056	S	15	14	29	0.00013
ERR6913197	Flavonifractor plautii	292800	S	5	4	9	0.00004
ERR6913197	Fastidiosipila sanguinis	236753	S	5	0	5	0.00002
ERR6913197	Filifactor alocis	143361	S	49	4	53	0.00024
ERR6913197	Peptostreptococcus sp. CBA3647	3003601	S	11	1	12	0.00005
ERR6913197	Eubacterium ventriosum	39496	S	5	5	10	0.00004
ERR6913197	Christensenella minuta	626937	S	7	2	9	0.00004
ERR6913197	Caldanaerobacter subterraneus	911092	S	5	0	5	0.00002
ERR6913197	Parvimonas micra	33033	S	302	18	320	0.00144
ERR6913197	Peptoniphilus sp. SAHP1	2948573	S	9	1	10	0.00004
ERR6913197	Peptoniphilus ivorii	54006	S	5	0	5	0.00002
ERR6913197	Finegoldia magna	1260	S	14	2	16	0.00007
ERR6913197	Bulleidia sp. zg-1006	2806552	S	106	3	109	0.00049
ERR6913197	Longicatena caecimuris	1796635	S	5	1	6	0.00003
ERR6913197	Rothia mucilaginosa	43675	S	7632	1070	8702	0.03909
ERR6913197	Rothia dentocariosa	2047	S	363	259	622	0.00279
ERR6913197	Rothia aeria	172042	S	78	42	120	0.00054
ERR6913197	Rothia amarae	169480	S	9	2	11	0.00005
ERR6913197	Kocuria rhizophila	72000	S	421	299	720	0.00323
ERR6913197	Kocuria palustris	71999	S	82	30	112	0.00050
ERR6913197	Kocuria varians	1272	S	18	7	25	0.00011
ERR6913197	Kocuria indica	1049583	S	6	5	11	0.00005
ERR6913197	Kocuria rosea	1275	S	5	1	6	0.00003
ERR6913197	Micrococcus luteus	1270	S	54	201	255	0.00115
ERR6913197	Arthrobacter alpinus	656366	S	6	10	16	0.00007
ERR6913197	Arthrobacter antioxidans	2895818	S	6	1	7	0.00003
ERR6913197	Auritidibacter sp. NML130574	2170745	S	14	1	15	0.00007
ERR6913197	Citricoccus sp. SGAir0253	2567881	S	5	2	7	0.00003
ERR6913197	Renibacterium salmoninarum	1646	S	5	0	5	0.00002
ERR6913197	Microbacterium sp. PM5	2014534	S	11	12	23	0.00010
ERR6913197	Microbacterium oxydans	82380	S	23	24	47	0.00021
ERR6913197	Microbacterium oleivorans	273677	S	9	3	12	0.00005
ERR6913197	Microbacterium hominis	162426	S	8	28	36	0.00016
ERR6913197	Microbacterium aurum	36805	S	6	3	9	0.00004
ERR6913197	Microbacterium endophyticum	1526412	S	5	0	5	0.00002
ERR6913197	Curtobacterium sp. TC1	2862880	S	5	8	13	0.00006
ERR6913197	Clavibacter michiganensis	28447	S	5	16	21	0.00009
ERR6913197	Protaetiibacter larvae	2592654	S	6	4	10	0.00004
ERR6913197	Herbiconiux sp. SALV-R1	2735133	S	11	6	17	0.00008
ERR6913197	Aurantimicrobium photophilum	1987356	S	9	1	10	0.00004
ERR6913197	Agreia sp. COWG	2773266	S	8	2	10	0.00004
ERR6913197	Janibacter sp. CX7	2963431	S	19	10	29	0.00013
ERR6913197	Janibacter sp. YB324	2761047	S	8	19	27	0.00012
ERR6913197	Janibacter limosus	53458	S	25	8	33	0.00015
ERR6913197	Janibacter indicus	857417	S	16	28	44	0.00020
ERR6913197	Janibacter melonis	262209	S	7	2	9	0.00004
ERR6913197	Phycicoccus sp. HDW14	2714941	S	6	3	9	0.00004
ERR6913197	Cellulomonas sp. H30R-01	2704467	S	7	6	13	0.00006
ERR6913197	Cellulomonas fimi	1708	S	5	3	8	0.00004
ERR6913197	Cellulomonas fengjieae	2819978	S	5	1	6	0.00003
ERR6913197	Brevibacterium sp. CS2	2575923	S	15	4	19	0.00009
ERR6913197	Brevibacterium casei	33889	S	7	6	13	0.00006
ERR6913197	Brevibacterium luteolum	199591	S	5	1	6	0.00003
ERR6913197	Brachybacterium sp. NBEC-018	2996004	S	6	3	9	0.00004
ERR6913197	Brachybacterium saurashtrense	556288	S	7	4	11	0.00005
ERR6913197	Dermabacter jinjuensis	1667168	S	5	3	8	0.00004
ERR6913197	Kytococcus sedentarius	1276	S	34	9	43	0.00019
ERR6913197	Dermacoccus nishinomiyaensis	1274	S	17	6	23	0.00010
ERR6913197	Ruania suaedae	2897774	S	6	13	19	0.00009
ERR6913197	Georgenia faecalis	2483799	S	6	1	7	0.00003
ERR6913197	Georgenia wutianyii	2585135	S	6	1	7	0.00003
ERR6913197	Jonesia denitrificans	43674	S	9	0	9	0.00004
ERR6913197	Luteimicrobium xylanilyticum	1133546	S	5	1	6	0.00003
ERR6913197	Schaalia odontolytica	1660	S	1767	311	2078	0.00933
ERR6913197	Schaalia meyeri	52773	S	125	20	145	0.00065
ERR6913197	Schaalia sp. 19OD2882	2794089	S	11	1	12	0.00005
ERR6913197	Schaalia sp. ZJ405	2709403	S	7	0	7	0.00003
ERR6913197	Schaalia radingae	131110	S	8	0	8	0.00004
ERR6913197	Schaalia cardiffensis	181487	S	6	0	6	0.00003
ERR6913197	Schaalia turicensis	131111	S	5	0	5	0.00002
ERR6913197	Actinomyces pacaensis	1852377	S	424	43	467	0.00210
ERR6913197	Actinomyces sp. oral taxon 169	712116	S	36	49	85	0.00038
ERR6913197	Actinomyces sp. oral taxon 171	706438	S	20	10	30	0.00013
ERR6913197	Actinomyces sp. oral taxon 414	712122	S	18	2	20	0.00009
ERR6913197	Actinomyces sp. HMT 175	2789425	S	11	36	47	0.00021
ERR6913197	Actinomyces sp. 432	2057798	S	6	1	7	0.00003
ERR6913197	Actinomyces sp. Z16	2079536	S	5	1	6	0.00003
ERR6913197	Actinomyces oris	544580	S	72	104	176	0.00079
ERR6913197	Actinomyces trachealis	2763540	S	34	3	37	0.00017
ERR6913197	Actinomyces naeslundii	1655	S	32	9	41	0.00018
ERR6913197	Actinomyces howellii	52771	S	20	2	22	0.00010
ERR6913197	Actinomyces radicidentis	111015	S	17	3	20	0.00009
ERR6913197	Actinomyces viscosus	1656	S	13	3	16	0.00007
ERR6913197	Actinomyces faecalis	2722820	S	11	1	12	0.00005
ERR6913197	Actinomyces qiguomingii	2057800	S	8	0	8	0.00004
ERR6913197	Actinomyces lilanjuaniae	2321394	S	5	0	5	0.00002
ERR6913197	Actinomyces slackii	52774	S	5	0	5	0.00002
ERR6913197	Mobiluncus curtisii	2051	S	13	1	14	0.00006
ERR6913197	Trueperella pyogenes	1661	S	8	0	8	0.00004
ERR6913197	Pauljensenia hongkongensis	178339	S	11	3	14	0.00006
ERR6913197	Winkia neuii	33007	S	5	1	6	0.00003
ERR6913197	Fannyhessea vaginae	82135	S	5	0	5	0.00002
ERR6913197	Cutibacterium acnes	1747	S	1596	113	1709	0.00768
ERR6913197	Cutibacterium granulosum	33011	S	21	1	22	0.00010
ERR6913197	Cutibacterium modestum	2559073	S	16	0	16	0.00007
ERR6913197	Cutibacterium avidum	33010	S	9	1	10	0.00004
ERR6913197	Propionibacterium acidifaciens	556499	S	23	1	24	0.00011
ERR6913197	Arachnia propionica	1750	S	10	0	10	0.00004
ERR6913197	Arachnia rubra	1547448	S	5	0	5	0.00002
ERR6913197	Propioniciclava coleopterorum	2714937	S	6	1	7	0.00003
ERR6913197	Nocardioides sp. LMS-CY	2840457	S	7	3	10	0.00004
ERR6913197	Nocardioides sp. zg-1228	2763008	S	6	3	9	0.00004
ERR6913197	Nocardioides sp. InS609-2	2760705	S	6	1	7	0.00003
ERR6913197	Nocardioides sp. JS614	196162	S	5	4	9	0.00004
ERR6913197	Nocardioides sp. JQ2195	2592334	S	5	1	6	0.00003
ERR6913197	Nocardioides sp. zg-536	2803858	S	5	2	7	0.00003
ERR6913197	Nocardioides coralli	2872154	S	10	4	14	0.00006
ERR6913197	Nocardioides okcheonensis	2894081	S	8	5	13	0.00006
ERR6913197	Nocardioides cynanchi	2558918	S	7	2	9	0.00004
ERR6913197	Nocardioides marinisabuli	419476	S	5	4	9	0.00004
ERR6913197	Nocardioides ungokensis	1643322	S	5	2	7	0.00003
ERR6913197	Aeromicrobium sp. HA	3009077	S	5	2	7	0.00003
ERR6913197	Marmoricola scoriae	642780	S	8	3	11	0.00005
ERR6913197	Friedmanniella luteola	546871	S	6	0	6	0.00003
ERR6913197	Corynebacterium matruchotii	43768	S	112	2	114	0.00051
ERR6913197	Corynebacterium pseudodiphtheriticum	37637	S	89	11	100	0.00045
ERR6913197	Corynebacterium propinquum	43769	S	71	9	80	0.00036
ERR6913197	Corynebacterium tuberculostearicum	38304	S	48	9	57	0.00026
ERR6913197	Corynebacterium segmentosum	43990	S	30	38	68	0.00031
ERR6913197	Corynebacterium kefirresidentii	1979527	S	30	7	37	0.00017
ERR6913197	Corynebacterium accolens	38284	S	27	33	60	0.00027
ERR6913197	Corynebacterium kroppenstedtii	161879	S	24	0	24	0.00011
ERR6913197	Corynebacterium variabile	1727	S	20	4	24	0.00011
ERR6913197	Corynebacterium bovis	36808	S	14	1	15	0.00007
ERR6913197	Corynebacterium ureicelerivorans	401472	S	13	2	15	0.00007
ERR6913197	Corynebacterium efficiens	152794	S	12	1	13	0.00006
ERR6913197	Corynebacterium sp. FDAARGOS 1242	2778078	S	6	7	13	0.00006
ERR6913197	Corynebacterium xerosis	1725	S	9	6	15	0.00007
ERR6913197	Corynebacterium sanguinis	2594913	S	9	2	11	0.00005
ERR6913197	Corynebacterium ihumii	1232427	S	8	1	9	0.00004
ERR6913197	Corynebacterium macginleyi	38290	S	7	0	7	0.00003
ERR6913197	Corynebacterium sphenisci	191493	S	6	1	7	0.00003
ERR6913197	Corynebacterium simulans	146827	S	5	1	6	0.00003
ERR6913197	Mycolicibacterium celeriflavum	1249101	S	8	5	13	0.00006
ERR6913197	Mycolicibacterium psychrotolerans	216929	S	7	6	13	0.00006
ERR6913197	Mycolicibacterium litorale	758802	S	6	6	12	0.00005
ERR6913197	Mycolicibacterium phlei	1771	S	5	5	10	0.00004
ERR6913197	Mycobacterium sp. EPa45	1545728	S	6	9	15	0.00007
ERR6913197	Rhodococcus sp. P1Y	1302308	S	5	2	7	0.00003
ERR6913197	Rhodococcus fascians	1828	S	11	3	14	0.00006
ERR6913197	Rhodococcus opacus	37919	S	6	42	48	0.00022
ERR6913197	Nocardia cyriacigeorgica	135487	S	14	5	19	0.00009
ERR6913197	Nocardia asteroides	1824	S	11	3	14	0.00006
ERR6913197	Nocardia terpenica	455432	S	9	1	10	0.00004
ERR6913197	Nocardia brasiliensis	37326	S	5	1	6	0.00003
ERR6913197	Gordonia sp. KTR9	337191	S	5	3	8	0.00004
ERR6913197	Gordonia bronchialis	2054	S	6	2	8	0.00004
ERR6913197	Gordonia polyisoprenivorans	84595	S	5	1	6	0.00003
ERR6913197	Skermania piniformis	39122	S	6	1	7	0.00003
ERR6913197	Dietzia timorensis	499555	S	8	3	11	0.00005
ERR6913197	Dietzia sp. oral taxon 368	712270	S	6	5	11	0.00005
ERR6913197	Lawsonella clevelandensis	1528099	S	7	0	7	0.00003
ERR6913197	Streptomyces sp. T12	477697	S	21	59	80	0.00036
ERR6913197	Streptomyces sp. MRC013	2898276	S	5	9	14	0.00006
ERR6913197	Streptomyces sp. NA04227	2742136	S	5	4	9	0.00004
ERR6913197	Streptomyces sp. ST1015	1848900	S	5	7	12	0.00005
ERR6913197	Streptomyces sp. WAC 01529	2203205	S	5	16	21	0.00009
ERR6913197	Streptomyces venezuelae	54571	S	13	34	47	0.00021
ERR6913197	Streptomyces cadmiisoli	2184053	S	5	6	11	0.00005
ERR6913197	Streptomyces buecherae	2763006	S	7	5	12	0.00005
ERR6913197	Streptomyces tsukubensis	83656	S	6	6	12	0.00005
ERR6913197	Streptomyces rimosus	1927	S	6	5	11	0.00005
ERR6913197	Streptomyces formicae	1616117	S	5	15	20	0.00009
ERR6913197	Streptomyces roseirectus	2768066	S	5	6	11	0.00005
ERR6913197	Amycolatopsis sp. CA-230715	2745196	S	7	1	8	0.00004
ERR6913197	Amycolatopsis sp. Hca4	2742131	S	6	3	9	0.00004
ERR6913197	Amycolatopsis orientalis	31958	S	5	3	8	0.00004
ERR6913197	Pseudonocardia sp. DSM 110487	2865833	S	8	3	11	0.00005
ERR6913197	Pseudonocardia dioxanivorans	240495	S	8	1	9	0.00004
ERR6913197	Pseudonocardia broussonetiae	2736640	S	7	1	8	0.00004
ERR6913197	Pseudonocardia abyssalis	2792008	S	5	0	5	0.00002
ERR6913197	Saccharopolyspora pogona	333966	S	11	3	14	0.00006
ERR6913197	Saccharopolyspora gloriosae	455344	S	7	1	8	0.00004
ERR6913197	Saccharopolyspora erythraea	1836	S	5	1	6	0.00003
ERR6913197	Saccharothrix syringae	103733	S	5	1	6	0.00003
ERR6913197	Lentzea sp. HUAS12	2951806	S	5	4	9	0.00004
ERR6913197	Bifidobacterium dentium	1689	S	41	1	42	0.00019
ERR6913197	Bifidobacterium longum	216816	S	21	35	56	0.00025
ERR6913197	Bifidobacterium adolescentis	1680	S	8	6	14	0.00006
ERR6913197	Gardnerella vaginalis	2702	S	20	8	28	0.00013
ERR6913197	Gardnerella piotii	2792977	S	5	5	10	0.00004
ERR6913197	Parascardovia denticolens	78258	S	12	0	12	0.00005
ERR6913197	Micromonospora carbonacea	47853	S	5	9	14	0.00006
ERR6913197	Actinoplanes sp. L3-i22	2836373	S	7	3	10	0.00004
ERR6913197	Actinoplanes sp. N902-109	649831	S	5	2	7	0.00003
ERR6913197	Actinoplanes ianthinogenes	122358	S	6	2	8	0.00004
ERR6913197	Actinoplanes derwentensis	113562	S	5	1	6	0.00003
ERR6913197	Dactylosporangium fulvum	53359	S	7	8	15	0.00007
ERR6913197	Dactylosporangium aurantiacum	35754	S	6	1	7	0.00003
ERR6913197	Actinocatenispora thailandica	227318	S	5	0	5	0.00002
ERR6913197	Phytohabitans flavus	1076124	S	5	1	6	0.00003
ERR6913197	Actinomadura sp. WMMB 499	1219491	S	6	3	9	0.00004
ERR6913197	Actinomadura verrucosospora	46165	S	6	5	11	0.00005
ERR6913197	Nonomuraea sp. ATCC 55076	1909395	S	6	0	6	0.00003
ERR6913197	Candidatus Planktophila sulfonica	1884904	S	5	5	10	0.00004
ERR6913197	Frankia inefficax	298654	S	8	0	8	0.00004
ERR6913197	Blastococcus saxobsidens	138336	S	5	1	6	0.00003
ERR6913197	Jatrophihabitans telluris	2038343	S	7	0	7	0.00003
ERR6913197	Jatrophihabitans sp. SB3-54	2944128	S	5	0	5	0.00002
ERR6913197	Nakamurella multipartita	53461	S	5	0	5	0.00002
ERR6913197	Jiangella alkaliphila	419479	S	6	1	7	0.00003
ERR6913197	Stackebrandtia nassauensis	283811	S	5	0	5	0.00002
ERR6913197	Lancefieldella parvula	1382	S	632	17	649	0.00292
ERR6913197	Olsenella sp. oral taxon 807	712411	S	9	0	9	0.00004
ERR6913197	Parafannyhessea umbonata	604330	S	6	1	7	0.00003
ERR6913197	Collinsella aerofaciens	74426	S	5	1	6	0.00003
ERR6913197	Aquihabitans sp. G128	2849779	S	19	1	20	0.00009
ERR6913197	Aquihabitans sp. Kera 3	2884263	S	5	0	5	0.00002
ERR6913197	Iamia sp. SCSIO 61187	2722752	S	13	1	14	0.00006
ERR6913197	Iamia majanohamensis	467976	S	8	0	8	0.00004
ERR6913197	Actinomarinicola tropica	2789776	S	6	0	6	0.00003
ERR6913197	Ilumatobacter coccineus	467094	S	12	0	12	0.00005
ERR6913197	Conexibacter sp. SYSU D00693	2812560	S	7	5	12	0.00005
ERR6913197	Paraconexibacter antarcticus	2949664	S	5	1	6	0.00003
ERR6913197	Baekduia sp. 0141_2	2997333	S	8	0	8	0.00004
ERR6913197	Baekduia soli	496014	S	5	0	5	0.00002
ERR6913197	Microcoleus vaginatus	119532	S	8	1	9	0.00004
ERR6913197	Phormidium yuhuli	2974039	S	5	0	5	0.00002
ERR6913197	Limnospira indica	147322	S	8	41	49	0.00022
ERR6913197	Chondrocystis sp. NIES-4102	2005460	S	5	8	13	0.00006
ERR6913197	Calothrix sp. PCC 6303	1170562	S	9	13	22	0.00010
ERR6913197	Prochlorococcus marinus	1219	S	6	13	19	0.00009
ERR6913197	Chamaesiphon minutus	1173032	S	6	1	7	0.00003
ERR6913197	Leptolyngbya sp. 7M	2812896	S	5	5	10	0.00004
ERR6913197	Gloeomargarita lithophora	1188228	S	6	0	6	0.00003
ERR6913197	cyanobacterium endosymbiont of Epithemia turgida	718217	S	5	0	5	0.00002
ERR6913197	Thermus sp. NEB1569	2918899	S	11	10	21	0.00009
ERR6913197	Thermus scotoductus	37636	S	8	11	19	0.00009
ERR6913197	Thermus thermophilus	274	S	5	3	8	0.00004
ERR6913197	Deinococcus sp. NW-56	2080419	S	7	4	11	0.00005
ERR6913197	Metamycoplasma salivarium	2124	S	30	13	43	0.00019
ERR6913197	Pelolinea submarina	913107	S	5	0	5	0.00002
ERR6913197	Prevotella melaninogenica	28132	S	4541	1018	5559	0.02497
ERR6913197	Prevotella histicola	470565	S	2363	236	2599	0.01167
ERR6913197	Prevotella oris	28135	S	949	70	1019	0.00458
ERR6913197	Prevotella veroralis	28137	S	942	154	1096	0.00492
ERR6913197	Prevotella nigrescens	28133	S	920	401	1321	0.00593
ERR6913197	Prevotella jejuni	1177574	S	743	205	948	0.00426
ERR6913197	Prevotella sp. oral taxon 299	652716	S	284	20	304	0.00137
ERR6913197	Prevotella sp. oral taxon 475	712471	S	105	4	109	0.00049
ERR6913197	Prevotella sp. Rep29	2691580	S	22	1	23	0.00010
ERR6913197	Prevotella sp. E13-17	2913616	S	15	5	20	0.00009
ERR6913197	Prevotella sp. E15-22	2937774	S	13	9	22	0.00010
ERR6913197	Prevotella sp. E2-28	2913620	S	6	3	9	0.00004
ERR6913197	Prevotella sp. E9-3	2913621	S	6	2	8	0.00004
ERR6913197	Prevotella intermedia	28131	S	415	475	890	0.00400
ERR6913197	Prevotella scopos	589437	S	171	59	230	0.00103
ERR6913197	Prevotella denticola	28129	S	162	41	203	0.00091
ERR6913197	Prevotella herbatica	2801997	S	62	0	62	0.00028
ERR6913197	Prevotella corporis	28128	S	49	7	56	0.00025
ERR6913197	Prevotella multiformis	282402	S	43	13	56	0.00025
ERR6913197	Prevotella bryantii	77095	S	41	0	41	0.00018
ERR6913197	Prevotella copri	165179	S	38	1	39	0.00018
ERR6913197	Prevotella dentalis	52227	S	37	2	39	0.00018
ERR6913197	Prevotella fusca	589436	S	27	4	31	0.00014
ERR6913197	Prevotella ruminicola	839	S	19	0	19	0.00009
ERR6913197	Pseudoprevotella muciniphila	2133944	S	222	2	224	0.00101
ERR6913197	Hoylesella enoeca	76123	S	141	33	174	0.00078
ERR6913197	Hoylesella buccalis	28127	S	38	7	45	0.00020
ERR6913197	Paraprevotella xylaniphila	454155	S	46	5	51	0.00023
ERR6913197	Porphyromonas sp. oral taxon 275	712435	S	681	28	709	0.00318
ERR6913197	Porphyromonas endodontalis	28124	S	331	42	373	0.00168
ERR6913197	Porphyromonas gingivalis	837	S	103	22	125	0.00056
ERR6913197	Porphyromonas cangingivalis	36874	S	14	4	18	0.00008
ERR6913197	Porphyromonas somerae	322095	S	7	2	9	0.00004
ERR6913197	Tannerella serpentiformis	712710	S	408	15	423	0.00190
ERR6913197	Tannerella forsythia	28112	S	270	44	314	0.00141
ERR6913197	Parabacteroides goldsteinii	328812	S	12	1	13	0.00006
ERR6913197	Parabacteroides distasonis	823	S	7	17	24	0.00011
ERR6913197	Bacteroides heparinolyticus	28113	S	22	7	29	0.00013
ERR6913197	Bacteroides stercoris	46506	S	19	5	24	0.00011
ERR6913197	Bacteroides uniformis	820	S	15	32	47	0.00021
ERR6913197	Bacteroides xylanisolvens	371601	S	15	49	64	0.00029
ERR6913197	Bacteroides intestinalis	329854	S	11	3	14	0.00006
ERR6913197	Bacteroides thetaiotaomicron	818	S	9	3	12	0.00005
ERR6913197	Bacteroides zoogleoformans	28119	S	9	3	12	0.00005
ERR6913197	Bacteroides salyersiae	291644	S	8	1	9	0.00004
ERR6913197	Bacteroides eggerthii	28111	S	7	2	9	0.00004
ERR6913197	Bacteroides faecium	2715212	S	6	0	6	0.00003
ERR6913197	Bacteroides caccae	47678	S	5	1	6	0.00003
ERR6913197	Bacteroides nordii	291645	S	5	0	5	0.00002
ERR6913197	Bacteroides ovatus	28116	S	5	32	37	0.00017
ERR6913197	Phocaeicola vulgatus	821	S	29	29	58	0.00026
ERR6913197	Phocaeicola dorei	357276	S	23	20	43	0.00019
ERR6913197	Phocaeicola coprophilus	387090	S	21	6	27	0.00012
ERR6913197	Phocaeicola salanitronis	376805	S	15	1	16	0.00007
ERR6913197	Alistipes communis	2585118	S	6	16	22	0.00010
ERR6913197	Coprobacter secundus	1501392	S	15	1	16	0.00007
ERR6913197	Barnesiella viscericola	397865	S	6	0	6	0.00003
ERR6913197	Odoribacter splanchnicus	28118	S	14	0	14	0.00006
ERR6913197	Sodaliphilus pleomorphus	2606626	S	8	0	8	0.00004
ERR6913197	Petrimonas mucosa	1642646	S	10	5	15	0.00007
ERR6913197	Paludibacter propionicigenes	185300	S	8	0	8	0.00004
ERR6913197	Candidatus Azobacteroides pseudotrichonymphae	511435	S	6	0	6	0.00003
ERR6913197	Alkalitalea saponilacus	889453	S	8	0	8	0.00004
ERR6913197	Capnocytophaga gingivalis	1017	S	255	35	290	0.00130
ERR6913197	Capnocytophaga sputigena	1019	S	37	19	56	0.00025
ERR6913197	Capnocytophaga sp. FDAARGOS_737	2545799	S	19	16	35	0.00016
ERR6913197	Capnocytophaga sp. oral taxon 878	1316596	S	9	3	12	0.00005
ERR6913197	Capnocytophaga leadbetteri	327575	S	18	16	34	0.00015
ERR6913197	Capnocytophaga ochracea	1018	S	9	26	35	0.00016
ERR6913197	Capnocytophaga endodontalis	2708117	S	5	4	9	0.00004
ERR6913197	Flavobacterium sp. Sr18	935222	S	19	8	27	0.00012
ERR6913197	Flavobacterium sp. IMCC36792	3016339	S	17	7	24	0.00011
ERR6913197	Flavobacterium sp. IMCC36791	3003262	S	15	4	19	0.00009
ERR6913197	Flavobacterium sp. KBS0721	1179672	S	9	10	19	0.00009
ERR6913197	Flavobacterium sp. IMCC36793	3003263	S	8	3	11	0.00005
ERR6913197	Flavobacterium sp. F-340	2893886	S	7	3	10	0.00004
ERR6913197	Flavobacterium sp. N2820	2986834	S	6	3	9	0.00004
ERR6913197	Flavobacterium sp. M31R6	2739062	S	6	3	9	0.00004
ERR6913197	Flavobacterium sp. N1846	2986824	S	5	2	7	0.00003
ERR6913197	Flavobacterium sp. TR2	2977321	S	5	7	12	0.00005
ERR6913197	Flavobacterium sp. 140616W15	2478552	S	5	2	7	0.00003
ERR6913197	Flavobacterium sp. LPB0248	2614441	S	5	10	15	0.00007
ERR6913197	Flavobacterium sp. K5-23	2746225	S	5	2	7	0.00003
ERR6913197	Flavobacterium ammoniigenes	1751095	S	11	7	18	0.00008
ERR6913197	Flavobacterium psychrophilum	96345	S	11	4	15	0.00007
ERR6913197	Flavobacterium ammonificans	1751056	S	8	5	13	0.00006
ERR6913197	Flavobacterium sangjuense	2518177	S	7	1	8	0.00004
ERR6913197	Flavobacterium crocinum	2183896	S	6	6	12	0.00005
ERR6913197	Flavobacterium pallidum	2172098	S	6	1	7	0.00003
ERR6913197	Flavobacterium haoranii	683124	S	6	6	12	0.00005
ERR6913197	Flavobacterium endoglycinae	2816357	S	5	3	8	0.00004
ERR6913197	Zunongwangia profunda	398743	S	16	34	50	0.00022
ERR6913197	Abyssalbus ytuae	2926907	S	15	2	17	0.00008
ERR6913197	Amniculibacterium sp. G2-70	2767188	S	5	6	11	0.00005
ERR6913197	Chryseobacterium sp. POL2	2713414	S	8	7	15	0.00007
ERR6913197	Chryseobacterium sp. Y16C	2920939	S	5	15	20	0.00009
ERR6913197	Chryseobacterium manosquense	2754694	S	12	17	29	0.00013
ERR6913197	Chryseobacterium indologenes	253	S	5	9	14	0.00006
ERR6913197	Chryseobacterium capnotolerans	2759528	S	5	11	16	0.00007
ERR6913197	Kaistella jeonii	266749	S	5	2	7	0.00003
ERR6913197	Epilithonimonas vandammei	2487072	S	14	19	33	0.00015
ERR6913197	Bergeyella cardium	1585976	S	15	3	18	0.00008
ERR6913197	Cloacibacterium caeni	2004710	S	10	16	26	0.00012
ERR6913197	Riemerella anatipestifer	34085	S	10	1	11	0.00005
ERR6913197	Empedobacter falsenii	343874	S	6	3	9	0.00004
ERR6913197	Fluviicola taffensis	191579	S	6	0	6	0.00003
ERR6913197	Spirosoma sp. KCTC 42546	2520506	S	5	4	9	0.00004
ERR6913197	Spirosoma montaniterrae	1178516	S	9	10	19	0.00009
ERR6913197	Cytophaga hutchinsonii	985	S	6	3	9	0.00004
ERR6913197	Fibrella sp. ES10-3-2-2	1834519	S	5	4	9	0.00004
ERR6913197	Mongoliitalea daihaiensis	2782006	S	5	1	6	0.00003
ERR6913197	Chryseolinea soli	2321403	S	8	1	9	0.00004
ERR6913197	Pedobacter cryoconitis	188932	S	8	1	9	0.00004
ERR6913197	Pedobacter roseus	336820	S	6	3	9	0.00004
ERR6913197	Pedobacter endophyticus	2789740	S	5	0	5	0.00002
ERR6913197	Sphingobacterium sp. UDSM-2020	2795738	S	5	1	6	0.00003
ERR6913197	Sphingobacterium multivorum	28454	S	6	12	18	0.00008
ERR6913197	Sphingobacterium daejeonense	371142	S	6	1	7	0.00003
ERR6913197	Mucilaginibacter sp. KACC 22773	3025671	S	5	7	12	0.00005
ERR6913197	Arachidicoccus sp. B3-10	2545455	S	7	1	8	0.00004
ERR6913197	Niastella koreensis	354356	S	6	1	7	0.00003
ERR6913197	Sediminibacterium sp. TEGAF015	575378	S	6	1	7	0.00003
ERR6913197	Phnomibacter ginsenosidimutans	2676868	S	6	1	7	0.00003
ERR6913197	Filimonas lacunae	477680	S	5	1	6	0.00003
ERR6913197	Pseudobacter ginsenosidimutans	661488	S	5	1	6	0.00003
ERR6913197	Panacibacter ginsenosidivorans	1813871	S	5	0	5	0.00002
ERR6913197	Haliscomenobacter hydrossis	2350	S	8	0	8	0.00004
ERR6913197	Gemmatirosa kalamazoonensis	861299	S	15	2	17	0.00008
ERR6913197	Fusobacterium nucleatum	851	S	669	646	1315	0.00591
ERR6913197	Fusobacterium pseudoperiodonticum	2663009	S	351	285	636	0.00286
ERR6913197	Fusobacterium periodonticum	860	S	34	106	140	0.00063
ERR6913197	Fusobacterium hwasookii	1583098	S	11	25	36	0.00016
ERR6913197	Fusobacterium necrophorum	859	S	5	0	5	0.00002
ERR6913197	Fusobacterium gastrosuis	1755100	S	5	0	5	0.00002
ERR6913197	Leptotrichia sp. oral taxon 212	712357	S	470	13	483	0.00217
ERR6913197	Leptotrichia sp. oral taxon 221	712362	S	195	23	218	0.00098
ERR6913197	Leptotrichia sp. oral taxon 218	712361	S	33	7	40	0.00018
ERR6913197	Leptotrichia sp. oral taxon 498	712368	S	13	3	16	0.00007
ERR6913197	Leptotrichia sp. oral taxon 847	1785996	S	11	1	12	0.00005
ERR6913197	Leptotrichia wadei	157687	S	534	108	642	0.00288
ERR6913197	Leptotrichia shahii	157691	S	30	7	37	0.00017
ERR6913197	Leptotrichia hofstadii	157688	S	23	5	28	0.00013
ERR6913197	Leptotrichia hongkongensis	554406	S	21	4	25	0.00011
ERR6913197	Leptotrichia trevisanii	109328	S	20	2	22	0.00010
ERR6913197	Leptotrichia buccalis	40542	S	6	0	6	0.00003
ERR6913197	Streptobacillus moniliformis	34105	S	29	11	40	0.00018
ERR6913197	Pseudoleptotrichia goodfellowii	157692	S	12	0	12	0.00005
ERR6913197	Sebaldella termitidis	826	S	7	0	7	0.00003
ERR6913197	Campylobacter concisus	199	S	527	1	528	0.00237
ERR6913197	Campylobacter gracilis	824	S	85	0	85	0.00038
ERR6913197	Campylobacter showae	204	S	61	0	61	0.00027
ERR6913197	Campylobacter rectus	203	S	54	0	54	0.00024
ERR6913197	Campylobacter curvus	200	S	15	0	15	0.00007
ERR6913197	Campylobacter jejuni	197	S	6	304	310	0.00139
ERR6913197	Arcobacter suis	1278212	S	7	1	8	0.00004
ERR6913197	Aliarcobacter cryaerophilus	28198	S	9	3	12	0.00005
ERR6913197	Candidatus Nanosynbacter sp. HMT-352	2899133	S	450	134	584	0.00262
ERR6913197	Candidatus Nanosynbacter lyticus	2093824	S	10	7	17	0.00008
ERR6913197	Candidatus Nanosynbacter featherlites	2572088	S	9	3	12	0.00005
ERR6913197	Candidatus Saccharimonas aalborgensis	1332188	S	13	0	13	0.00006
ERR6913197	Candidatus Minimicrobia vallesae	2841264	S	37	13	50	0.00022
ERR6913197	Candidatus Mycosynbacter amalyticus	2665156	S	8	0	8	0.00004
ERR6913197	Treponema sp. OMZ 906	2563662	S	24	67	91	0.00041
ERR6913197	Treponema sp. OMZ 803	120682	S	17	48	65	0.00029
ERR6913197	Treponema sp. Marseille-Q4132	2766701	S	11	1	12	0.00005
ERR6913197	Treponema sp. OMZ 838	1539298	S	8	19	27	0.00012
ERR6913197	Treponema sp. OMZ 305	1659192	S	6	13	19	0.00009
ERR6913197	Treponema sp. OMZ 857	1643513	S	5	6	11	0.00005
ERR6913197	Treponema denticola	158	S	80	81	161	0.00072
ERR6913197	Treponema vincentii	69710	S	36	19	55	0.00025
ERR6913197	Treponema socranskii	53419	S	26	3	29	0.00013
ERR6913197	Treponema medium	58231	S	17	7	24	0.00011
ERR6913197	Treponema brennaborense	81028	S	5	0	5	0.00002
ERR6913197	Treponema putidum	221027	S	5	1	6	0.00003
ERR6913197	Lacipirellula parvula	2650471	S	8	2	10	0.00004
ERR6913197	Planctomyces sp. SH-PL14	1632864	S	5	1	6	0.00003
ERR6913197	Urbifossiella limnaea	2528023	S	16	7	23	0.00010
ERR6913197	Aquisphaera giovannonii	406548	S	8	2	10	0.00004
ERR6913197	Tautonia plasticadhaerens	2527974	S	7	1	8	0.00004
ERR6913197	Paludisphaera borealis	1387353	S	6	2	8	0.00004
ERR6913197	Verrucomicrobium spinosum	2736	S	10	2	12	0.00005
ERR6913197	Luteolibacter sp. SL250	2995170	S	5	1	6	0.00003
ERR6913197	Roseimicrobium sp. ORNL1	2711231	S	8	1	9	0.00004
ERR6913197	Akkermansia muciniphila	239935	S	9	4	13	0.00006
ERR6913197	Opitutus sp. GAS368	1882749	S	9	1	10	0.00004
ERR6913197	Nibricoccus aquaticus	2576891	S	10	0	10	0.00004
ERR6913197	Lacunisphaera limnophila	1838286	S	7	0	7	0.00003
ERR6913197	Horticoccus luteus	2862869	S	7	0	7	0.00003
ERR6913197	Sorangium cellulosum	56	S	15	14	29	0.00013
ERR6913197	Labilithrix luteola	1391654	S	15	1	16	0.00007
ERR6913197	Sandaracinus amylolyticus	927083	S	9	1	10	0.00004
ERR6913197	Nannocystis sp. fl3	2995304	S	12	0	12	0.00005
ERR6913197	Haliangium ochraceum	80816	S	6	0	6	0.00003
ERR6913197	Pyxidicoccus sp. SCPEA002	2813578	S	5	4	9	0.00004
ERR6913197	Archangium violaceum	83451	S	5	4	9	0.00004
ERR6913197	Luteitalea sp. TBR-22	2802971	S	15	2	17	0.00008
ERR6913197	Luteitalea pratensis	1855912	S	11	1	12	0.00005
ERR6913197	Paludibaculum fermentans	1473598	S	5	0	5	0.00002
ERR6913197	Fervidobacterium nodosum	2424	S	6	2	8	0.00004
ERR6913197	Fretibacterium fastidiosum	651822	S	11	0	11	0.00005
ERR6913197	Bdellovibrio bacteriovorus	959	S	5	2	7	0.00003
ERR6913197	Nitrospira moscoviensis	42253	S	5	1	6	0.00003
ERR6913197	Persicimonas caeni	2292766	S	6	0	6	0.00003
ERR6913197	Malassezia restricta	76775	S	178	4	182	0.00082
ERR6913197	Sporisorium graminicola	280036	S	5	0	5	0.00002
ERR6913197	Puccinia triticina	208348	S	7	1	8	0.00004
ERR6913197	Candida albicans	5476	S	15	24	39	0.00018
ERR6913197	Ustilaginoidea virens	1159556	S	9	6	15	0.00007
ERR6913197	Botrytis cinerea	40559	S	7	2	9	0.00004
ERR6913197	Homo sapiens	9606	S	258	2	260	0.00117
ERR6913197	Phaeodactylum tricornutum	2850	S	110	5	115	0.00052
ERR6913197	Thalassiosira pseudonana	35128	S	72	6	78	0.00035
ERR6913197	Babesia bigemina	5866	S	20	7	27	0.00012
ERR6913197	Plasmodium malariae	5858	S	6	0	6	0.00003
ERR6913197	Neospora caninum	29176	S	7	2	9	0.00004
ERR6913197	Bigelowiella natans	227086	S	5	1	6	0.00003
ERR6913197	Guillardia theta	55529	S	8	2	10	0.00004
ERR6913197	Trichomonas vaginalis	5722	S	5	0	5	0.00002
ERR6913197	Severe acute respiratory syndrome-related coronavirus	694009	S	8980	0	8980	0.04034
ERR6913197	Vhmlvirus VP585	1922213	S	10	20	30	0.00013
ERR6913197	Streptococcus phage PH10	644007	S	10	0	10	0.00004
ERR6913197	Human gammaherpesvirus 4	10376	S	6	0	6	0.00003
ERR6913197	Human mastadenovirus C	129951	S	8	0	8	0.00004
ERR6913275	Streptococcus mitis	28037	S	23487	10668	34155	0.12788
ERR6913275	Streptococcus pneumoniae	1313	S	11127	82297	93424	0.34980
ERR6913275	Streptococcus sp. 116-D4	2598453	S	2936	1000	3936	0.01474
ERR6913275	Streptococcus sp. LPB0220	2610896	S	868	405	1273	0.00477
ERR6913275	Streptococcus sp. oral taxon 431	712633	S	723	124	847	0.00317
ERR6913275	Streptococcus sp. HSISM1	1316408	S	662	286	948	0.00355
ERR6913275	Streptococcus sp. oral taxon 061	712623	S	285	89	374	0.00140
ERR6913275	Streptococcus sp. NPS 308	1902136	S	279	142	421	0.00158
ERR6913275	Streptococcus sp. Marseille-Q3533	2759692	S	220	44	264	0.00099
ERR6913275	Streptococcus sp. Marseille-Q6470	2972784	S	206	58	264	0.00099
ERR6913275	Streptococcus sp. 1643	2576376	S	114	141	255	0.00095
ERR6913275	Streptococcus sp. A12	1759399	S	96	36	132	0.00049
ERR6913275	Streptococcus sp. oral taxon 064	712624	S	54	138	192	0.00072
ERR6913275	Streptococcus sp. HSISS2	1316411	S	51	62	113	0.00042
ERR6913275	Streptococcus sp. FDAARGOS_192	1839799	S	43	80	123	0.00046
ERR6913275	Streptococcus sp. HSISS3	1316412	S	33	38	71	0.00027
ERR6913275	Streptococcus sp. KS 6	2598457	S	12	11	23	0.00009
ERR6913275	Streptococcus sp. zg-86	2664091	S	11	1	12	0.00004
ERR6913275	Streptococcus sp. HN38	3020829	S	11	16	27	0.00010
ERR6913275	Streptococcus sp. CNU G3	2698804	S	9	20	29	0.00011
ERR6913275	Streptococcus sp. FDAARGOS_522	2420310	S	7	461	468	0.00175
ERR6913275	Streptococcus sp. HSISS1	1316410	S	6	187	193	0.00072
ERR6913275	Streptococcus oralis	1303	S	4743	2237	6980	0.02613
ERR6913275	Streptococcus pseudopneumoniae	257758	S	3911	2367	6278	0.02351
ERR6913275	Streptococcus toyakuensis	2819619	S	2136	1751	3887	0.01455
ERR6913275	Streptococcus vestibularis	1343	S	2021	804	2825	0.01058
ERR6913275	Streptococcus gwangjuense	1433513	S	1774	1145	2919	0.01093
ERR6913275	Streptococcus anginosus	1328	S	917	1013	1930	0.00723
ERR6913275	Streptococcus intermedius	1338	S	73	38	111	0.00042
ERR6913275	Streptococcus constellatus	76860	S	41	9016	9057	0.03391
ERR6913275	Streptococcus parasanguinis	1318	S	968	355	1323	0.00495
ERR6913275	Streptococcus salivarius	1304	S	794	590	1384	0.00518
ERR6913275	Streptococcus thermophilus	1308	S	666	2753	3419	0.01280
ERR6913275	Streptococcus infantis	68892	S	432	91	523	0.00196
ERR6913275	Streptococcus suis	1307	S	359	888	1247	0.00467
ERR6913275	Streptococcus australis	113107	S	353	316	669	0.00250
ERR6913275	Streptococcus gordonii	1302	S	295	30	325	0.00122
ERR6913275	Streptococcus sanguinis	1305	S	285	29	314	0.00118
ERR6913275	Streptococcus cristatus	45634	S	272	52	324	0.00121
ERR6913275	Streptococcus ferus	1345	S	223	7	230	0.00086
ERR6913275	Streptococcus pyogenes	1314	S	180	835	1015	0.00380
ERR6913275	Streptococcus lactarius	684066	S	147	19	166	0.00062
ERR6913275	Streptococcus agalactiae	1311	S	143	21383	21526	0.08060
ERR6913275	Streptococcus ilei	1156431	S	63	59	122	0.00046
ERR6913275	Streptococcus rubneri	1234680	S	47	34	81	0.00030
ERR6913275	Streptococcus sobrinus	1310	S	44	1	45	0.00017
ERR6913275	Streptococcus equi	1336	S	29	1	30	0.00011
ERR6913275	Streptococcus dysgalactiae	1334	S	11	3	14	0.00005
ERR6913275	Streptococcus chenjunshii	2173853	S	32	0	32	0.00012
ERR6913275	Streptococcus pantholopis	1811193	S	32	0	32	0.00012
ERR6913275	Streptococcus ratti	1341	S	30	0	30	0.00011
ERR6913275	Streptococcus pluranimalium	82348	S	28	2	30	0.00011
ERR6913275	Streptococcus mutans	1309	S	27	5	32	0.00012
ERR6913275	Streptococcus koreensis	2382163	S	20	22	42	0.00016
ERR6913275	Streptococcus respiraculi	2021971	S	20	1	21	0.00008
ERR6913275	Streptococcus equinus	1335	S	19	5	24	0.00009
ERR6913275	Streptococcus iniae	1346	S	19	1	20	0.00007
ERR6913275	Streptococcus uberis	1349	S	18	1	19	0.00007
ERR6913275	Streptococcus canis	1329	S	17	2	19	0.00007
ERR6913275	Streptococcus parasuis	1501662	S	16	15	31	0.00012
ERR6913275	Streptococcus acidominimus	1326	S	14	1	15	0.00006
ERR6913275	Streptococcus marmotae	1825069	S	14	2	16	0.00006
ERR6913275	Streptococcus pseudoporcinus	361101	S	13	2	15	0.00006
ERR6913275	Streptococcus troglodytae	1111760	S	13	2	15	0.00006
ERR6913275	Streptococcus pasteurianus	197614	S	11	46	57	0.00021
ERR6913275	Streptococcus urinalis	149016	S	11	1	12	0.00004
ERR6913275	Streptococcus halichoeri	254785	S	9	0	9	0.00003
ERR6913275	Streptococcus parauberis	1348	S	9	2	11	0.00004
ERR6913275	Streptococcus alactolyticus	29389	S	9	2	11	0.00004
ERR6913275	Streptococcus ruminantium	1917441	S	8	11	19	0.00007
ERR6913275	Streptococcus porcinus	1340	S	8	0	8	0.00003
ERR6913275	Streptococcus halotolerans	1814128	S	8	0	8	0.00003
ERR6913275	Streptococcus oriscaviae	2781599	S	8	0	8	0.00003
ERR6913275	Streptococcus merionis	400065	S	5	0	5	0.00002
ERR6913275	Streptococcus gallolyticus	315405	S	5	5	10	0.00004
ERR6913275	Lactococcus cremoris	1359	S	9	19	28	0.00010
ERR6913275	Lactococcus lactis	1358	S	5	2	7	0.00003
ERR6913275	Floricoccus penangensis	1859475	S	5	0	5	0.00002
ERR6913275	Granulicatella adiacens	46124	S	350	29	379	0.00142
ERR6913275	Granulicatella elegans	137732	S	14	3	17	0.00006
ERR6913275	Dolosigranulum pigrum	29394	S	9	0	9	0.00003
ERR6913275	Lactobacillus crispatus	47770	S	39	28	67	0.00025
ERR6913275	Lactobacillus delbrueckii	1584	S	11	7	18	0.00007
ERR6913275	Lactiplantibacillus plantarum	1590	S	15	4	19	0.00007
ERR6913275	Lactiplantibacillus paraplantarum	60520	S	5	0	5	0.00002
ERR6913275	Oenococcus oeni	1247	S	13	0	13	0.00005
ERR6913275	Latilactobacillus sakei	1599	S	6	1	7	0.00003
ERR6913275	Latilactobacillus curvatus	28038	S	5	1	6	0.00002
ERR6913275	Limosilactobacillus reuteri	1598	S	6	1	7	0.00003
ERR6913275	Lacticaseibacillus paracasei	1597	S	5	1	6	0.00002
ERR6913275	Enterococcus faecium	1352	S	41	37	78	0.00029
ERR6913275	Enterococcus faecalis	1351	S	22	112	134	0.00050
ERR6913275	Tetragenococcus halophilus	51669	S	16	1	17	0.00006
ERR6913275	Abiotrophia defectiva	46125	S	79	6	85	0.00032
ERR6913275	Suicoccus acidiformans	2036206	S	17	1	18	0.00007
ERR6913275	Gemella haemolysans	1379	S	11572	10623	22195	0.08310
ERR6913275	Gemella sanguinis	84135	S	267	365	632	0.00237
ERR6913275	Gemella sp. zg-570	2840371	S	141	150	291	0.00109
ERR6913275	Gemella morbillorum	29391	S	212	324	536	0.00201
ERR6913275	Bacillus atrophaeus	1452	S	1334	611	1945	0.00728
ERR6913275	Bacillus velezensis	492670	S	20	34	54	0.00020
ERR6913275	Bacillus amyloliquefaciens	1390	S	11	19	30	0.00011
ERR6913275	Bacillus subtilis	1423	S	8	65	73	0.00027
ERR6913275	Bacillus licheniformis	1402	S	6	3	9	0.00003
ERR6913275	Bacillus cereus	1396	S	16	120	136	0.00051
ERR6913275	Bacillus anthracis	1392	S	13	649	662	0.00248
ERR6913275	Bacillus thuringiensis	1428	S	11	2	13	0.00005
ERR6913275	Bacillus paranthracis	2026186	S	6	11	17	0.00006
ERR6913275	Bacillus mycoides	1405	S	5	0	5	0.00002
ERR6913275	Bacillus sp. FJAT-14266	1837130	S	8	178	186	0.00070
ERR6913275	Bacillus pumilus	1408	S	5	0	5	0.00002
ERR6913275	Anoxybacillus flavithermus	33934	S	6	6	12	0.00004
ERR6913275	Priestia megaterium	1404	S	8	1	9	0.00003
ERR6913275	Staphylococcus epidermidis	1282	S	94	6	100	0.00037
ERR6913275	Staphylococcus capitis	29388	S	56	6	62	0.00023
ERR6913275	Staphylococcus aureus	1280	S	38	54	92	0.00034
ERR6913275	Staphylococcus hominis	1290	S	13	0	13	0.00005
ERR6913275	Staphylococcus simulans	1286	S	8	0	8	0.00003
ERR6913275	Staphylococcus pseudintermedius	283734	S	8	0	8	0.00003
ERR6913275	Staphylococcus arlettae	29378	S	5	0	5	0.00002
ERR6913275	Listeria monocytogenes	1639	S	16	43	59	0.00022
ERR6913275	Listeria innocua	1642	S	5	0	5	0.00002
ERR6913275	Veillonella atypica	39777	S	1291	262	1553	0.00581
ERR6913275	Veillonella parvula	29466	S	546	167	713	0.00267
ERR6913275	Veillonella nakazawae	2682456	S	527	1521	2048	0.00767
ERR6913275	Veillonella rogosae	423477	S	312	196	508	0.00190
ERR6913275	Veillonella sp. S12025-13	2682455	S	237	614	851	0.00319
ERR6913275	Veillonella dispar	39778	S	204	274	478	0.00179
ERR6913275	Veillonella rodentium	248315	S	19	2	21	0.00008
ERR6913275	Megasphaera stantonii	2144175	S	58	21	79	0.00030
ERR6913275	Megasphaera hexanoica	1675036	S	17	13	30	0.00011
ERR6913275	Megasphaera elsdenii	907	S	8	16	24	0.00009
ERR6913275	Selenomonas sp. oral taxon 920	1884263	S	6	8	14	0.00005
ERR6913275	Selenomonas sputigena	69823	S	9	1	10	0.00004
ERR6913275	Caloramator sp. Dgby_cultured_2	3029174	S	104	31	135	0.00051
ERR6913275	Clostridium neonatale	137838	S	20	2	22	0.00008
ERR6913275	Clostridium botulinum	1491	S	7	19	26	0.00010
ERR6913275	Clostridium pasteurianum	1501	S	6	0	6	0.00002
ERR6913275	Clostridium tyrobutyricum	1519	S	6	0	6	0.00002
ERR6913275	Lachnoanaerobaculum umeaense	617123	S	31	3	34	0.00013
ERR6913275	Blautia wexlerae	418240	S	5	27	32	0.00012
ERR6913275	Anaerostipes hadrus	649756	S	5	8	13	0.00005
ERR6913275	Peptostreptococcus sp. CBA3647	3003601	S	20	4	24	0.00009
ERR6913275	Filifactor alocis	143361	S	5	0	5	0.00002
ERR6913275	Natranaerobius thermophilus	375929	S	6	0	6	0.00002
ERR6913275	Finegoldia magna	1260	S	28	2	30	0.00011
ERR6913275	Gottschalkia acidurici	1556	S	5	0	5	0.00002
ERR6913275	Bulleidia sp. zg-1006	2806552	S	6	4	10	0.00004
ERR6913275	Rothia mucilaginosa	43675	S	2416	423	2839	0.01063
ERR6913275	Rothia dentocariosa	2047	S	1906	779	2685	0.01005
ERR6913275	Rothia aeria	172042	S	228	72	300	0.00112
ERR6913275	Kocuria rhizophila	72000	S	51	67	118	0.00044
ERR6913275	Kocuria palustris	71999	S	8	5	13	0.00005
ERR6913275	Micrococcus luteus	1270	S	12	46	58	0.00022
ERR6913275	Micrococcus sp. KD337-16	2856555	S	5	5	10	0.00004
ERR6913275	Auritidibacter sp. NML130574	2170745	S	19	3	22	0.00008
ERR6913275	Renibacterium salmoninarum	1646	S	10	1	11	0.00004
ERR6913275	Microbacterium aurum	36805	S	8	12	20	0.00007
ERR6913275	Cutibacterium acnes	1747	S	2676	219	2895	0.01084
ERR6913275	Cutibacterium granulosum	33011	S	116	7	123	0.00046
ERR6913275	Cutibacterium avidum	33010	S	13	1	14	0.00005
ERR6913275	Cutibacterium modestum	2559073	S	10	0	10	0.00004
ERR6913275	Arachnia propionica	1750	S	29	1	30	0.00011
ERR6913275	Arachnia rubra	1547448	S	7	0	7	0.00003
ERR6913275	Schaalia odontolytica	1660	S	357	84	441	0.00165
ERR6913275	Schaalia meyeri	52773	S	15	3	18	0.00007
ERR6913275	Actinomyces sp. oral taxon 169	712116	S	27	38	65	0.00024
ERR6913275	Actinomyces sp. oral taxon 171	706438	S	11	6	17	0.00006
ERR6913275	Actinomyces sp. oral taxon 414	712122	S	5	0	5	0.00002
ERR6913275	Actinomyces oris	544580	S	57	83	140	0.00052
ERR6913275	Actinomyces pacaensis	1852377	S	32	4	36	0.00013
ERR6913275	Actinomyces naeslundii	1655	S	10	3	13	0.00005
ERR6913275	Actinomyces trachealis	2763540	S	7	0	7	0.00003
ERR6913275	Pauljensenia hongkongensis	178339	S	6	2	8	0.00003
ERR6913275	Actinotignum schaalii	59505	S	5	0	5	0.00002
ERR6913275	Corynebacterium matruchotii	43768	S	87	1	88	0.00033
ERR6913275	Corynebacterium ihumii	1232427	S	36	6	42	0.00016
ERR6913275	Corynebacterium tuberculostearicum	38304	S	36	6	42	0.00016
ERR6913275	Corynebacterium jeikeium	38289	S	18	14	32	0.00012
ERR6913275	Corynebacterium amycolatum	43765	S	17	44	61	0.00023
ERR6913275	Corynebacterium genitalium	38288	S	10	0	10	0.00004
ERR6913275	Corynebacterium sanguinis	2594913	S	8	2	10	0.00004
ERR6913275	Corynebacterium kefirresidentii	1979527	S	7	1	8	0.00003
ERR6913275	Corynebacterium jeddahense	1414719	S	6	1	7	0.00003
ERR6913275	Corynebacterium massiliense	441501	S	5	0	5	0.00002
ERR6913275	Corynebacterium occultum	2675219	S	5	0	5	0.00002
ERR6913275	Corynebacterium glucuronolyticum	39791	S	5	0	5	0.00002
ERR6913275	Rhodococcus fascians	1828	S	6	8	14	0.00005
ERR6913275	Nocardia farcinica	37329	S	8	4	12	0.00004
ERR6913275	Lawsonella clevelandensis	1528099	S	28	1	29	0.00011
ERR6913275	Gordonia otitidis	249058	S	5	4	9	0.00003
ERR6913275	Bifidobacterium longum	216816	S	6	5	11	0.00004
ERR6913275	Lancefieldella parvula	1382	S	207	8	215	0.00081
ERR6913275	Olsenella sp. oral taxon 807	712411	S	7	1	8	0.00003
ERR6913275	Collinsella aerofaciens	74426	S	5	0	5	0.00002
ERR6913275	Microcoleus vaginatus	119532	S	9	0	9	0.00003
ERR6913275	Oscillatoria nigro-viridis	482564	S	10	3	13	0.00005
ERR6913275	Limnospira indica	147322	S	12	70	82	0.00031
ERR6913275	Chondrocystis sp. NIES-4102	2005460	S	10	6	16	0.00006
ERR6913275	Geminocystis sp. NIES-3708	1615909	S	7	3	10	0.00004
ERR6913275	Synechococcus sp. PCC 7502	1173263	S	11	4	15	0.00006
ERR6913275	Synechococcus sp. PCC 7336	195250	S	8	3	11	0.00004
ERR6913275	Chamaesiphon minutus	1173032	S	22	4	26	0.00010
ERR6913275	Prochlorococcus marinus	1219	S	5	7	12	0.00004
ERR6913275	Calothrix sp. PCC 6303	1170562	S	15	10	25	0.00009
ERR6913275	Calothrix sp. NIES-3974	2005462	S	10	2	12	0.00004
ERR6913275	Pseudanabaena sp. PCC 7367	82654	S	5	2	7	0.00003
ERR6913275	Chroococcidiopsis sp. CCMEE 29	155894	S	8	5	13	0.00005
ERR6913275	Gloeomargarita lithophora	1188228	S	7	0	7	0.00003
ERR6913275	Mycoplasmopsis bovis	28903	S	19	4	23	0.00009
ERR6913275	Prevotella histicola	470565	S	2088	744	2832	0.01060
ERR6913275	Prevotella melaninogenica	28132	S	1060	916	1976	0.00740
ERR6913275	Prevotella oris	28135	S	368	90	458	0.00171
ERR6913275	Prevotella jejuni	1177574	S	354	378	732	0.00274
ERR6913275	Prevotella veroralis	28137	S	341	199	540	0.00202
ERR6913275	Prevotella sp. oral taxon 475	712471	S	90	11	101	0.00038
ERR6913275	Prevotella sp. oral taxon 299	652716	S	35	8	43	0.00016
ERR6913275	Prevotella sp. Rep29	2691580	S	15	2	17	0.00006
ERR6913275	Prevotella sp. E13-17	2913616	S	8	6	14	0.00005
ERR6913275	Prevotella sp. E9-3	2913621	S	5	3	8	0.00003
ERR6913275	Prevotella denticola	28129	S	101	98	199	0.00075
ERR6913275	Prevotella nigrescens	28133	S	76	101	177	0.00066
ERR6913275	Prevotella intermedia	28131	S	67	58	125	0.00047
ERR6913275	Prevotella herbatica	2801997	S	63	1	64	0.00024
ERR6913275	Prevotella copri	165179	S	29	3	32	0.00012
ERR6913275	Prevotella corporis	28128	S	20	7	27	0.00010
ERR6913275	Prevotella scopos	589437	S	19	26	45	0.00017
ERR6913275	Prevotella fusca	589436	S	18	10	28	0.00010
ERR6913275	Prevotella bryantii	77095	S	16	0	16	0.00006
ERR6913275	Prevotella dentalis	52227	S	14	2	16	0.00006
ERR6913275	Prevotella ruminicola	839	S	10	0	10	0.00004
ERR6913275	Prevotella multiformis	282402	S	8	10	18	0.00007
ERR6913275	Pseudoprevotella muciniphila	2133944	S	71	1	72	0.00027
ERR6913275	Hoylesella enoeca	76123	S	36	19	55	0.00021
ERR6913275	Hoylesella buccalis	28127	S	19	8	27	0.00010
ERR6913275	Paraprevotella xylaniphila	454155	S	8	1	9	0.00003
ERR6913275	Porphyromonas sp. oral taxon 275	712435	S	860	45	905	0.00339
ERR6913275	Porphyromonas gingivalis	837	S	7	1	8	0.00003
ERR6913275	Porphyromonas endodontalis	28124	S	6	1	7	0.00003
ERR6913275	Tannerella serpentiformis	712710	S	126	11	137	0.00051
ERR6913275	Tannerella forsythia	28112	S	7	3	10	0.00004
ERR6913275	Bacteroides stercoris	46506	S	15	11	26	0.00010
ERR6913275	Bacteroides caccae	47678	S	11	13	24	0.00009
ERR6913275	Bacteroides heparinolyticus	28113	S	9	14	23	0.00009
ERR6913275	Bacteroides faecium	2715212	S	5	3	8	0.00003
ERR6913275	Phocaeicola salanitronis	376805	S	14	4	18	0.00007
ERR6913275	Phocaeicola dorei	357276	S	6	16	22	0.00008
ERR6913275	Odoribacter splanchnicus	28118	S	8	0	8	0.00003
ERR6913275	Coprobacter secundus	1501392	S	7	1	8	0.00003
ERR6913275	Chryseobacterium piperi	558152	S	41	14	55	0.00021
ERR6913275	Chryseobacterium camelliae	1265445	S	19	9	28	0.00010
ERR6913275	Chryseobacterium rhizoplanae	1609531	S	13	77	90	0.00034
ERR6913275	Chryseobacterium gambrini	373672	S	11	12	23	0.00009
ERR6913275	Chryseobacterium manosquense	2754694	S	7	32	39	0.00015
ERR6913275	Candidatus Kaistella beijingensis	2820270	S	10	25	35	0.00013
ERR6913275	Bergeyella cardium	1585976	S	86	43	129	0.00048
ERR6913275	Faecalibacter bovis	2898187	S	35	35	70	0.00026
ERR6913275	Riemerella anatipestifer	34085	S	29	15	44	0.00016
ERR6913275	Cloacibacterium caeni	2004710	S	5	48	53	0.00020
ERR6913275	Elizabethkingia sp. JS20170427COW	2583851	S	13	11	24	0.00009
ERR6913275	Capnocytophaga gingivalis	1017	S	98	31	129	0.00048
ERR6913275	Capnocytophaga sputigena	1019	S	27	30	57	0.00021
ERR6913275	Capnocytophaga sp. FDAARGOS_737	2545799	S	5	9	14	0.00005
ERR6913275	Capnocytophaga endodontalis	2708117	S	10	17	27	0.00010
ERR6913275	Capnocytophaga ochracea	1018	S	7	44	51	0.00019
ERR6913275	Capnocytophaga leadbetteri	327575	S	5	9	14	0.00005
ERR6913275	Flavobacterium sp. N2013	2986828	S	29	50	79	0.00030
ERR6913275	Flavobacterium psychrophilum	96345	S	5	5	10	0.00004
ERR6913275	Amniculibacterium sp. G2-70	2767188	S	22	42	64	0.00024
ERR6913275	Sinomicrobium kalidii	2900738	S	14	2	16	0.00006
ERR6913275	Blattabacterium cuenoti	1653831	S	18	3	21	0.00008
ERR6913275	Candidatus Karelsulcia muelleri	336810	S	7	1	8	0.00003
ERR6913275	Pelodictyon luteolum	1100	S	5	3	8	0.00003
ERR6913275	Haemophilus influenzae	727	S	854	293	1147	0.00429
ERR6913275	Haemophilus parahaemolyticus	735	S	396	19	415	0.00155
ERR6913275	Haemophilus parainfluenzae	729	S	104	8	112	0.00042
ERR6913275	Haemophilus haemolyticus	726	S	90	16	106	0.00040
ERR6913275	Haemophilus sp. oral taxon 036	712310	S	13	2	15	0.00006
ERR6913275	Haemophilus pittmaniae	249188	S	7	0	7	0.00003
ERR6913275	Aggregatibacter sp. 2125159857	2820817	S	18	12	30	0.00011
ERR6913275	Aggregatibacter actinomycetemcomitans	714	S	10	0	10	0.00004
ERR6913275	Aggregatibacter aphrophilus	732	S	6	1	7	0.00003
ERR6913275	Rodentibacter haemolyticus	2778911	S	10	0	10	0.00004
ERR6913275	Rodentibacter heylii	1906744	S	9	0	9	0.00003
ERR6913275	Pasteurella multocida	747	S	6	4	10	0.00004
ERR6913275	Histophilus somni	731	S	5	1	6	0.00002
ERR6913275	Acinetobacter sp. WCHA45	2004644	S	6	13	19	0.00007
ERR6913275	Acinetobacter variabilis	70346	S	33	23	56	0.00021
ERR6913275	Acinetobacter junii	40215	S	24	2	26	0.00010
ERR6913275	Acinetobacter johnsonii	40214	S	23	11	34	0.00013
ERR6913275	Acinetobacter seifertii	1530123	S	7	1	8	0.00003
ERR6913275	Acinetobacter baumannii	470	S	6	205	211	0.00079
ERR6913275	Acinetobacter lwoffii	28090	S	10	7	17	0.00006
ERR6913275	Acinetobacter ursingii	108980	S	6	4	10	0.00004
ERR6913275	Acinetobacter haemolyticus	29430	S	5	1	6	0.00002
ERR6913275	Moraxella osloensis	34062	S	59	4	63	0.00024
ERR6913275	Pseudomonas fluorescens	294	S	18	1	19	0.00007
ERR6913275	Pseudomonas putida	303	S	24	2	26	0.00010
ERR6913275	Pseudomonas aeruginosa	287	S	5	195	200	0.00075
ERR6913275	Pseudomonas wenzhouensis	2906062	S	5	0	5	0.00002
ERR6913275	Stutzerimonas stutzeri	316	S	20	5	25	0.00009
ERR6913275	Enterobacter roggenkampii	1812935	S	19	18	37	0.00014
ERR6913275	Escherichia coli	562	S	5	33	38	0.00014
ERR6913275	Salmonella enterica	28901	S	6	222	228	0.00085
ERR6913275	Serratia marcescens	615	S	6	2	8	0.00003
ERR6913275	Buchnera aphidicola	9	S	6	0	6	0.00002
ERR6913275	Xanthomonas campestris	339	S	82	24	106	0.00040
ERR6913275	Stenotrophomonas maltophilia	40324	S	13	6	19	0.00007
ERR6913275	Halomonas sp. JS92-SW72	2306583	S	31	4	35	0.00013
ERR6913275	Cardiobacterium hominis	2718	S	17	3	20	0.00007
ERR6913275	Cardiobacterium sp. Marseille-Q4385	2866573	S	6	1	7	0.00003
ERR6913275	Aeromonas salmonicida	645	S	11	5	16	0.00006
ERR6913275	Guyparkeria halophila	47960	S	5	0	5	0.00002
ERR6913275	Polaromonas naphthalenivorans	216465	S	29	38	67	0.00025
ERR6913275	Polaromonas sp. JS666	296591	S	6	11	17	0.00006
ERR6913275	Comamonas testosteroni	285	S	13	30	43	0.00016
ERR6913275	Comamonas thiooxydans	363952	S	7	14	21	0.00008
ERR6913275	Comamonas aquatica	225991	S	5	8	13	0.00005
ERR6913275	Acidovorax sp. KKS102	358220	S	6	12	18	0.00007
ERR6913275	Acidovorax temperans	80878	S	5	14	19	0.00007
ERR6913275	Acidovorax radicis	758826	S	5	5	10	0.00004
ERR6913275	Rhodoferax aquaticus	2527691	S	5	7	12	0.00004
ERR6913275	Ottowia sp. oral taxon 894	1658672	S	12	6	18	0.00007
ERR6913275	Limnohabitans sp. 63ED37-2	1678128	S	7	4	11	0.00004
ERR6913275	Limnohabitans sp. 103DPR2	1678129	S	5	1	6	0.00002
ERR6913275	Curvibacter sp. AEP1-3	1844971	S	10	4	14	0.00005
ERR6913275	Alicycliphilus denitrificans	179636	S	5	19	24	0.00009
ERR6913275	Simplicispira suum	2109915	S	5	5	10	0.00004
ERR6913275	Lautropia mirabilis	47671	S	68	23	91	0.00034
ERR6913275	Burkholderia cenocepacia	95486	S	14	49	63	0.00024
ERR6913275	Burkholderia multivorans	87883	S	11	6	17	0.00006
ERR6913275	Paraburkholderia aromaticivorans	2026199	S	6	2	8	0.00003
ERR6913275	Cupriavidus metallidurans	119219	S	5	3	8	0.00003
ERR6913275	Ralstonia mannitolilytica	105219	S	8	11	19	0.00007
ERR6913275	Collimonas fungivorans	158899	S	20	22	42	0.00016
ERR6913275	Collimonas arenae	279058	S	10	6	16	0.00006
ERR6913275	Collimonas pratensis	279113	S	9	9	18	0.00007
ERR6913275	Janthinobacterium sp. 1_2014MBL_MicDiv	1644131	S	5	22	27	0.00010
ERR6913275	Alcaligenes faecalis	511	S	12	10	22	0.00008
ERR6913275	Schlegelella aquatica	376175	S	8	9	17	0.00006
ERR6913275	Neisseria sicca	490	S	90	108	198	0.00074
ERR6913275	Neisseria mucosa	488	S	60	78	138	0.00052
ERR6913275	Neisseria macacae	496	S	37	62	99	0.00037
ERR6913275	Neisseria meningitidis	487	S	15	58	73	0.00027
ERR6913275	Neisseria sp. oral taxon 014	641148	S	12	4	16	0.00006
ERR6913275	Neisseria elongata	495	S	11	3	14	0.00005
ERR6913275	Neisseria subflava	28449	S	10	7	17	0.00006
ERR6913275	Neisseria bacilliformis	267212	S	8	2	10	0.00004
ERR6913275	Neisseria flavescens	484	S	7	5	12	0.00004
ERR6913275	Aquella oligotrophica	2067065	S	23	0	23	0.00009
ERR6913275	Morococcus cerebrosus	1056807	S	14	49	63	0.00024
ERR6913275	Kingella denitrificans	502	S	6	1	7	0.00003
ERR6913275	Kingella oralis	505	S	6	0	6	0.00002
ERR6913275	Paralysiella testudinis	2809020	S	9	3	12	0.00004
ERR6913275	Eikenella corrodens	539	S	5	1	6	0.00002
ERR6913275	Dechloromonas denitrificans	281362	S	7	4	11	0.00004
ERR6913275	Ferribacterium limneticum	76259	S	19	9	28	0.00010
ERR6913275	Quatrionicoccus australiensis	138118	S	5	4	9	0.00003
ERR6913275	Mesorhizobium terrae	2725666	S	48	71	119	0.00045
ERR6913275	Bradyrhizobium sp. SK17	2057741	S	26	34	60	0.00022
ERR6913275	Methylobacterium sp. FF17	2984843	S	16	9	25	0.00009
ERR6913275	Methylobacterium aquaticum	270351	S	7	11	18	0.00007
ERR6913275	Agrobacterium tumefaciens	358	S	7	7	14	0.00005
ERR6913275	Xanthobacter dioxanivorans	2528964	S	5	8	13	0.00005
ERR6913275	Sphingomonas sp. RMG20	2949093	S	5	10	15	0.00006
ERR6913275	Novosphingobium sp. 9	2025349	S	5	4	9	0.00003
ERR6913275	Sphingobium cloacae	120107	S	6	20	26	0.00010
ERR6913275	Brevundimonas sp. Bb-A	2560058	S	8	7	15	0.00006
ERR6913275	Brevundimonas diminuta	293	S	7	7	14	0.00005
ERR6913275	Brevundimonas naejangsanensis	588932	S	5	2	7	0.00003
ERR6913275	Hydrogenophilus thermoluteolus	297	S	32	0	32	0.00012
ERR6913275	Leptotrichia sp. oral taxon 212	712357	S	21	1	22	0.00008
ERR6913275	Leptotrichia sp. oral taxon 498	712368	S	9	1	10	0.00004
ERR6913275	Leptotrichia sp. oral taxon 221	712362	S	5	0	5	0.00002
ERR6913275	Leptotrichia wadei	157687	S	28	6	34	0.00013
ERR6913275	Leptotrichia shahii	157691	S	7	1	8	0.00003
ERR6913275	Fusobacterium nucleatum	851	S	26	37	63	0.00024
ERR6913275	Limnoglobus roseus	2598579	S	5	6	11	0.00004
ERR6913275	Campylobacter concisus	199	S	21	8	29	0.00011
ERR6913275	Treponema pedis	409322	S	5	9	14	0.00005
ERR6913275	Leptospira kobayashii	1917830	S	9	2	11	0.00004
ERR6913275	Candidatus Nanosynbacter sp. HMT-352	2899133	S	15	9	24	0.00009
ERR6913275	Labilithrix luteola	1391654	S	5	1	6	0.00002
ERR6913275	Fervidobacterium nodosum	2424	S	7	0	7	0.00003
ERR6913275	Phaeodactylum tricornutum	2850	S	211	12	223	0.00083
ERR6913275	Thalassiosira pseudonana	35128	S	180	18	198	0.00074
ERR6913275	Plasmodium malariae	5858	S	39	27	66	0.00025
ERR6913275	Babesia bovis	5865	S	18	4	22	0.00008
ERR6913275	Babesia microti	5868	S	14	4	18	0.00007
ERR6913275	Cryptosporidium parvum	5807	S	18	2	20	0.00007
ERR6913275	Bigelowiella natans	227086	S	7	5	12	0.00004
ERR6913275	Malassezia restricta	76775	S	136	6	142	0.00053
ERR6913275	Sporisorium graminicola	280036	S	5	0	5	0.00002
ERR6913275	Rhizoctonia solani	456999	S	26	2	28	0.00010
ERR6913275	Pichia kudriavzevii	4909	S	8	4	12	0.00004
ERR6913275	Ogataea parapolymorpha	1005962	S	6	5	11	0.00004
ERR6913275	Homo sapiens	9606	S	204	11	215	0.00081
ERR6913275	Guillardia theta	55529	S	8	4	12	0.00004
ERR6913275	Cryptomonas paramecium	2898	S	5	0	5	0.00002
ERR6913275	Dictyostelium discoideum	44689	S	6	0	6	0.00002
ERR6913275	Natronomonas moolapensis	416273	S	7	5	12	0.00004
ERR6913275	Streptococcus phage EJ-1	12402	S	111	1	112	0.00042
ERR6913275	Streptococcus phage PH10	644007	S	25	0	25	0.00009
ERR6913275	Streptococcus phage K13	1448274	S	21	7	28	0.00010
ERR6913275	Streptococcus phage SpSL1	1566990	S	17	0	17	0.00006
ERR6913275	Streptococcus phage phiARI0462	1701826	S	5	2	7	0.00003
ERR6913275	Cepunavirus Cp7	1982585	S	14	0	14	0.00005
ERR6913275	Cepunavirus Cp1	1982584	S	11	0	11	0.00004
ERR6913275	Severe acute respiratory syndrome-related coronavirus	694009	S	168	0	168	0.00063
ERR6913275	Human mastadenovirus C	129951	S	8	0	8	0.00003
ERR6913277	Streptococcus salivarius	1304	S	179248	165580	344828	0.27982
ERR6913277	Streptococcus sp. LPB0220	2610896	S	19906	10938	30844	0.02503
ERR6913277	Streptococcus sp. HSISM1	1316408	S	17554	9047	26601	0.02159
ERR6913277	Streptococcus sp. FDAARGOS_192	1839799	S	2367	5902	8269	0.00671
ERR6913277	Streptococcus sp. A12	1759399	S	1265	622	1887	0.00153
ERR6913277	Streptococcus sp. HSISS2	1316411	S	955	1238	2193	0.00178
ERR6913277	Streptococcus sp. oral taxon 061	712623	S	502	177	679	0.00055
ERR6913277	Streptococcus sp. HSISS3	1316412	S	486	613	1099	0.00089
ERR6913277	Streptococcus sp. oral taxon 431	712633	S	472	93	565	0.00046
ERR6913277	Streptococcus sp. 116-D4	2598453	S	468	206	674	0.00055
ERR6913277	Streptococcus sp. Marseille-Q6470	2972784	S	315	98	413	0.00034
ERR6913277	Streptococcus sp. HSISS1	1316410	S	271	11444	11715	0.00951
ERR6913277	Streptococcus sp. Marseille-Q3533	2759692	S	223	49	272	0.00022
ERR6913277	Streptococcus sp. NPS 308	1902136	S	148	98	246	0.00020
ERR6913277	Streptococcus sp. 1643	2576376	S	82	134	216	0.00018
ERR6913277	Streptococcus sp. oral taxon 064	712624	S	67	229	296	0.00024
ERR6913277	Streptococcus sp. NSJ-72	2763068	S	54	263	317	0.00026
ERR6913277	Streptococcus sp. FDAARGOS_522	2420310	S	30	2645	2675	0.00217
ERR6913277	Streptococcus sp. CNU G3	2698804	S	28	79	107	0.00009
ERR6913277	Streptococcus sp. zg-86	2664091	S	16	3	19	0.00002
ERR6913277	Streptococcus sp. KS 6	2598457	S	11	14	25	0.00002
ERR6913277	Streptococcus sp. HN38	3020829	S	7	14	21	0.00002
ERR6913277	Streptococcus sp. CNU G2	2686210	S	7	21	28	0.00002
ERR6913277	Streptococcus parasanguinis	1318	S	25916	12135	38051	0.03088
ERR6913277	Streptococcus oralis	1303	S	6674	4130	10804	0.00877
ERR6913277	Streptococcus thermophilus	1308	S	4620	62915	67535	0.05480
ERR6913277	Streptococcus lactarius	684066	S	3112	514	3626	0.00294
ERR6913277	Streptococcus mitis	28037	S	2664	2319	4983	0.00404
ERR6913277	Streptococcus gordonii	1302	S	1967	252	2219	0.00180
ERR6913277	Streptococcus cristatus	45634	S	1325	240	1565	0.00127
ERR6913277	Streptococcus suis	1307	S	1149	1819	2968	0.00241
ERR6913277	Streptococcus pneumoniae	1313	S	1148	33734	34882	0.02831
ERR6913277	Streptococcus australis	113107	S	1062	1272	2334	0.00189
ERR6913277	Streptococcus vestibularis	1343	S	1062	545	1607	0.00130
ERR6913277	Streptococcus sanguinis	1305	S	1053	136	1189	0.00096
ERR6913277	Streptococcus pyogenes	1314	S	657	1044	1701	0.00138
ERR6913277	Streptococcus ilei	1156431	S	643	814	1457	0.00118
ERR6913277	Streptococcus anginosus	1328	S	350	641	991	0.00080
ERR6913277	Streptococcus constellatus	76860	S	135	39090	39225	0.03183
ERR6913277	Streptococcus intermedius	1338	S	116	73	189	0.00015
ERR6913277	Streptococcus infantis	68892	S	575	158	733	0.00059
ERR6913277	Streptococcus agalactiae	1311	S	439	64873	65312	0.05300
ERR6913277	Streptococcus rubneri	1234680	S	328	320	648	0.00053
ERR6913277	Streptococcus koreensis	2382163	S	316	481	797	0.00065
ERR6913277	Streptococcus oriscaviae	2781599	S	291	16	307	0.00025
ERR6913277	Streptococcus equi	1336	S	260	20	280	0.00023
ERR6913277	Streptococcus dysgalactiae	1334	S	20	11	31	0.00003
ERR6913277	Streptococcus sobrinus	1310	S	256	9	265	0.00022
ERR6913277	Streptococcus gwangjuense	1433513	S	203	172	375	0.00030
ERR6913277	Streptococcus ferus	1345	S	200	8	208	0.00017
ERR6913277	Streptococcus mutans	1309	S	185	74	259	0.00021
ERR6913277	Streptococcus pseudopneumoniae	257758	S	169	134	303	0.00025
ERR6913277	Streptococcus toyakuensis	2819619	S	151	163	314	0.00025
ERR6913277	Streptococcus pantholopis	1811193	S	95	2	97	0.00008
ERR6913277	Streptococcus canis	1329	S	94	17	111	0.00009
ERR6913277	Streptococcus ratti	1341	S	86	2	88	0.00007
ERR6913277	Streptococcus iniae	1346	S	83	5	88	0.00007
ERR6913277	Streptococcus equinus	1335	S	81	29	110	0.00009
ERR6913277	Streptococcus pluranimalium	82348	S	81	8	89	0.00007
ERR6913277	Streptococcus milleri	33040	S	79	252	331	0.00027
ERR6913277	Streptococcus pseudoporcinus	361101	S	76	17	93	0.00008
ERR6913277	Streptococcus troglodytae	1111760	S	66	18	84	0.00007
ERR6913277	Streptococcus chenjunshii	2173853	S	64	1	65	0.00005
ERR6913277	Streptococcus halotolerans	1814128	S	58	2	60	0.00005
ERR6913277	Streptococcus pasteurianus	197614	S	56	337	393	0.00032
ERR6913277	Streptococcus alactolyticus	29389	S	50	12	62	0.00005
ERR6913277	Streptococcus acidominimus	1326	S	48	5	53	0.00004
ERR6913277	Streptococcus uberis	1349	S	46	3	49	0.00004
ERR6913277	Streptococcus merionis	400065	S	39	0	39	0.00003
ERR6913277	Streptococcus parasuis	1501662	S	34	42	76	0.00006
ERR6913277	Streptococcus porcinus	1340	S	34	3	37	0.00003
ERR6913277	Streptococcus respiraculi	2021971	S	32	2	34	0.00003
ERR6913277	Streptococcus halichoeri	254785	S	27	2	29	0.00002
ERR6913277	Streptococcus himalayensis	1888195	S	27	2	29	0.00002
ERR6913277	Streptococcus lutetiensis	150055	S	25	22	47	0.00004
ERR6913277	Streptococcus parauberis	1348	S	24	6	30	0.00002
ERR6913277	Streptococcus urinalis	149016	S	24	3	27	0.00002
ERR6913277	Streptococcus marmotae	1825069	S	12	2	14	0.00001
ERR6913277	Streptococcus gallolyticus	315405	S	10	14	24	0.00002
ERR6913277	Streptococcus periodonticum	2490633	S	10	19	29	0.00002
ERR6913277	Streptococcus infantarius	102684	S	10	14	24	0.00002
ERR6913277	Streptococcus ruminantium	1917441	S	7	13	20	0.00002
ERR6913277	Streptococcus macedonicus	59310	S	5	30	35	0.00003
ERR6913277	Lactococcus lactis	1358	S	35	22	57	0.00005
ERR6913277	Lactococcus cremoris	1359	S	19	202	221	0.00018
ERR6913277	Lactococcus garvieae	1363	S	13	3	16	0.00001
ERR6913277	Lactococcus raffinolactis	1366	S	9	1	10	0.00001
ERR6913277	Lactococcus paracarnosus	2749962	S	7	57	64	0.00005
ERR6913277	Floricoccus penangensis	1859475	S	10	0	10	0.00001
ERR6913277	Lactobacillus crispatus	47770	S	57	19	76	0.00006
ERR6913277	Lactobacillus sp. IBH004	2879107	S	16	14	30	0.00002
ERR6913277	Lactobacillus iners	147802	S	21	1	22	0.00002
ERR6913277	Lactobacillus delbrueckii	1584	S	17	8	25	0.00002
ERR6913277	Lactobacillus acetotolerans	1600	S	15	1	16	0.00001
ERR6913277	Lactobacillus acidophilus	1579	S	12	195	207	0.00017
ERR6913277	Lactobacillus gasseri	1596	S	11	22	33	0.00003
ERR6913277	Lactobacillus jensenii	109790	S	10	26	36	0.00003
ERR6913277	Lactobacillus amylovorus	1604	S	6	9	15	0.00001
ERR6913277	Lactobacillus helveticus	1587	S	5	1	6	0.00000
ERR6913277	Lactiplantibacillus plantarum	1590	S	82	25	107	0.00009
ERR6913277	Lactiplantibacillus paraplantarum	60520	S	5	0	5	0.00000
ERR6913277	Limosilactobacillus fermentum	1613	S	23	4	27	0.00002
ERR6913277	Limosilactobacillus reuteri	1598	S	19	5	24	0.00002
ERR6913277	Ligilactobacillus salivarius	1624	S	24	56	80	0.00006
ERR6913277	Ligilactobacillus ruminis	1623	S	11	0	11	0.00001
ERR6913277	Ligilactobacillus acidipiscis	89059	S	8	1	9	0.00001
ERR6913277	Weissella cibaria	137591	S	7	2	9	0.00001
ERR6913277	Weissella hellenica	46256	S	5	2	7	0.00001
ERR6913277	Weissella jogaejeotgali	1631871	S	5	3	8	0.00001
ERR6913277	Oenococcus oeni	1247	S	25	3	28	0.00002
ERR6913277	Latilactobacillus curvatus	28038	S	15	2	17	0.00001
ERR6913277	Latilactobacillus sakei	1599	S	11	1	12	0.00001
ERR6913277	Lacticaseibacillus paracasei	1597	S	8	8	16	0.00001
ERR6913277	Lacticaseibacillus rhamnosus	47715	S	8	0	8	0.00001
ERR6913277	Lacticaseibacillus zeae	57037	S	6	0	6	0.00000
ERR6913277	Leuconostoc mesenteroides	1245	S	6	14	20	0.00002
ERR6913277	Pediococcus acidilactici	1254	S	7	0	7	0.00001
ERR6913277	Pediococcus damnosus	51663	S	6	1	7	0.00001
ERR6913277	Lentilactobacillus buchneri	1581	S	7	0	7	0.00001
ERR6913277	Periweissella cryptocerci	2506420	S	7	0	7	0.00001
ERR6913277	Furfurilactobacillus rossiae	231049	S	6	0	6	0.00000
ERR6913277	Granulicatella adiacens	46124	S	674	132	806	0.00065
ERR6913277	Granulicatella elegans	137732	S	47	17	64	0.00005
ERR6913277	Dolosigranulum pigrum	29394	S	33	1	34	0.00003
ERR6913277	Abiotrophia defectiva	46125	S	239	20	259	0.00021
ERR6913277	Aerococcus urinaeequi	51665	S	11	2	13	0.00001
ERR6913277	Aerococcus viridans	1377	S	5	2	7	0.00001
ERR6913277	Suicoccus acidiformans	2036206	S	12	0	12	0.00001
ERR6913277	Enterococcus faecium	1352	S	73	128	201	0.00016
ERR6913277	Enterococcus faecalis	1351	S	26	856	882	0.00072
ERR6913277	Enterococcus hirae	1354	S	9	0	9	0.00001
ERR6913277	Enterococcus cecorum	44008	S	8	0	8	0.00001
ERR6913277	Enterococcus gallinarum	1353	S	7	5	12	0.00001
ERR6913277	Enterococcus wangshanyuanii	2005703	S	6	0	6	0.00000
ERR6913277	Enterococcus gilvus	160453	S	5	0	5	0.00000
ERR6913277	Tetragenococcus halophilus	51669	S	5	5	10	0.00001
ERR6913277	Vagococcus fluvialis	2738	S	5	1	6	0.00000
ERR6913277	Gemella haemolysans	1379	S	1943	1612	3555	0.00288
ERR6913277	Gemella morbillorum	29391	S	199	284	483	0.00039
ERR6913277	Gemella sanguinis	84135	S	85	105	190	0.00015
ERR6913277	Gemella sp. zg-570	2840371	S	10	9	19	0.00002
ERR6913277	Exiguobacterium sp. N4-1P	2051906	S	7	4	11	0.00001
ERR6913277	Exiguobacterium mexicanum	340146	S	8	7	15	0.00001
ERR6913277	Exiguobacterium aurantiacum	33987	S	5	4	9	0.00001
ERR6913277	Staphylococcus epidermidis	1282	S	1059	54	1113	0.00090
ERR6913277	Staphylococcus capitis	29388	S	647	49	696	0.00056
ERR6913277	Staphylococcus aureus	1280	S	188	207	395	0.00032
ERR6913277	Staphylococcus pseudintermedius	283734	S	39	3	42	0.00003
ERR6913277	Staphylococcus hominis	1290	S	24	1	25	0.00002
ERR6913277	Staphylococcus lugdunensis	28035	S	18	4	22	0.00002
ERR6913277	Staphylococcus carnosus	1281	S	14	0	14	0.00001
ERR6913277	Staphylococcus auricularis	29379	S	13	0	13	0.00001
ERR6913277	Staphylococcus warneri	1292	S	8	1	9	0.00001
ERR6913277	Staphylococcus haemolyticus	1283	S	7	3	10	0.00001
ERR6913277	Staphylococcus saprophyticus	29385	S	7	0	7	0.00001
ERR6913277	Staphylococcus xylosus	1288	S	6	0	6	0.00000
ERR6913277	Staphylococcus nepalensis	214473	S	6	0	6	0.00000
ERR6913277	Macrococcus armenti	2875764	S	6	4	10	0.00001
ERR6913277	Mammaliicoccus sciuri	1296	S	8	0	8	0.00001
ERR6913277	Bacillus atrophaeus	1452	S	1271	442	1713	0.00139
ERR6913277	Bacillus velezensis	492670	S	60	91	151	0.00012
ERR6913277	Bacillus amyloliquefaciens	1390	S	16	24	40	0.00003
ERR6913277	Bacillus subtilis	1423	S	39	336	375	0.00030
ERR6913277	Bacillus halotolerans	260554	S	8	1	9	0.00001
ERR6913277	Bacillus licheniformis	1402	S	8	5	13	0.00001
ERR6913277	Bacillus spizizenii	96241	S	5	0	5	0.00000
ERR6913277	Bacillus anthracis	1392	S	89	946	1035	0.00084
ERR6913277	Bacillus cereus	1396	S	40	2646	2686	0.00218
ERR6913277	Bacillus thuringiensis	1428	S	17	3	20	0.00002
ERR6913277	Bacillus mycoides	1405	S	12	1	13	0.00001
ERR6913277	Bacillus paranthracis	2026186	S	7	12	19	0.00002
ERR6913277	Bacillus sp. Y1	352858	S	7	1	8	0.00001
ERR6913277	Bacillus sp. Lzh-5	2049935	S	5	296	301	0.00024
ERR6913277	Bacillus altitudinis	293387	S	11	2	13	0.00001
ERR6913277	Bacillus pumilus	1408	S	9	0	9	0.00001
ERR6913277	Bacillus shivajii	1983719	S	8	0	8	0.00001
ERR6913277	Bacillus badius	1455	S	5	0	5	0.00000
ERR6913277	Priestia megaterium	1404	S	24	2	26	0.00002
ERR6913277	Priestia aryabhattai	412384	S	19	10	29	0.00002
ERR6913277	Anoxybacillus flavithermus	33934	S	15	12	27	0.00002
ERR6913277	Niallia circulans	1397	S	13	0	13	0.00001
ERR6913277	Niallia sp. RD1	2962858	S	7	0	7	0.00001
ERR6913277	Niallia sp. Man26	2912824	S	5	0	5	0.00000
ERR6913277	Lysinibacillus timonensis	2086577	S	7	0	7	0.00001
ERR6913277	Lysinibacillus sphaericus	1421	S	6	12	18	0.00001
ERR6913277	Peribacillus frigoritolerans	450367	S	8	2	10	0.00001
ERR6913277	Peribacillus asahii	228899	S	7	0	7	0.00001
ERR6913277	Weizmannia coagulans	1398	S	15	4	19	0.00002
ERR6913277	Fictibacillus sp. KU28468	2991053	S	7	0	7	0.00001
ERR6913277	Fictibacillus phosphorivorans	1221500	S	5	0	5	0.00000
ERR6913277	Mesobacillus foraminis	279826	S	10	1	11	0.00001
ERR6913277	Paenalkalicoccus suaedae	2592382	S	10	0	10	0.00001
ERR6913277	Radiobacillus deserti	2594883	S	5	0	5	0.00000
ERR6913277	Radiobacillus kanasensis	2844358	S	5	0	5	0.00000
ERR6913277	Psychrobacillus glaciei	2283160	S	5	0	5	0.00000
ERR6913277	Paenibacillus polymyxa	1406	S	74	34	108	0.00009
ERR6913277	Paenibacillus sp. URB8-2	2741301	S	7	1	8	0.00001
ERR6913277	Paenibacillus mucilaginosus	61624	S	11	0	11	0.00001
ERR6913277	Paenibacillus naphthalenovorans	162209	S	9	0	9	0.00001
ERR6913277	Paenibacillus crassostreae	1763538	S	7	0	7	0.00001
ERR6913277	Paenibacillus physcomitrellae	1619311	S	6	0	6	0.00000
ERR6913277	Paenibacillus xylanilyticus	248903	S	5	0	5	0.00000
ERR6913277	Brevibacillus brevis	1393	S	5	2	7	0.00001
ERR6913277	Cohnella abietis	2507935	S	7	2	9	0.00001
ERR6913277	Listeria monocytogenes	1639	S	43	92	135	0.00011
ERR6913277	Brochothrix thermosphacta	2756	S	12	0	12	0.00001
ERR6913277	Sporosarcina sp. Marseille-Q4943	2942204	S	10	2	12	0.00001
ERR6913277	Sporosarcina ureae	1571	S	5	1	6	0.00000
ERR6913277	Planococcus sp. 107-1	2908840	S	5	4	9	0.00001
ERR6913277	Veillonella atypica	39777	S	123518	31954	155472	0.12616
ERR6913277	Veillonella parvula	29466	S	6113	96679	102792	0.08341
ERR6913277	Veillonella nakazawae	2682456	S	2939	11236	14175	0.01150
ERR6913277	Veillonella rogosae	423477	S	2874	2377	5251	0.00426
ERR6913277	Veillonella sp. S12025-13	2682455	S	1866	6431	8297	0.00673
ERR6913277	Veillonella dispar	39778	S	1425	2535	3960	0.00321
ERR6913277	Veillonella rodentium	248315	S	827	130	957	0.00078
ERR6913277	Megasphaera stantonii	2144175	S	1345	563	1908	0.00155
ERR6913277	Megasphaera hexanoica	1675036	S	412	379	791	0.00064
ERR6913277	Megasphaera elsdenii	907	S	150	375	525	0.00043
ERR6913277	Megasphaera massiliensis	1232428	S	36	20	56	0.00005
ERR6913277	Dialister pneumosintes	39950	S	177	61	238	0.00019
ERR6913277	Dialister succinatiphilus	487173	S	103	69	172	0.00014
ERR6913277	Selenomonas sputigena	69823	S	1001	75	1076	0.00087
ERR6913277	Selenomonas sp. oral taxon 920	1884263	S	73	30	103	0.00008
ERR6913277	Selenomonas sp. oral taxon 126	712528	S	70	44	114	0.00009
ERR6913277	Selenomonas sp. oral taxon 136	713030	S	50	54	104	0.00008
ERR6913277	Selenomonas sp. oral taxon 478	712538	S	45	55	100	0.00008
ERR6913277	Selenomonas timonae	2754044	S	44	48	92	0.00007
ERR6913277	Selenomonas ruminantium	971	S	14	0	14	0.00001
ERR6913277	Megamonas hypermegale	158847	S	8	7	15	0.00001
ERR6913277	Megamonas funiformis	437897	S	8	5	13	0.00001
ERR6913277	Pectinatus frisingensis	865	S	14	1	15	0.00001
ERR6913277	Pelosinus sp. UFO1	484770	S	11	18	29	0.00002
ERR6913277	Sporomusa termitida	2377	S	9	13	22	0.00002
ERR6913277	Acidaminococcus intestini	187327	S	42	11	53	0.00004
ERR6913277	Phascolarctobacterium faecium	33025	S	16	2	18	0.00001
ERR6913277	Clostridium tyrobutyricum	1519	S	65	2	67	0.00005
ERR6913277	Clostridium sp. MD294	97138	S	15	0	15	0.00001
ERR6913277	Clostridium sp. BJN0001	2930219	S	8	1	9	0.00001
ERR6913277	Clostridium sp. M62/1	411486	S	6	1	7	0.00001
ERR6913277	Clostridium sp. 'deep sea'	2779445	S	5	0	5	0.00000
ERR6913277	Clostridium botulinum	1491	S	39	59	98	0.00008
ERR6913277	Clostridium perfringens	1502	S	27	67	94	0.00008
ERR6913277	Clostridium beijerinckii	1520	S	25	19	44	0.00004
ERR6913277	Clostridium gelidum	704125	S	15	1	16	0.00001
ERR6913277	Clostridium tetani	1513	S	14	1	15	0.00001
ERR6913277	Clostridium pasteurianum	1501	S	13	0	13	0.00001
ERR6913277	Clostridium isatidis	182773	S	11	2	13	0.00001
ERR6913277	Clostridium chauvoei	46867	S	10	1	11	0.00001
ERR6913277	Clostridium cadaveris	1529	S	8	0	8	0.00001
ERR6913277	Clostridium acetobutylicum	1488	S	6	0	6	0.00000
ERR6913277	Clostridium gasigenes	94869	S	5	0	5	0.00000
ERR6913277	Clostridium argentinense	29341	S	5	0	5	0.00000
ERR6913277	Caloramator sp. Dgby_cultured_2	3029174	S	110	24	134	0.00011
ERR6913277	Sarcina sp. JB2	2726954	S	9	4	13	0.00001
ERR6913277	Hungatella hathewayi	154046	S	6	0	6	0.00000
ERR6913277	Blautia wexlerae	418240	S	14	7	21	0.00002
ERR6913277	Blautia pseudococcoides	1796616	S	12	4	16	0.00001
ERR6913277	Blautia liquoris	2779518	S	10	0	10	0.00001
ERR6913277	Blautia hansenii	1322	S	8	2	10	0.00001
ERR6913277	Blautia producta	33035	S	6	2	8	0.00001
ERR6913277	Blautia obeum	40520	S	5	2	7	0.00001
ERR6913277	Blautia argi	1912897	S	5	1	6	0.00000
ERR6913277	Lachnoanaerobaculum umeaense	617123	S	55	1	56	0.00005
ERR6913277	Butyrivibrio proteoclasticus	43305	S	17	8	25	0.00002
ERR6913277	Butyrivibrio hungatei	185008	S	11	6	17	0.00001
ERR6913277	Butyrivibrio fibrisolvens	831	S	9	2	11	0.00001
ERR6913277	Roseburia hominis	301301	S	8	1	9	0.00001
ERR6913277	Roseburia intestinalis	166486	S	7	441	448	0.00036
ERR6913277	Anaerostipes hadrus	649756	S	18	3	21	0.00002
ERR6913277	[Clostridium] scindens	29347	S	9	5	14	0.00001
ERR6913277	Lachnoclostridium phytofermentans	66219	S	8	0	8	0.00001
ERR6913277	Anaerobutyricum hallii	39488	S	17	1	18	0.00001
ERR6913277	[Ruminococcus] torques	33039	S	8	1	9	0.00001
ERR6913277	Anaeropeptidivorans aminofermentans	2934315	S	14	0	14	0.00001
ERR6913277	Enterocloster bolteae	208479	S	7	0	7	0.00001
ERR6913277	Dorea formicigenerans	39486	S	7	2	9	0.00001
ERR6913277	Dorea longicatena	88431	S	6	1	7	0.00001
ERR6913277	Marvinbryantia formatexigens	168384	S	14	0	14	0.00001
ERR6913277	[Clostridium] colinum	36835	S	14	0	14	0.00001
ERR6913277	Sellimonas intestinalis	1653434	S	14	1	15	0.00001
ERR6913277	Anaerocolumna chitinilytica	1727145	S	6	2	8	0.00001
ERR6913277	Pseudobutyrivibrio xylanivorans	185007	S	11	0	11	0.00001
ERR6913277	Wansuia hejianensis	2763667	S	9	0	9	0.00001
ERR6913277	Lachnospira eligens	39485	S	8	0	8	0.00001
ERR6913277	Novisyntrophococcus fermenticellae	2068655	S	7	0	7	0.00001
ERR6913277	Herbinix luporum	1679721	S	6	0	6	0.00000
ERR6913277	Faecalicatena sp. Marseille-Q4148	2823316	S	5	0	5	0.00000
ERR6913277	Faecalibacterium prausnitzii	853	S	13	20	33	0.00003
ERR6913277	Faecalibacterium sp. HTF-F	2929491	S	9	7	16	0.00001
ERR6913277	Fastidiosipila sanguinis	236753	S	35	6	41	0.00003
ERR6913277	Solibaculum mannosilyticum	2780922	S	24	17	41	0.00003
ERR6913277	Mageeibacillus indolicus	884684	S	15	1	16	0.00001
ERR6913277	Ruminococcus bovis	2564099	S	6	0	6	0.00000
ERR6913277	Caproicibacterium amylolyticum	2766537	S	6	0	6	0.00000
ERR6913277	Dysosmobacter sp. Marseille-Q4140	2830675	S	7	1	8	0.00001
ERR6913277	Ruminiclostridium cellulolyticum	1521	S	6	0	6	0.00000
ERR6913277	Acetivibrio thermocellus	1515	S	5	0	5	0.00000
ERR6913277	Flavonifractor plautii	292800	S	7	1	8	0.00001
ERR6913277	Oscillibacter hominis	2763056	S	7	1	8	0.00001
ERR6913277	Ruthenibacterium lactatiformans	1550024	S	6	1	7	0.00001
ERR6913277	Thermoclostridium stercorarium	1510	S	6	1	7	0.00001
ERR6913277	Monoglobus pectinilyticus	1981510	S	5	0	5	0.00000
ERR6913277	Pseudoclostridium thermosuccinogenes	84032	S	5	0	5	0.00000
ERR6913277	Filifactor alocis	143361	S	110	25	135	0.00011
ERR6913277	Clostridioides difficile	1496	S	17	2354	2371	0.00192
ERR6913277	Peptostreptococcus sp. CBA3647	3003601	S	20	0	20	0.00002
ERR6913277	Romboutsia ilealis	1115758	S	10	2	12	0.00001
ERR6913277	Tepidibacter sp. 8C15b	2925782	S	12	0	12	0.00001
ERR6913277	Acetoanaerobium sticklandii	1511	S	7	0	7	0.00001
ERR6913277	Paeniclostridium sordellii	1505	S	5	0	5	0.00000
ERR6913277	Mogibacterium pumilum	86332	S	29	8	37	0.00003
ERR6913277	Mogibacterium diversum	114527	S	12	3	15	0.00001
ERR6913277	Aminipila terrae	2697030	S	9	3	12	0.00001
ERR6913277	Emergencia timonensis	1776384	S	8	1	9	0.00001
ERR6913277	Flintibacter sp. KGMB00164	2610895	S	9	0	9	0.00001
ERR6913277	Eubacterium ventriosum	39496	S	9	4	13	0.00001
ERR6913277	Alkalibacter rhizosphaerae	2815577	S	5	0	5	0.00000
ERR6913277	Desulfosporosinus meridiei	79209	S	10	3	13	0.00001
ERR6913277	Desulfosporosinus youngiae	339862	S	6	1	7	0.00001
ERR6913277	Desulforamulus ferrireducens	1833852	S	10	4	14	0.00001
ERR6913277	Christensenella sp. Marseille-P3954	2086585	S	17	1	18	0.00001
ERR6913277	Petrocella atlantisensis	2173034	S	7	0	7	0.00001
ERR6913277	Symbiobacterium thermophilum	2734	S	6	0	6	0.00000
ERR6913277	Caldanaerobacter subterraneus	911092	S	18	1	19	0.00002
ERR6913277	Thermacetogenium phaeum	85874	S	6	0	6	0.00000
ERR6913277	Thermoanaerobacterium thermosaccharolyticum	1517	S	8	1	9	0.00001
ERR6913277	Mahella australiensis	252966	S	5	0	5	0.00000
ERR6913277	Finegoldia magna	1260	S	194	45	239	0.00019
ERR6913277	Parvimonas micra	33033	S	163	39	202	0.00016
ERR6913277	Anaerococcus prevotii	33034	S	63	15	78	0.00006
ERR6913277	Anaerococcus mediterraneensis	1870984	S	11	3	14	0.00001
ERR6913277	Anaerococcus vaginalis	33037	S	8	21	29	0.00002
ERR6913277	Peptoniphilus harei	54005	S	16	11	27	0.00002
ERR6913277	Peptoniphilus sp. SAHP1	2948573	S	10	9	19	0.00002
ERR6913277	Murdochiella vaginalis	1852373	S	6	1	7	0.00001
ERR6913277	Gottschalkia acidurici	1556	S	17	0	17	0.00001
ERR6913277	Gudongella oleilytica	1582259	S	7	0	7	0.00001
ERR6913277	Ezakiella coagulans	46507	S	11	5	16	0.00001
ERR6913277	Sedimentibacter sp. zth1	2816908	S	8	0	8	0.00001
ERR6913277	Bulleidia sp. zg-1006	2806552	S	65	7	72	0.00006
ERR6913277	Erysipelothrix larvae	1514105	S	16	3	19	0.00002
ERR6913277	[Clostridium] innocuum	1522	S	5	6	11	0.00001
ERR6913277	Ndongobacter massiliensis	1871025	S	6	1	7	0.00001
ERR6913277	Cutibacterium acnes	1747	S	19252	921	20173	0.01637
ERR6913277	Cutibacterium granulosum	33011	S	673	19	692	0.00056
ERR6913277	Cutibacterium avidum	33010	S	50	2	52	0.00004
ERR6913277	Cutibacterium modestum	2559073	S	48	1	49	0.00004
ERR6913277	Arachnia propionica	1750	S	104	3	107	0.00009
ERR6913277	Tessaracoccus timonensis	2161816	S	15	0	15	0.00001
ERR6913277	Tessaracoccus flavescens	399497	S	8	3	11	0.00001
ERR6913277	Tessaracoccus aquimaris	1332264	S	8	1	9	0.00001
ERR6913277	Tessaracoccus sp. MC1865	2760310	S	5	0	5	0.00000
ERR6913277	Propioniciclava sp. MC1595	2760308	S	5	0	5	0.00000
ERR6913277	Vaginimicrobium propionicum	1871034	S	6	0	6	0.00000
ERR6913277	Nocardioides sp. JQ2195	2592334	S	9	3	12	0.00001
ERR6913277	Nocardioides sp. S5	2017486	S	8	10	18	0.00001
ERR6913277	Nocardioides sp. zg-536	2803858	S	6	5	11	0.00001
ERR6913277	Nocardioides sp. B-3	2895565	S	5	3	8	0.00001
ERR6913277	Nocardioides panacis	2849501	S	10	5	15	0.00001
ERR6913277	Nocardioides baekrokdamisoli	1804624	S	6	1	7	0.00001
ERR6913277	Aeromicrobium sp. HA	3009077	S	5	7	12	0.00001
ERR6913277	Aeromicrobium marinum	219314	S	9	3	12	0.00001
ERR6913277	Pimelobacter simplex	2045	S	8	5	13	0.00001
ERR6913277	Mumia sp. ZJ1417	2708082	S	6	0	6	0.00000
ERR6913277	Micropruina glycogenica	75385	S	5	0	5	0.00000
ERR6913277	Bifidobacterium longum	216816	S	8907	4051	12958	0.01052
ERR6913277	Bifidobacterium breve	1685	S	583	135	718	0.00058
ERR6913277	Bifidobacterium dentium	1689	S	271	4	275	0.00022
ERR6913277	Bifidobacterium scardovii	158787	S	63	1	64	0.00005
ERR6913277	Bifidobacterium actinocoloniiforme	638619	S	25	0	25	0.00002
ERR6913277	Bifidobacterium imperatoris	2020965	S	21	2	23	0.00002
ERR6913277	Bifidobacterium pseudocatenulatum	28026	S	20	1	21	0.00002
ERR6913277	Bifidobacterium adolescentis	1680	S	19	4	23	0.00002
ERR6913277	Bifidobacterium lemurum	1603886	S	16	0	16	0.00001
ERR6913277	Bifidobacterium catenulatum	1686	S	14	1	15	0.00001
ERR6913277	Bifidobacterium eulemuris	1765219	S	13	0	13	0.00001
ERR6913277	Bifidobacterium subtile	77635	S	13	0	13	0.00001
ERR6913277	Bifidobacterium angulatum	1683	S	12	0	12	0.00001
ERR6913277	Bifidobacterium animalis	28025	S	12	158	170	0.00014
ERR6913277	Bifidobacterium bifidum	1681	S	10	9	19	0.00002
ERR6913277	Bifidobacterium asteroides	1684	S	9	0	9	0.00001
ERR6913277	Bifidobacterium saguini	762210	S	9	0	9	0.00001
ERR6913277	Bifidobacterium pseudolongum	1694	S	8	0	8	0.00001
ERR6913277	Bifidobacterium pullorum	78448	S	7	0	7	0.00001
ERR6913277	Bifidobacterium thermophilum	33905	S	6	0	6	0.00000
ERR6913277	Bifidobacterium choerinum	35760	S	6	0	6	0.00000
ERR6913277	Gardnerella vaginalis	2702	S	47	24	71	0.00006
ERR6913277	Gardnerella piotii	2792977	S	6	1	7	0.00001
ERR6913277	Scardovia inopinata	78259	S	27	0	27	0.00002
ERR6913277	Parascardovia denticolens	78258	S	14	0	14	0.00001
ERR6913277	Rothia mucilaginosa	43675	S	2557	102	2659	0.00216
ERR6913277	Rothia aeria	172042	S	898	111	1009	0.00082
ERR6913277	Rothia dentocariosa	2047	S	543	85	628	0.00051
ERR6913277	Rothia nasimurium	85336	S	5	0	5	0.00000
ERR6913277	Rothia amarae	169480	S	5	0	5	0.00000
ERR6913277	Micrococcus luteus	1270	S	287	465	752	0.00061
ERR6913277	Micrococcus sp. KD337-16	2856555	S	36	9	45	0.00004
ERR6913277	Micrococcus sp. SL257	2995171	S	7	112	119	0.00010
ERR6913277	Micrococcus sp. KBS0714	1179670	S	5	40	45	0.00004
ERR6913277	Micrococcus yunnanensis	566027	S	10	84	94	0.00008
ERR6913277	Kocuria rhizophila	72000	S	556	131	687	0.00056
ERR6913277	Kocuria palustris	71999	S	74	6	80	0.00006
ERR6913277	Kocuria sp. BT304	1702043	S	8	5	13	0.00001
ERR6913277	Kocuria varians	1272	S	7	0	7	0.00001
ERR6913277	Kocuria flava	446860	S	7	0	7	0.00001
ERR6913277	Kocuria rosea	1275	S	5	0	5	0.00000
ERR6913277	Kocuria indica	1049583	S	5	1	6	0.00000
ERR6913277	Arthrobacter sp. MMS18-M83	2996261	S	5	3	8	0.00001
ERR6913277	Arthrobacter sp. StoSoilB5	2830992	S	5	6	11	0.00001
ERR6913277	Arthrobacter agilis	37921	S	12	6	18	0.00001
ERR6913277	Arthrobacter polaris	2813727	S	10	5	15	0.00001
ERR6913277	Renibacterium salmoninarum	1646	S	39	0	39	0.00003
ERR6913277	Citricoccus sp. SGAir0253	2567881	S	27	4	31	0.00003
ERR6913277	Auritidibacter sp. NML130574	2170745	S	33	0	33	0.00003
ERR6913277	Glutamicibacter protophormiae	37930	S	7	3	10	0.00001
ERR6913277	Glutamicibacter creatinolyticus	162496	S	5	0	5	0.00000
ERR6913277	Psychromicrobium lacuslunae	1618207	S	9	0	9	0.00001
ERR6913277	Microbacterium sp. PM5	2014534	S	12	2	14	0.00001
ERR6913277	Microbacterium sp. Nx66	2766784	S	10	9	19	0.00002
ERR6913277	Microbacterium sp. Y-01	2048898	S	9	4	13	0.00001
ERR6913277	Microbacterium sp. 10M-3C3	2483401	S	6	2	8	0.00001
ERR6913277	Microbacterium sp. A18JL241	2782166	S	6	1	7	0.00001
ERR6913277	Microbacterium sp. SSW1-51	2851650	S	6	2	8	0.00001
ERR6913277	Microbacterium sp. TPU 3598	1938334	S	6	2	8	0.00001
ERR6913277	Microbacterium sp. 1S1	2606451	S	5	3	8	0.00001
ERR6913277	Microbacterium sp. No. 7	1714373	S	5	1	6	0.00000
ERR6913277	Microbacterium aurum	36805	S	51	15	66	0.00005
ERR6913277	Microbacterium oxydans	82380	S	27	18	45	0.00004
ERR6913277	Microbacterium resistens	156977	S	7	1	8	0.00001
ERR6913277	Microbacterium foliorum	104336	S	7	1	8	0.00001
ERR6913277	Microbacterium chocolatum	84292	S	6	1	7	0.00001
ERR6913277	Microbacterium cremeum	2782169	S	5	1	6	0.00000
ERR6913277	Microbacterium paraoxydans	199592	S	5	30	35	0.00003
ERR6913277	Agrococcus sp. Marseille-Q4369	2810513	S	54	18	72	0.00006
ERR6913277	Rhodoluna lacicola	529884	S	10	33	43	0.00003
ERR6913277	Leucobacter sp. H25R-14	2932245	S	5	2	7	0.00001
ERR6913277	Leucobacter aridicollis	283878	S	7	1	8	0.00001
ERR6913277	Leucobacter viscericola	2714935	S	7	2	9	0.00001
ERR6913277	Leucobacter muris	1935379	S	5	4	9	0.00001
ERR6913277	Agromyces sp. CFWR-12	2929802	S	5	7	12	0.00001
ERR6913277	Gulosibacter molinativorax	256821	S	10	1	11	0.00001
ERR6913277	Gulosibacter sediminis	1729695	S	9	1	10	0.00001
ERR6913277	Aurantimicrobium photophilum	1987356	S	9	0	9	0.00001
ERR6913277	Aurantimicrobium minutum	708131	S	6	1	7	0.00001
ERR6913277	Mycetocola zhujimingii	2079792	S	7	0	7	0.00001
ERR6913277	Mycetocola sp. JXN-3	2116510	S	5	0	5	0.00000
ERR6913277	Clavibacter michiganensis	28447	S	9	9	18	0.00001
ERR6913277	Subtercola sp. PAMC28395	2846775	S	8	0	8	0.00001
ERR6913277	Humibacter ginsenosidimutans	2599293	S	5	1	6	0.00000
ERR6913277	Janibacter sp. CX7	2963431	S	98	22	120	0.00010
ERR6913277	Janibacter sp. YB324	2761047	S	40	41	81	0.00007
ERR6913277	Janibacter indicus	857417	S	120	82	202	0.00016
ERR6913277	Janibacter limosus	53458	S	60	6	66	0.00005
ERR6913277	Janibacter melonis	262209	S	20	1	21	0.00002
ERR6913277	Tetrasphaera sp. HKS02	1813880	S	6	0	6	0.00000
ERR6913277	Arsenicicoccus sp. oral taxon 190	1658671	S	6	0	6	0.00000
ERR6913277	Brevibacterium sp. CS2	2575923	S	108	10	118	0.00010
ERR6913277	Brevibacterium casei	33889	S	14	3	17	0.00001
ERR6913277	Brevibacterium aurantiacum	273384	S	5	6	11	0.00001
ERR6913277	Brachybacterium sp. Z12	2759167	S	11	5	16	0.00001
ERR6913277	Brachybacterium sp. P6-10-X1	1903186	S	10	3	13	0.00001
ERR6913277	Brachybacterium faecium	43669	S	10	2	12	0.00001
ERR6913277	Brachybacterium ginsengisoli	1331682	S	9	1	10	0.00001
ERR6913277	Brachybacterium huguangmaarense	1652028	S	7	0	7	0.00001
ERR6913277	Brachybacterium vulturis	2017484	S	6	2	8	0.00001
ERR6913277	Brachybacterium saurashtrense	556288	S	5	1	6	0.00000
ERR6913277	Brachybacterium avium	2017485	S	5	1	6	0.00000
ERR6913277	Brachybacterium kimchii	2942909	S	5	4	9	0.00001
ERR6913277	Dermabacter vaginalis	1630135	S	6	15	21	0.00002
ERR6913277	Kytococcus sedentarius	1276	S	44	3	47	0.00004
ERR6913277	Cellulomonas iranensis	76862	S	5	3	8	0.00001
ERR6913277	Actinotalea sp. JY-7876	2758442	S	7	0	7	0.00001
ERR6913277	Dermacoccus nishinomiyaensis	1274	S	16	1	17	0.00001
ERR6913277	Ruania zhangjianzhongii	2603206	S	5	3	8	0.00001
ERR6913277	Cellulosimicrobium cellulans	1710	S	5	3	8	0.00001
ERR6913277	Luteimicrobium xylanilyticum	1133546	S	5	0	5	0.00000
ERR6913277	Pengzhenrongella sicca	2819238	S	5	0	5	0.00000
ERR6913277	Sanguibacter sp. HDW7	2714931	S	5	0	5	0.00000
ERR6913277	Demequina sp. TMPB413	2881056	S	5	0	5	0.00000
ERR6913277	Jonesia denitrificans	43674	S	5	0	5	0.00000
ERR6913277	Corynebacterium tuberculostearicum	38304	S	441	37	478	0.00039
ERR6913277	Corynebacterium matruchotii	43768	S	428	4	432	0.00035
ERR6913277	Corynebacterium kefirresidentii	1979527	S	158	17	175	0.00014
ERR6913277	Corynebacterium ihumii	1232427	S	157	11	168	0.00014
ERR6913277	Corynebacterium glucuronolyticum	39791	S	113	2	115	0.00009
ERR6913277	Corynebacterium genitalium	38288	S	101	3	104	0.00008
ERR6913277	Corynebacterium sanguinis	2594913	S	94	10	104	0.00008
ERR6913277	Corynebacterium jeikeium	38289	S	69	28	97	0.00008
ERR6913277	Corynebacterium ureicelerivorans	401472	S	31	2	33	0.00003
ERR6913277	Corynebacterium jeddahense	1414719	S	28	2	30	0.00002
ERR6913277	Corynebacterium sp. CNCTC7651	2815361	S	10	0	10	0.00001
ERR6913277	Corynebacterium sp. FDAARGOS 1242	2778078	S	8	4	12	0.00001
ERR6913277	Corynebacterium amycolatum	43765	S	24	35	59	0.00005
ERR6913277	Corynebacterium pseudodiphtheriticum	37637	S	23	1	24	0.00002
ERR6913277	Corynebacterium aurimucosum	169292	S	17	1	18	0.00001
ERR6913277	Corynebacterium coyleae	53374	S	17	0	17	0.00001
ERR6913277	Corynebacterium striatum	43770	S	17	2	19	0.00002
ERR6913277	Corynebacterium diphtheriae	1717	S	15	80	95	0.00008
ERR6913277	Corynebacterium minutissimum	38301	S	14	3	17	0.00001
ERR6913277	Corynebacterium singulare	161899	S	12	1	13	0.00001
ERR6913277	Corynebacterium falsenii	108486	S	11	0	11	0.00001
ERR6913277	Corynebacterium lujinxingii	2763010	S	11	0	11	0.00001
ERR6913277	Corynebacterium simulans	146827	S	10	1	11	0.00001
ERR6913277	Corynebacterium massiliense	441501	S	10	0	10	0.00001
ERR6913277	Corynebacterium macginleyi	38290	S	9	0	9	0.00001
ERR6913277	Corynebacterium riegelii	156976	S	9	0	9	0.00001
ERR6913277	Corynebacterium variabile	1727	S	9	0	9	0.00001
ERR6913277	Corynebacterium liangguodongii	2079535	S	8	0	8	0.00001
ERR6913277	Corynebacterium flavescens	28028	S	8	0	8	0.00001
ERR6913277	Corynebacterium mycetoides	38302	S	7	0	7	0.00001
ERR6913277	Corynebacterium glaucum	187491	S	7	0	7	0.00001
ERR6913277	Corynebacterium imitans	156978	S	7	0	7	0.00001
ERR6913277	Corynebacterium incognita	2754725	S	7	0	7	0.00001
ERR6913277	Corynebacterium timonense	441500	S	7	0	7	0.00001
ERR6913277	Corynebacterium accolens	38284	S	7	4	11	0.00001
ERR6913277	Corynebacterium propinquum	43769	S	6	0	6	0.00000
ERR6913277	Corynebacterium doosanense	1121358	S	6	0	6	0.00000
ERR6913277	Corynebacterium choanae	1862358	S	5	0	5	0.00000
ERR6913277	Corynebacterium resistens	258224	S	5	0	5	0.00000
ERR6913277	Corynebacterium aquilae	203263	S	5	0	5	0.00000
ERR6913277	Corynebacterium ammoniagenes	1697	S	5	0	5	0.00000
ERR6913277	Corynebacterium frankenforstense	1230998	S	5	0	5	0.00000
ERR6913277	Corynebacterium lactis	1231000	S	5	0	5	0.00000
ERR6913277	Corynebacterium camporealensis	161896	S	5	0	5	0.00000
ERR6913277	Corynebacterium xerosis	1725	S	5	0	5	0.00000
ERR6913277	Corynebacterium kroppenstedtii	161879	S	5	0	5	0.00000
ERR6913277	Corynebacterium efficiens	152794	S	5	0	5	0.00000
ERR6913277	Corynebacterium pseudopelargi	2080757	S	5	0	5	0.00000
ERR6913277	Mycolicibacterium phocaicum	319706	S	12	10	22	0.00002
ERR6913277	Mycolicibacterium poriferae	39694	S	9	1	10	0.00001
ERR6913277	Mycolicibacterium psychrotolerans	216929	S	8	2	10	0.00001
ERR6913277	Mycolicibacterium gadium	1794	S	7	1	8	0.00001
ERR6913277	Mycolicibacterium celeriflavum	1249101	S	6	0	6	0.00000
ERR6913277	Mycolicibacterium litorale	758802	S	5	1	6	0.00000
ERR6913277	Mycolicibacterium parafortuitum	39692	S	5	1	6	0.00000
ERR6913277	Mycolicibacterium alvei	67081	S	5	1	6	0.00000
ERR6913277	Mycobacterium frederiksbergense	117567	S	24	2	26	0.00002
ERR6913277	Mycobacterium sp. YC-RL4	1682113	S	6	3	9	0.00001
ERR6913277	Mycobacterium tuberculosis	1773	S	5	103	108	0.00009
ERR6913277	Mycobacterium paragordonae	1389713	S	7	0	7	0.00001
ERR6913277	Mycobacterium grossiae	1552759	S	6	0	6	0.00000
ERR6913277	Mycobacterium gordonae	1778	S	5	0	5	0.00000
ERR6913277	Mycobacterium xenopi	1789	S	5	0	5	0.00000
ERR6913277	Mycobacteroides abscessus	36809	S	7	6	13	0.00001
ERR6913277	Mycobacteroides chelonae	1774	S	5	0	5	0.00000
ERR6913277	Rhodococcus fascians	1828	S	47	3	50	0.00004
ERR6913277	Rhodococcus sp. P1Y	1302308	S	9	0	9	0.00001
ERR6913277	Rhodococcus sp. YL-1	1045808	S	7	21	28	0.00002
ERR6913277	Rhodococcus sp. W8901	2742603	S	6	1	7	0.00001
ERR6913277	Rhodococcus erythropolis	1833	S	11	30	41	0.00003
ERR6913277	Rhodococcus qingshengii	334542	S	8	28	36	0.00003
ERR6913277	Nocardia cyriacigeorgica	135487	S	6	1	7	0.00001
ERR6913277	Nocardia asteroides	1824	S	5	1	6	0.00000
ERR6913277	Nocardia terpenica	455432	S	5	0	5	0.00000
ERR6913277	Lawsonella clevelandensis	1528099	S	159	3	162	0.00013
ERR6913277	Dietzia sp. oral taxon 368	712270	S	15	11	26	0.00002
ERR6913277	Dietzia psychralcaliphila	139021	S	8	1	9	0.00001
ERR6913277	Dietzia lutea	546160	S	7	2	9	0.00001
ERR6913277	Gordonia bronchialis	2054	S	9	6	15	0.00001
ERR6913277	Schaalia odontolytica	1660	S	952	136	1088	0.00088
ERR6913277	Schaalia meyeri	52773	S	96	16	112	0.00009
ERR6913277	Schaalia turicensis	131111	S	18	2	20	0.00002
ERR6913277	Schaalia radingae	131110	S	16	0	16	0.00001
ERR6913277	Schaalia sp. 19OD2882	2794089	S	10	0	10	0.00001
ERR6913277	Actinomyces pacaensis	1852377	S	296	22	318	0.00026
ERR6913277	Actinomyces sp. oral taxon 414	712122	S	33	4	37	0.00003
ERR6913277	Actinomyces sp. oral taxon 169	712116	S	26	40	66	0.00005
ERR6913277	Actinomyces sp. HMT 175	2789425	S	21	73	94	0.00008
ERR6913277	Actinomyces sp. oral taxon 171	706438	S	17	9	26	0.00002
ERR6913277	Actinomyces sp. MAS-1	2755559	S	7	0	7	0.00001
ERR6913277	Actinomyces sp. 432	2057798	S	6	1	7	0.00001
ERR6913277	Actinomyces oris	544580	S	112	135	247	0.00020
ERR6913277	Actinomyces faecalis	2722820	S	35	1	36	0.00003
ERR6913277	Actinomyces trachealis	2763540	S	30	2	32	0.00003
ERR6913277	Actinomyces naeslundii	1655	S	26	5	31	0.00003
ERR6913277	Actinomyces slackii	52774	S	17	1	18	0.00001
ERR6913277	Actinomyces radicidentis	111015	S	15	1	16	0.00001
ERR6913277	Actinomyces howellii	52771	S	14	0	14	0.00001
ERR6913277	Actinomyces viscosus	1656	S	10	2	12	0.00001
ERR6913277	Actinomyces respiraculi	2744574	S	8	0	8	0.00001
ERR6913277	Actinomyces wuliandei	2057743	S	7	1	8	0.00001
ERR6913277	Actinomyces procaprae	2560010	S	5	0	5	0.00000
ERR6913277	Actinomyces gaoshouyii	1960083	S	5	1	6	0.00000
ERR6913277	Actinomyces weissii	675090	S	5	0	5	0.00000
ERR6913277	Trueperella pyogenes	1661	S	30	1	31	0.00003
ERR6913277	Trueperella pecoris	2733571	S	7	0	7	0.00001
ERR6913277	Fannyhessea vaginae	82135	S	32	0	32	0.00003
ERR6913277	Pauljensenia hongkongensis	178339	S	27	5	32	0.00003
ERR6913277	Winkia neuii	33007	S	14	1	15	0.00001
ERR6913277	Varibaculum prostatecancerukia	2811781	S	13	0	13	0.00001
ERR6913277	Mobiluncus curtisii	2051	S	10	0	10	0.00001
ERR6913277	Flaviflexus salsibiostraticola	1282737	S	5	0	5	0.00000
ERR6913277	Boudabousia tangfeifanii	1912795	S	7	0	7	0.00001
ERR6913277	Changpingibacter yushuensis	2758440	S	6	0	6	0.00000
ERR6913277	Streptomyces sp. T12	477697	S	42	51	93	0.00008
ERR6913277	Streptomyces sp. CB04723	2748873	S	6	42	48	0.00004
ERR6913277	Streptomyces venezuelae	54571	S	7	6	13	0.00001
ERR6913277	Streptomyces viridosporus	67581	S	6	5	11	0.00001
ERR6913277	Streptomyces calvus	67282	S	5	4	9	0.00001
ERR6913277	Streptacidiphilus sp. P02-A3a	2704468	S	7	0	7	0.00001
ERR6913277	Amycolatopsis orientalis	31958	S	5	3	8	0.00001
ERR6913277	Kutzneria albida	43357	S	11	1	12	0.00001
ERR6913277	Kutzneria chonburiensis	1483604	S	5	0	5	0.00000
ERR6913277	Kutzneria sp. CA-103260	2802641	S	5	0	5	0.00000
ERR6913277	Saccharothrix sp. 6-C	2781735	S	8	1	9	0.00001
ERR6913277	Actinokineospora sp. UTMC 2448	2268449	S	5	0	5	0.00000
ERR6913277	Candidatus Planktophila sulfonica	1884904	S	27	20	47	0.00004
ERR6913277	Candidatus Planktophila lacus	1884913	S	11	2	13	0.00001
ERR6913277	Candidatus Planktophila vernalis	1884907	S	8	2	10	0.00001
ERR6913277	Candidatus Planktophila versatilis	1884905	S	7	2	9	0.00001
ERR6913277	Candidatus Planktophila dulcis	1884914	S	7	6	13	0.00001
ERR6913277	Dactylosporangium aurantiacum	35754	S	5	15	20	0.00002
ERR6913277	Nonomuraea coxensis	404386	S	5	3	8	0.00001
ERR6913277	Nocardiopsis dassonvillei	2014	S	6	1	7	0.00001
ERR6913277	Nakamurella multipartita	53461	S	5	0	5	0.00000
ERR6913277	Nakamurella antarctica	1902245	S	5	0	5	0.00000
ERR6913277	Jatrophihabitans telluris	2038343	S	10	0	10	0.00001
ERR6913277	Epidermidibacterium keratini	1891644	S	7	0	7	0.00001
ERR6913277	Lancefieldella parvula	1382	S	41701	1564	43265	0.03511
ERR6913277	Olsenella uli	133926	S	307	41	348	0.00028
ERR6913277	Olsenella sp. oral taxon 807	712411	S	109	4	113	0.00009
ERR6913277	Olsenella timonensis	1805478	S	43	12	55	0.00004
ERR6913277	Atopobium sp. oral taxon 416	712157	S	55	2	57	0.00005
ERR6913277	Parolsenella massiliensis	1871022	S	20	19	39	0.00003
ERR6913277	Parolsenella catena	2003188	S	12	13	25	0.00002
ERR6913277	Leptogranulimonas caecicola	2894156	S	35	1	36	0.00003
ERR6913277	Parafannyhessea umbonata	604330	S	20	5	25	0.00002
ERR6913277	Thermophilibacter immobilis	2779519	S	14	3	17	0.00001
ERR6913277	Collinsella sp. zg1085	2844380	S	190	2	192	0.00016
ERR6913277	Collinsella aerofaciens	74426	S	93	16	109	0.00009
ERR6913277	Collinsella stercoris	147206	S	8	0	8	0.00001
ERR6913277	Coriobacterium glomerans	33871	S	11	0	11	0.00001
ERR6913277	Cryptobacterium curtum	84163	S	2420	36	2456	0.00199
ERR6913277	Gordonibacter urolithinfaciens	1335613	S	5	1	6	0.00000
ERR6913277	Raoultibacter timonensis	1907662	S	8	0	8	0.00001
ERR6913277	Phoenicibacter congonensis	1944646	S	8	0	8	0.00001
ERR6913277	Arabiibacter massiliensis	1870985	S	8	1	9	0.00001
ERR6913277	Slackia heliotrinireducens	84110	S	6	0	6	0.00000
ERR6913277	Denitrobacterium detoxificans	79604	S	5	0	5	0.00000
ERR6913277	Aquihabitans sp. G128	2849779	S	21	3	24	0.00002
ERR6913277	Aquihabitans sp. Kera 3	2884263	S	7	0	7	0.00001
ERR6913277	Iamia majanohamensis	467976	S	7	0	7	0.00001
ERR6913277	Iamia sp. SCSIO 61187	2722752	S	7	0	7	0.00001
ERR6913277	Actinomarinicola tropica	2789776	S	14	2	16	0.00001
ERR6913277	Ilumatobacter coccineus	467094	S	13	1	14	0.00001
ERR6913277	Acidimicrobium ferrooxidans	53635	S	11	0	11	0.00001
ERR6913277	Conexibacter woesei	191495	S	10	0	10	0.00001
ERR6913277	Limnospira indica	147322	S	94	276	370	0.00030
ERR6913277	Moorena producens	1155739	S	37	0	37	0.00003
ERR6913277	Oscillatoria acuminata	118323	S	6	0	6	0.00000
ERR6913277	Planktothrix agardhii	1160	S	14	22	36	0.00003
ERR6913277	Microcoleus vaginatus	119532	S	13	1	14	0.00001
ERR6913277	Allocoleopsis franciscana	2886352	S	16	3	19	0.00002
ERR6913277	Crinalium epipsammum	241425	S	7	2	9	0.00001
ERR6913277	Geminocystis sp. NIES-3708	1615909	S	40	23	63	0.00005
ERR6913277	Geminocystis sp. NIES-3709	1617448	S	8	4	12	0.00001
ERR6913277	Chondrocystis sp. NIES-4102	2005460	S	46	19	65	0.00005
ERR6913277	Candidatus Atelocyanobacterium thalassa	713887	S	44	6	50	0.00004
ERR6913277	Cyanobacterium aponinum	379064	S	11	12	23	0.00002
ERR6913277	Calothrix sp. PCC 6303	1170562	S	120	22	142	0.00012
ERR6913277	Calothrix sp. NIES-3974	2005462	S	98	10	108	0.00009
ERR6913277	Nostoc sp. UHCC 0702	2814655	S	6	38	44	0.00004
ERR6913277	Richelia sinica	1357545	S	6	5	11	0.00001
ERR6913277	Dolichospermum compactum	136073	S	30	56	86	0.00007
ERR6913277	Scytonema sp. HK-05	1137095	S	5	4	9	0.00001
ERR6913277	Tolypothrix tenuis	457083	S	6	4	10	0.00001
ERR6913277	Rivularia sp. PCC 7116	373994	S	5	0	5	0.00000
ERR6913277	Synechococcus sp. PCC 7336	195250	S	76	5	81	0.00007
ERR6913277	Synechococcus sp. PCC 7502	1173263	S	29	4	33	0.00003
ERR6913277	Synechococcus sp. JA-2-3B'a(2-13)	321332	S	28	48	76	0.00006
ERR6913277	Synechococcus sp. PCC 6312	195253	S	11	1	12	0.00001
ERR6913277	Synechococcus sp. CBW1004	1353136	S	9	46	55	0.00004
ERR6913277	Chamaesiphon minutus	1173032	S	94	12	106	0.00009
ERR6913277	Prochlorococcus marinus	1219	S	11	14	25	0.00002
ERR6913277	Acaryochloris marina	155978	S	11	4	15	0.00001
ERR6913277	Leptolyngbya sp. 7M	2812896	S	19	4	23	0.00002
ERR6913277	Leptolyngbya sp. NIES-3755	1752064	S	8	11	19	0.00002
ERR6913277	Leptolyngbya sp. BL0902	1115757	S	7	4	11	0.00001
ERR6913277	Pseudanabaena sp. PCC 7367	82654	S	6	11	17	0.00001
ERR6913277	Thermosynechococcus vestitus	146786	S	7	4	11	0.00001
ERR6913277	Anthocerotibacter panamensis	2857077	S	9	10	19	0.00002
ERR6913277	Gloeomargarita lithophora	1188228	S	42	3	45	0.00004
ERR6913277	Chroococcidiopsis sp. CCMEE 29	155894	S	27	16	43	0.00003
ERR6913277	Pleurocapsa sp. PCC 7327	118163	S	5	0	5	0.00000
ERR6913277	cyanobacterium endosymbiont of Epithemia turgida	718217	S	18	11	29	0.00002
ERR6913277	Mesomycoplasma ovipneumoniae	29562	S	17	21	38	0.00003
ERR6913277	Paracholeplasma brassicae	61635	S	13	3	16	0.00001
ERR6913277	Spiroplasma platyhelix	301585	S	9	1	10	0.00001
ERR6913277	Spiroplasma chrysopicola	216933	S	5	3	8	0.00001
ERR6913277	Metamycoplasma salivarium	2124	S	13	26	39	0.00003
ERR6913277	Malacoplasma penetrans	28227	S	5	0	5	0.00000
ERR6913277	Brevefilum fermentans	1986204	S	46	8	54	0.00004
ERR6913277	Candidatus Promineofilum breve	1806508	S	6	1	7	0.00001
ERR6913277	Phototrophicus methaneseepsis	2710758	S	6	0	6	0.00000
ERR6913277	Deinococcus peraridilitoris	432329	S	16	0	16	0.00001
ERR6913277	Deinococcus wulumuqiensis	980427	S	6	3	9	0.00001
ERR6913277	Deinococcus geothermalis	68909	S	6	1	7	0.00001
ERR6913277	Fimbriimonas ginsengisoli	1005039	S	10	0	10	0.00001
ERR6913277	Sphaerobacter thermophilus	2057	S	5	0	5	0.00000
ERR6913277	Prevotella histicola	470565	S	16724	3731	20455	0.01660
ERR6913277	Prevotella jejuni	1177574	S	2124	1418	3542	0.00287
ERR6913277	Prevotella melaninogenica	28132	S	2002	1097	3099	0.00251
ERR6913277	Prevotella oris	28135	S	1870	280	2150	0.00174
ERR6913277	Prevotella denticola	28129	S	1176	711	1887	0.00153
ERR6913277	Prevotella nigrescens	28133	S	931	800	1731	0.00140
ERR6913277	Prevotella intermedia	28131	S	669	397	1066	0.00087
ERR6913277	Prevotella sp. oral taxon 299	652716	S	172	25	197	0.00016
ERR6913277	Prevotella sp. oral taxon 475	712471	S	164	13	177	0.00014
ERR6913277	Prevotella sp. E15-22	2937774	S	52	45	97	0.00008
ERR6913277	Prevotella sp. Rep29	2691580	S	46	4	50	0.00004
ERR6913277	Prevotella sp. E13-17	2913616	S	36	16	52	0.00004
ERR6913277	Prevotella sp. E9-3	2913621	S	36	16	52	0.00004
ERR6913277	Prevotella sp. E2-28	2913620	S	11	7	18	0.00001
ERR6913277	Prevotella herbatica	2801997	S	253	4	257	0.00021
ERR6913277	Prevotella fusca	589436	S	222	83	305	0.00025
ERR6913277	Prevotella copri	165179	S	204	13	217	0.00018
ERR6913277	Prevotella multiformis	282402	S	162	128	290	0.00024
ERR6913277	Prevotella dentalis	52227	S	131	16	147	0.00012
ERR6913277	Prevotella scopos	589437	S	115	99	214	0.00017
ERR6913277	Prevotella veroralis	28137	S	113	41	154	0.00012
ERR6913277	Prevotella bryantii	77095	S	100	3	103	0.00008
ERR6913277	Prevotella corporis	28128	S	89	22	111	0.00009
ERR6913277	Prevotella ruminicola	839	S	27	0	27	0.00002
ERR6913277	Hoylesella enoeca	76123	S	111	41	152	0.00012
ERR6913277	Hoylesella buccalis	28127	S	94	33	127	0.00010
ERR6913277	Pseudoprevotella muciniphila	2133944	S	192	3	195	0.00016
ERR6913277	Paraprevotella xylaniphila	454155	S	54	8	62	0.00005
ERR6913277	Porphyromonas gingivalis	837	S	2023	319	2342	0.00190
ERR6913277	Porphyromonas endodontalis	28124	S	1735	111	1846	0.00150
ERR6913277	Porphyromonas sp. oral taxon 275	712435	S	894	25	919	0.00075
ERR6913277	Porphyromonas cangingivalis	36874	S	22	1	23	0.00002
ERR6913277	Porphyromonas somerae	322095	S	10	1	11	0.00001
ERR6913277	Porphyromonas asaccharolytica	28123	S	5	0	5	0.00000
ERR6913277	Tannerella forsythia	28112	S	729	116	845	0.00069
ERR6913277	Tannerella serpentiformis	712710	S	276	10	286	0.00023
ERR6913277	Parabacteroides distasonis	823	S	14	18	32	0.00003
ERR6913277	Parabacteroides faecis	1217282	S	6	0	6	0.00000
ERR6913277	Bacteroides zoogleoformans	28119	S	28	10	38	0.00003
ERR6913277	Bacteroides xylanisolvens	371601	S	24	63	87	0.00007
ERR6913277	Bacteroides caccae	47678	S	13	3	16	0.00001
ERR6913277	Bacteroides stercoris	46506	S	12	3	15	0.00001
ERR6913277	Bacteroides fragilis	817	S	12	12	24	0.00002
ERR6913277	Bacteroides ovatus	28116	S	10	51	61	0.00005
ERR6913277	Bacteroides faecium	2715212	S	10	1	11	0.00001
ERR6913277	Bacteroides uniformis	820	S	9	17	26	0.00002
ERR6913277	Bacteroides thetaiotaomicron	818	S	8	3	11	0.00001
ERR6913277	Bacteroides intestinalis	329854	S	8	1	9	0.00001
ERR6913277	Bacteroides eggerthii	28111	S	7	2	9	0.00001
ERR6913277	Bacteroides heparinolyticus	28113	S	7	1	8	0.00001
ERR6913277	Bacteroides salyersiae	291644	S	5	1	6	0.00000
ERR6913277	Phocaeicola coprophilus	387090	S	27	11	38	0.00003
ERR6913277	Phocaeicola vulgatus	821	S	17	38	55	0.00004
ERR6913277	Phocaeicola salanitronis	376805	S	15	2	17	0.00001
ERR6913277	Phocaeicola dorei	357276	S	10	21	31	0.00003
ERR6913277	Alistipes communis	2585118	S	27	18	45	0.00004
ERR6913277	Alistipes finegoldii	214856	S	6	18	24	0.00002
ERR6913277	Odoribacter splanchnicus	28118	S	18	1	19	0.00002
ERR6913277	Coprobacter secundus	1501392	S	28	4	32	0.00003
ERR6913277	Barnesiella viscericola	397865	S	7	1	8	0.00001
ERR6913277	Muribaculum intestinale	1796646	S	12	2	14	0.00001
ERR6913277	Sodaliphilus pleomorphus	2606626	S	13	1	14	0.00001
ERR6913277	Paludibacter propionicigenes	185300	S	31	0	31	0.00003
ERR6913277	Proteiniphilum saccharofermentans	1642647	S	5	5	10	0.00001
ERR6913277	Tenuifilum thalassicum	2590900	S	8	0	8	0.00001
ERR6913277	Candidatus Azobacteroides pseudotrichonymphae	511435	S	6	0	6	0.00000
ERR6913277	Alkalitalea saponilacus	889453	S	22	0	22	0.00002
ERR6913277	Capnocytophaga gingivalis	1017	S	530	91	621	0.00050
ERR6913277	Capnocytophaga leadbetteri	327575	S	210	226	436	0.00035
ERR6913277	Capnocytophaga sp. FDAARGOS_737	2545799	S	92	95	187	0.00015
ERR6913277	Capnocytophaga sp. oral taxon 878	1316596	S	38	12	50	0.00004
ERR6913277	Capnocytophaga sp. H2931	1945657	S	15	18	33	0.00003
ERR6913277	Capnocytophaga sp. H4358	1945658	S	15	19	34	0.00003
ERR6913277	Capnocytophaga sp. oral taxon 902	2748316	S	8	72	80	0.00006
ERR6913277	Capnocytophaga sputigena	1019	S	110	65	175	0.00014
ERR6913277	Capnocytophaga ochracea	1018	S	91	331	422	0.00034
ERR6913277	Capnocytophaga endodontalis	2708117	S	26	25	51	0.00004
ERR6913277	Flavobacterium sp. M31R6	2739062	S	12	18	30	0.00002
ERR6913277	Flavobacterium sp. CC-SYL302	2870839	S	7	7	14	0.00001
ERR6913277	Flavobacterium sp. N1994	2986827	S	7	4	11	0.00001
ERR6913277	Flavobacterium sp. F-323	2893885	S	6	10	16	0.00001
ERR6913277	Flavobacterium sp. F-340	2893886	S	6	8	14	0.00001
ERR6913277	Flavobacterium sp. IMCC34518	3003623	S	6	8	14	0.00001
ERR6913277	Flavobacterium sp. IMCC36793	3003263	S	6	6	12	0.00001
ERR6913277	Flavobacterium sp. N2820	2986834	S	5	7	12	0.00001
ERR6913277	Flavobacterium sp. F-29	2893883	S	5	6	11	0.00001
ERR6913277	Flavobacterium sp. K5-23	2746225	S	5	6	11	0.00001
ERR6913277	Flavobacterium sp. Sr18	935222	S	5	6	11	0.00001
ERR6913277	Flavobacterium sp. IMCC36792	3016339	S	5	6	11	0.00001
ERR6913277	Flavobacterium psychrophilum	96345	S	12	10	22	0.00002
ERR6913277	Flavobacterium davisii	2906077	S	6	12	18	0.00001
ERR6913277	Flavobacterium nackdongense	2547394	S	6	3	9	0.00001
ERR6913277	Flavobacterium nitrogenifigens	1617283	S	6	88	94	0.00008
ERR6913277	Flavobacterium arcticum	1784713	S	5	3	8	0.00001
ERR6913277	Flavobacterium ammoniigenes	1751095	S	5	9	14	0.00001
ERR6913277	Flavobacterium ammonificans	1751056	S	5	9	14	0.00001
ERR6913277	Amniculibacterium sp. G2-70	2767188	S	10	4	14	0.00001
ERR6913277	Mesoflavibacter sp. SCSIO 43206	2779362	S	6	16	22	0.00002
ERR6913277	Oceanihabitans sp. IOP_32	2529032	S	6	10	16	0.00001
ERR6913277	Aureibaculum algae	2584122	S	6	2	8	0.00001
ERR6913277	Zhouia spongiae	2202721	S	5	4	9	0.00001
ERR6913277	Chryseobacterium taklimakanense	536441	S	258	66	324	0.00026
ERR6913277	Chryseobacterium sp. CY350	2997336	S	15	6	21	0.00002
ERR6913277	Chryseobacterium sp. 6424	2039166	S	13	2	15	0.00001
ERR6913277	Chryseobacterium sp. POL2	2713414	S	8	1	9	0.00001
ERR6913277	Chryseobacterium sp. ZHDP1	2838877	S	7	11	18	0.00001
ERR6913277	Chryseobacterium sp. StRB126	878220	S	7	5	12	0.00001
ERR6913277	Chryseobacterium manosquense	2754694	S	61	25	86	0.00007
ERR6913277	Chryseobacterium faecale	2852098	S	28	2	30	0.00002
ERR6913277	Chryseobacterium camelliae	1265445	S	11	2	13	0.00001
ERR6913277	Chryseobacterium balustinum	246	S	7	5	12	0.00001
ERR6913277	Chryseobacterium shandongense	1493872	S	6	3	9	0.00001
ERR6913277	Kaistella sp. BT6-1-3	2989820	S	419	106	525	0.00043
ERR6913277	Kaistella sp. GW4-15	2878534	S	6	0	6	0.00000
ERR6913277	Kaistella daneshvariae	2487074	S	20	0	20	0.00002
ERR6913277	Kaistella flava (ex Peng et al. 2021)	2038776	S	10	0	10	0.00001
ERR6913277	Kaistella carnis	1241979	S	6	0	6	0.00000
ERR6913277	Candidatus Kaistella beijingensis	2820270	S	6	0	6	0.00000
ERR6913277	Kaistella jeonii	266749	S	5	0	5	0.00000
ERR6913277	Epilithonimonas vandammei	2487072	S	27	13	40	0.00003
ERR6913277	Epilithonimonas zeae	1416779	S	7	0	7	0.00001
ERR6913277	Bergeyella cardium	1585976	S	57	4	61	0.00005
ERR6913277	Cloacibacterium caeni	2004710	S	18	9	27	0.00002
ERR6913277	Cloacibacterium sp. TD35	2976818	S	18	3	21	0.00002
ERR6913277	Cloacibacterium normanense	237258	S	13	4	17	0.00001
ERR6913277	Elizabethkingia sp. JS20170427COW	2583851	S	5	14	19	0.00002
ERR6913277	Riemerella anatipestifer	34085	S	16	1	17	0.00001
ERR6913277	Empedobacter falsenii	343874	S	7	1	8	0.00001
ERR6913277	Empedobacter brevis	247	S	5	0	5	0.00000
ERR6913277	Ornithobacterium rhinotracheale	28251	S	8	1	9	0.00001
ERR6913277	Croceimicrobium hydrocarbonivorans	2761580	S	16	17	33	0.00003
ERR6913277	Candidatus Karelsulcia muelleri	336810	S	31	2	33	0.00003
ERR6913277	Fluviicola taffensis	191579	S	23	0	23	0.00002
ERR6913277	Blattabacterium cuenoti	1653831	S	12	7	19	0.00002
ERR6913277	Ichthyobacterium seriolicida	242600	S	8	0	8	0.00001
ERR6913277	Spirosoma montaniterrae	1178516	S	31	17	48	0.00004
ERR6913277	Spirosoma pollinicola	2057025	S	8	6	14	0.00001
ERR6913277	Aquirufa antheringensis	2516559	S	18	54	72	0.00006
ERR6913277	Rhodocytophaga rosea	2704465	S	11	1	12	0.00001
ERR6913277	Cytophaga hutchinsonii	985	S	8	1	9	0.00001
ERR6913277	Hymenobacter sp. 5317J-9	2932250	S	9	9	18	0.00001
ERR6913277	Hymenobacter sp. PAMC 26628	1484118	S	7	7	14	0.00001
ERR6913277	Hymenobacter sp. 5116S-3	2932248	S	5	3	8	0.00001
ERR6913277	Hymenobacter monticola	1705399	S	16	11	27	0.00002
ERR6913277	Hymenobacter sedentarius	1411621	S	9	6	15	0.00001
ERR6913277	Hymenobacter nivis	1850093	S	7	6	13	0.00001
ERR6913277	Dyadobacter fermentans	94254	S	16	6	22	0.00002
ERR6913277	Emticicia sp. 21SJ11W-3	2916755	S	18	3	21	0.00002
ERR6913277	Fibrella aestuarina	651143	S	9	4	13	0.00001
ERR6913277	Larkinella sp. IE-0392	2907205	S	7	3	10	0.00001
ERR6913277	Arcticibacterium luteifluviistationis	1784714	S	6	1	7	0.00001
ERR6913277	Leadbetterella byssophila	316068	S	5	2	7	0.00001
ERR6913277	Echinicola soli	2591634	S	26	7	33	0.00003
ERR6913277	Mongoliitalea daihaiensis	2782006	S	25	7	32	0.00003
ERR6913277	Belliella baltica	232259	S	5	4	9	0.00001
ERR6913277	Marivirga tractuosa	1006	S	19	14	33	0.00003
ERR6913277	Chryseolinea soli	2321403	S	10	0	10	0.00001
ERR6913277	Persicobacter sp. JZB09	1085624	S	7	0	7	0.00001
ERR6913277	Bernardetia litoralis	999	S	7	0	7	0.00001
ERR6913277	Reichenbachiella sp. BKB1-1	2979464	S	5	1	6	0.00000
ERR6913277	Mangrovivirga cuniculi	2715131	S	7	1	8	0.00001
ERR6913277	Sphingobacterium sp. UDSM-2020	2795738	S	9	1	10	0.00001
ERR6913277	Sphingobacterium sp. CZ-2	2557994	S	7	1	8	0.00001
ERR6913277	Sphingobacterium sp. G1-14	2003121	S	5	22	27	0.00002
ERR6913277	Sphingobacterium lactis	797291	S	14	7	21	0.00002
ERR6913277	Sphingobacterium multivorum	28454	S	12	19	31	0.00003
ERR6913277	Sphingobacterium hotanense	649196	S	9	2	11	0.00001
ERR6913277	Sphingobacterium mizutaii	1010	S	7	2	9	0.00001
ERR6913277	Sphingobacterium daejeonense	371142	S	5	1	6	0.00000
ERR6913277	Mucilaginibacter paludis	423351	S	26	5	31	0.00003
ERR6913277	Mucilaginibacter sp. SMC90	2929803	S	5	7	12	0.00001
ERR6913277	Mucilaginibacter celer	2305508	S	6	2	8	0.00001
ERR6913277	Mucilaginibacter mali	2740462	S	5	0	5	0.00000
ERR6913277	Pedobacter mucosus	2895286	S	8	3	11	0.00001
ERR6913277	Pedobacter endophyticus	2789740	S	7	4	11	0.00001
ERR6913277	Pedobacter aquae	2605747	S	6	1	7	0.00001
ERR6913277	Pedobacter steynii	430522	S	5	2	7	0.00001
ERR6913277	Olivibacter sp. LS-1	2592345	S	5	2	7	0.00001
ERR6913277	Arachidicoccus sp. B3-10	2545455	S	47	17	64	0.00005
ERR6913277	Arachidicoccus terrestris	2875539	S	5	1	6	0.00000
ERR6913277	Ferruginibacter lapsinanis	563172	S	10	4	14	0.00001
ERR6913277	Ferruginibacter albus	2875540	S	9	4	13	0.00001
ERR6913277	Niabella soli	446683	S	8	3	11	0.00001
ERR6913277	Sediminibacterium sp. TEGAF015	575378	S	7	4	11	0.00001
ERR6913277	Filimonas lacunae	477680	S	5	3	8	0.00001
ERR6913277	Lacibacter sp. S13-6-22	2760713	S	5	1	6	0.00000
ERR6913277	Phnomibacter ginsenosidimutans	2676868	S	5	2	7	0.00001
ERR6913277	Haliscomenobacter hydrossis	2350	S	66	11	77	0.00006
ERR6913277	Aureispira sp. EL160426	2864201	S	32	14	46	0.00004
ERR6913277	Candidatus Sulfidibacterium hydrothermale	2875962	S	32	0	32	0.00003
ERR6913277	Salinibacter ruber	146919	S	7	0	7	0.00001
ERR6913277	Gemmatimonas aurantiaca	173480	S	7	6	13	0.00001
ERR6913277	Gemmatirosa kalamazoonensis	861299	S	15	0	15	0.00001
ERR6913277	Kingella denitrificans	502	S	1222	545	1767	0.00143
ERR6913277	Kingella oralis	505	S	753	133	886	0.00072
ERR6913277	Kingella potus	265175	S	32	7	39	0.00003
ERR6913277	Kingella kingae	504	S	21	3	24	0.00002
ERR6913277	Neisseria sp. KEM232	655307	S	194	44	238	0.00019
ERR6913277	Neisseria sp. oral taxon 014	641148	S	64	36	100	0.00008
ERR6913277	Neisseria elongata	495	S	239	120	359	0.00029
ERR6913277	Neisseria sicca	490	S	213	474	687	0.00056
ERR6913277	Neisseria subflava	28449	S	108	71	179	0.00015
ERR6913277	Neisseria meningitidis	487	S	54	1623	1677	0.00136
ERR6913277	Neisseria mucosa	488	S	52	126	178	0.00014
ERR6913277	Neisseria macacae	496	S	51	153	204	0.00017
ERR6913277	Neisseria flavescens	484	S	17	9	26	0.00002
ERR6913277	Neisseria shayeganii	607712	S	16	2	18	0.00001
ERR6913277	Neisseria bacilliformis	267212	S	16	4	20	0.00002
ERR6913277	Neisseria lactamica	486	S	13	9	22	0.00002
ERR6913277	Neisseria dentiae	194197	S	9	1	10	0.00001
ERR6913277	Neisseria gonorrhoeae	485	S	9	5	14	0.00001
ERR6913277	Neisseria animalis	492	S	7	0	7	0.00001
ERR6913277	Eikenella corrodens	539	S	254	144	398	0.00032
ERR6913277	Eikenella exigua	2528037	S	14	6	20	0.00002
ERR6913277	Aquella oligotrophica	2067065	S	103	2	105	0.00009
ERR6913277	Simonsiella muelleri	72	S	69	9	78	0.00006
ERR6913277	Morococcus cerebrosus	1056807	S	13	118	131	0.00011
ERR6913277	Alysiella filiformis	194196	S	9	1	10	0.00001
ERR6913277	Wielerella bovis	2917790	S	10	1	11	0.00001
ERR6913277	Paralysiella testudinis	2809020	S	6	1	7	0.00001
ERR6913277	Conchiformibius steedae	153493	S	5	0	5	0.00000
ERR6913277	Snodgrassella alvi	1196083	S	5	0	5	0.00000
ERR6913277	Chromobacterium sp. ATCC 53434	2059672	S	7	9	16	0.00001
ERR6913277	Aquaspirillum sp. LM1	1938604	S	7	3	10	0.00001
ERR6913277	Lautropia mirabilis	47671	S	1923	246	2169	0.00176
ERR6913277	Burkholderia cenocepacia	95486	S	49	60	109	0.00009
ERR6913277	Burkholderia vietnamiensis	60552	S	21	21	42	0.00003
ERR6913277	Burkholderia multivorans	87883	S	20	4	24	0.00002
ERR6913277	Burkholderia pseudomallei	28450	S	14	802	816	0.00066
ERR6913277	Burkholderia mallei	13373	S	5	23	28	0.00002
ERR6913277	Burkholderia thailandensis	57975	S	5	404	409	0.00033
ERR6913277	Cupriavidus taiwanensis	164546	S	13	14	27	0.00002
ERR6913277	Cupriavidus necator	106590	S	10	7	17	0.00001
ERR6913277	Cupriavidus metallidurans	119219	S	10	2	12	0.00001
ERR6913277	Cupriavidus pauculus	82633	S	8	2	10	0.00001
ERR6913277	Polynucleobacter necessarius	576610	S	9	5	14	0.00001
ERR6913277	Polynucleobacter asymbioticus	576611	S	5	2	7	0.00001
ERR6913277	Ralstonia solanacearum	305	S	8	26	34	0.00003
ERR6913277	Ralstonia mannitolilytica	105219	S	7	8	15	0.00001
ERR6913277	Caballeronia sp. TF1N1	2878153	S	5	3	8	0.00001
ERR6913277	Ephemeroptericola cinctiostellae	2268024	S	7	0	7	0.00001
ERR6913277	Polaromonas naphthalenivorans	216465	S	157	161	318	0.00026
ERR6913277	Polaromonas sp. JS666	296591	S	9	27	36	0.00003
ERR6913277	Polaromonas vacuolata	37448	S	9	9	18	0.00001
ERR6913277	Acidovorax sp. KKS102	358220	S	11	22	33	0.00003
ERR6913277	Acidovorax sp. HDW3	2714923	S	7	7	14	0.00001
ERR6913277	Acidovorax sp. 1608163	2478662	S	6	6	12	0.00001
ERR6913277	Acidovorax sp. YS12	2738413	S	6	10	16	0.00001
ERR6913277	Acidovorax sp. 5MLIR	2949090	S	6	5	11	0.00001
ERR6913277	Acidovorax sp. RAC01	1842533	S	5	7	12	0.00001
ERR6913277	Acidovorax sp. JMULE5	2518343	S	5	7	12	0.00001
ERR6913277	Acidovorax temperans	80878	S	23	50	73	0.00006
ERR6913277	Acidovorax antarcticus	2743470	S	16	17	33	0.00003
ERR6913277	Acidovorax carolinensis	553814	S	14	36	50	0.00004
ERR6913277	Acidovorax radicis	758826	S	10	9	19	0.00002
ERR6913277	Ottowia sp. oral taxon 894	1658672	S	150	46	196	0.00016
ERR6913277	Ottowia testudinis	2816950	S	7	4	11	0.00001
ERR6913277	Comamonas testosteroni	285	S	47	78	125	0.00010
ERR6913277	Comamonas sp. B21-038	2918299	S	18	8	26	0.00002
ERR6913277	Comamonas sp. NLF-7-7	2597701	S	9	11	20	0.00002
ERR6913277	Comamonas sp. Y33R10-2	2853257	S	6	1	7	0.00001
ERR6913277	Comamonas fluminis	2796366	S	9	4	13	0.00001
ERR6913277	Comamonas thiooxydans	363952	S	7	10	17	0.00001
ERR6913277	Comamonas kerstersii	225992	S	6	2	8	0.00001
ERR6913277	Comamonas piscis	1562974	S	5	1	6	0.00000
ERR6913277	Variovorax sp. HW608	1034889	S	10	6	16	0.00001
ERR6913277	Variovorax sp. PAMC26660	2762322	S	7	8	15	0.00001
ERR6913277	Variovorax sp. 38R	2774875	S	5	14	19	0.00002
ERR6913277	Variovorax sp. RA8	662548	S	5	20	25	0.00002
ERR6913277	Variovorax paradoxus	34073	S	24	27	51	0.00004
ERR6913277	Rhodoferax sp. AJA081-3	2752316	S	14	6	20	0.00002
ERR6913277	Rhodoferax sp. BAB1	2741720	S	11	10	21	0.00002
ERR6913277	Rhodoferax sp. MIZ03	2798804	S	7	1	8	0.00001
ERR6913277	Rhodoferax antarcticus	81479	S	14	4	18	0.00001
ERR6913277	Rhodoferax ferrireducens	192843	S	10	3	13	0.00001
ERR6913277	Rhodoferax koreense	1842727	S	8	6	14	0.00001
ERR6913277	Rhodoferax sediminis	2509614	S	8	5	13	0.00001
ERR6913277	Rhodoferax aquaticus	2527691	S	8	2	10	0.00001
ERR6913277	Rhodoferax saidenbachensis	1484693	S	5	3	8	0.00001
ERR6913277	Hydrogenophaga sp. PBC	795665	S	10	9	19	0.00002
ERR6913277	Hydrogenophaga sp. YM1	2806262	S	8	7	15	0.00001
ERR6913277	Hydrogenophaga sp. SL48	2806347	S	7	4	11	0.00001
ERR6913277	Hydrogenophaga sp. NH-16	2184519	S	6	23	29	0.00002
ERR6913277	Hydrogenophaga sp. PAMC20947	2565558	S	6	1	7	0.00001
ERR6913277	Hydrogenophaga sp. BPS33	2651974	S	6	4	10	0.00001
ERR6913277	Hydrogenophaga sp. PBL-H3	434010	S	5	5	10	0.00001
ERR6913277	Hydrogenophaga crocea	2716225	S	6	6	12	0.00001
ERR6913277	Limnohabitans sp. 103DPR2	1678129	S	36	16	52	0.00004
ERR6913277	Limnohabitans sp. 63ED37-2	1678128	S	20	13	33	0.00003
ERR6913277	Diaphorobacter ruginosibacter	1715720	S	13	9	22	0.00002
ERR6913277	Diaphorobacter sp. HDW4B	2714925	S	6	3	9	0.00001
ERR6913277	Diaphorobacter aerolatus	1288495	S	6	6	12	0.00001
ERR6913277	Delftia lacustris	558537	S	8	57	65	0.00005
ERR6913277	Delftia acidovorans	80866	S	7	26	33	0.00003
ERR6913277	Curvibacter sp. AEP1-3	1844971	S	32	8	40	0.00003
ERR6913277	Simplicispira suum	2109915	S	24	17	41	0.00003
ERR6913277	Ramlibacter tataouinensis	94132	S	13	9	22	0.00002
ERR6913277	Alicycliphilus denitrificans	179636	S	13	77	90	0.00007
ERR6913277	Candidatus Symbiobacter mobilis	1436290	S	12	0	12	0.00001
ERR6913277	Melaminivora suipulveris	2109913	S	7	14	21	0.00002
ERR6913277	Hylemonella gracilis	80880	S	5	2	7	0.00001
ERR6913277	Collimonas fungivorans	158899	S	80	84	164	0.00013
ERR6913277	Collimonas arenae	279058	S	69	39	108	0.00009
ERR6913277	Collimonas pratensis	279113	S	23	24	47	0.00004
ERR6913277	Janthinobacterium sp. HH102	1537274	S	16	55	71	0.00006
ERR6913277	Janthinobacterium sp. 1_2014MBL_MicDiv	1644131	S	12	15	27	0.00002
ERR6913277	Janthinobacterium sp. PAMC25594	2861284	S	8	14	22	0.00002
ERR6913277	Janthinobacterium sp. LM6	1938606	S	7	12	19	0.00002
ERR6913277	Janthinobacterium svalbardensis	368607	S	13	23	36	0.00003
ERR6913277	Janthinobacterium lividum	29581	S	12	56	68	0.00006
ERR6913277	Janthinobacterium agaricidamnosum	55508	S	8	24	32	0.00003
ERR6913277	Janthinobacterium tructae	2590869	S	6	10	16	0.00001
ERR6913277	Massilia sp. NP310	2861282	S	24	26	50	0.00004
ERR6913277	Massilia sp. LPB0304	2769491	S	6	4	10	0.00001
ERR6913277	Massilia sp. WG5	1707785	S	5	3	8	0.00001
ERR6913277	Massilia sp. H6	2970464	S	5	2	7	0.00001
ERR6913277	Massilia oculi	945844	S	12	12	24	0.00002
ERR6913277	Pseudoduganella flava	871742	S	5	7	12	0.00001
ERR6913277	Undibacterium parvum	401471	S	34	4	38	0.00003
ERR6913277	Alcaligenes faecalis	511	S	61	34	95	0.00008
ERR6913277	Alcaligenes sp. SORT26	2813780	S	6	7	13	0.00001
ERR6913277	Achromobacter xylosoxidans	85698	S	10	23	33	0.00003
ERR6913277	Pigmentiphaga sp. H8	2488560	S	7	1	8	0.00001
ERR6913277	Oligella ureolytica	90244	S	6	0	6	0.00000
ERR6913277	Schlegelella aquatica	376175	S	54	23	77	0.00006
ERR6913277	Sphaerotilus sulfidivorans	639200	S	11	5	16	0.00001
ERR6913277	Sphaerotilus sp. FB-5	2914710	S	7	3	10	0.00001
ERR6913277	Caldimonas thermodepolymerans	215580	S	9	5	14	0.00001
ERR6913277	Aquincola tertiaricarbonis	391953	S	8	2	10	0.00001
ERR6913277	Rubrivivax gelatinosus	28068	S	6	2	8	0.00001
ERR6913277	Ideonella dechloratans	36863	S	6	3	9	0.00001
ERR6913277	Rhizobacter sp. AJA081-3	2753607	S	9	5	14	0.00001
ERR6913277	Aquabacterium olei	1296669	S	5	1	6	0.00000
ERR6913277	Aquabacterium sp. J223	2898431	S	5	2	7	0.00001
ERR6913277	Paucibacter sp. KCTC 42545	1768242	S	9	2	11	0.00001
ERR6913277	Xylophilus rhododendri	2697032	S	8	3	11	0.00001
ERR6913277	Tepidimonas taiwanensis	307486	S	8	3	11	0.00001
ERR6913277	Leptothrix cholodnii	34029	S	6	3	9	0.00001
ERR6913277	Dechloromonas denitrificans	281362	S	17	6	23	0.00002
ERR6913277	Dechloromonas sp. A34	447588	S	7	1	8	0.00001
ERR6913277	Dechloromonas sp. TW-R-39-2	2654218	S	5	4	9	0.00001
ERR6913277	Ferribacterium limneticum	76259	S	30	5	35	0.00003
ERR6913277	Quatrionicoccus australiensis	138118	S	6	1	7	0.00001
ERR6913277	Azospira restricta	404405	S	6	3	9	0.00001
ERR6913277	Azospira sp. I09	1765049	S	5	7	12	0.00001
ERR6913277	Azospira inquinata	2785627	S	5	0	5	0.00000
ERR6913277	Parazoarcus communis	41977	S	5	3	8	0.00001
ERR6913277	Fluviibacter phosphoraccumulans	1751046	S	10	0	10	0.00001
ERR6913277	Methylotenera versatilis	1055487	S	12	8	20	0.00002
ERR6913277	Candidatus Methylopumilus turicensis	1581680	S	8	7	15	0.00001
ERR6913277	Sulfuritalea hydrogenivorans	748811	S	5	3	8	0.00001
ERR6913277	Sulfuriferula nivalis	2675298	S	7	1	8	0.00001
ERR6913277	Casimicrobium huifangae	2591109	S	6	0	6	0.00000
ERR6913277	Candidatus Nasuia deltocephalinicola	1160784	S	5	0	5	0.00000
ERR6913277	Ferrovum myxofaciens	416213	S	5	0	5	0.00000
ERR6913277	Acinetobacter lwoffii	28090	S	470	575	1045	0.00085
ERR6913277	Acinetobacter sp. SCLZS86	2908637	S	92	63	155	0.00013
ERR6913277	Acinetobacter sp. WCHA45	2004644	S	22	16	38	0.00003
ERR6913277	Acinetobacter sp. SWBY1	2079596	S	19	37	56	0.00005
ERR6913277	Acinetobacter sp. CS-2	2798861	S	17	3	20	0.00002
ERR6913277	Acinetobacter sp. 10FS3-1	2563897	S	13	4	17	0.00001
ERR6913277	Acinetobacter sp. NEB149	2725684	S	13	48	61	0.00005
ERR6913277	Acinetobacter sp. WY4	2708348	S	13	25	38	0.00003
ERR6913277	Acinetobacter sp. Z1	2953738	S	8	0	8	0.00001
ERR6913277	Acinetobacter sp. C16S1	2609668	S	7	2	9	0.00001
ERR6913277	Acinetobacter sp. TR11	3003393	S	6	15	21	0.00002
ERR6913277	Acinetobacter sp. TR3	3003392	S	6	15	21	0.00002
ERR6913277	Acinetobacter sp. FDAARGOS_724	2545797	S	5	22	27	0.00002
ERR6913277	Acinetobacter sp. NEB 394	2743575	S	5	11	16	0.00001
ERR6913277	Acinetobacter sp. TTH0-4	1646498	S	5	0	5	0.00000
ERR6913277	Acinetobacter sp. NyZ410	2929509	S	5	3	8	0.00001
ERR6913277	Acinetobacter towneri	202956	S	114	139	253	0.00021
ERR6913277	Acinetobacter junii	40215	S	111	20	131	0.00011
ERR6913277	Acinetobacter baumannii	470	S	60	337	397	0.00032
ERR6913277	Acinetobacter pittii	48296	S	20	23	43	0.00003
ERR6913277	Acinetobacter seifertii	1530123	S	6	1	7	0.00001
ERR6913277	Acinetobacter johnsonii	40214	S	80	68	148	0.00012
ERR6913277	Acinetobacter schindleri	108981	S	78	21	99	0.00008
ERR6913277	Acinetobacter indicus	756892	S	37	6	43	0.00003
ERR6913277	Acinetobacter lanii	2715163	S	35	1	36	0.00003
ERR6913277	Acinetobacter radioresistens	40216	S	21	1	22	0.00002
ERR6913277	Acinetobacter ursingii	108980	S	17	21	38	0.00003
ERR6913277	Acinetobacter pseudolwoffii	2053287	S	15	16	31	0.00003
ERR6913277	Acinetobacter variabilis	70346	S	14	15	29	0.00002
ERR6913277	Acinetobacter portensis	1839785	S	10	2	12	0.00001
ERR6913277	Acinetobacter haemolyticus	29430	S	8	2	10	0.00001
ERR6913277	Acinetobacter bereziniae	106648	S	8	8	16	0.00001
ERR6913277	Acinetobacter dispersus	70348	S	8	1	9	0.00001
ERR6913277	Acinetobacter wanghuae	2662362	S	6	0	6	0.00000
ERR6913277	Acinetobacter soli	487316	S	6	0	6	0.00000
ERR6913277	Acinetobacter larvae	1789224	S	6	0	6	0.00000
ERR6913277	Acinetobacter tandoii	202954	S	5	0	5	0.00000
ERR6913277	Acinetobacter guillouiae	106649	S	5	3	8	0.00001
ERR6913277	Moraxella osloensis	34062	S	2363	110	2473	0.00201
ERR6913277	Moraxella nonliquefaciens	478	S	15	2	17	0.00001
ERR6913277	Psychrobacter sp. DAB_AL43B	1028416	S	9	2	11	0.00001
ERR6913277	Psychrobacter sp. P11F6	1699621	S	6	11	17	0.00001
ERR6913277	Psychrobacter sanguinis	861445	S	27	13	40	0.00003
ERR6913277	Psychrobacter arenosus	256326	S	5	0	5	0.00000
ERR6913277	Aquirhabdus parva	2283318	S	45	0	45	0.00004
ERR6913277	Haemophilus parainfluenzae	729	S	890	344	1234	0.00100
ERR6913277	Haemophilus influenzae	727	S	21	52	73	0.00006
ERR6913277	Haemophilus haemolyticus	726	S	9	12	21	0.00002
ERR6913277	[Haemophilus] ducreyi	730	S	7	0	7	0.00001
ERR6913277	Haemophilus parahaemolyticus	735	S	5	1	6	0.00000
ERR6913277	Aggregatibacter sp. oral taxon 513	712150	S	148	182	330	0.00027
ERR6913277	Aggregatibacter sp. 2125159857	2820817	S	139	70	209	0.00017
ERR6913277	Aggregatibacter sp. Marseille-P9115	2866570	S	108	88	196	0.00016
ERR6913277	Aggregatibacter segnis	739	S	60	56	116	0.00009
ERR6913277	Aggregatibacter aphrophilus	732	S	59	25	84	0.00007
ERR6913277	Aggregatibacter actinomycetemcomitans	714	S	15	5	20	0.00002
ERR6913277	Pasteurella multocida	747	S	33	140	173	0.00014
ERR6913277	Pseudomonas sp. NIBR-H-19	2901380	S	20	18	38	0.00003
ERR6913277	Pseudomonas sp. TCU-HL1	1856685	S	7	3	10	0.00001
ERR6913277	Pseudomonas sp. GOM7	2998079	S	6	2	8	0.00001
ERR6913277	Pseudomonas sp. BSw22131	3002903	S	5	0	5	0.00000
ERR6913277	Pseudomonas sp. J452	2898441	S	5	2	7	0.00001
ERR6913277	Pseudomonas fluorescens	294	S	62	62	124	0.00010
ERR6913277	Pseudomonas synxantha	47883	S	7	3	10	0.00001
ERR6913277	Pseudomonas azotoformans	47878	S	5	6	11	0.00001
ERR6913277	Pseudomonas aeruginosa	287	S	26	170	196	0.00016
ERR6913277	Pseudomonas alcaligenes	43263	S	5	1	6	0.00000
ERR6913277	Pseudomonas syringae	317	S	20	23	43	0.00003
ERR6913277	Pseudomonas putida	303	S	24	29	53	0.00004
ERR6913277	Pseudomonas fulva	47880	S	5	6	11	0.00001
ERR6913277	Pseudomonas fragi	296	S	25	16	41	0.00003
ERR6913277	Pseudomonas lundensis	86185	S	6	0	6	0.00000
ERR6913277	Pseudomonas psychrotolerans	237610	S	10	2	12	0.00001
ERR6913277	Pseudomonas psychrophila	122355	S	8	1	9	0.00001
ERR6913277	Pseudomonas simiae	321846	S	5	1	6	0.00000
ERR6913277	Stutzerimonas stutzeri	316	S	14	14	28	0.00002
ERR6913277	Permianibacter aggregans	1510150	S	16	0	16	0.00001
ERR6913277	Marinobacter salinus	1874317	S	5	2	7	0.00001
ERR6913277	Xanthomonas campestris	339	S	291	83	374	0.00030
ERR6913277	Xanthomonas translucens	343	S	7	3	10	0.00001
ERR6913277	Stenotrophomonas maltophilia	40324	S	50	46	96	0.00008
ERR6913277	Stenotrophomonas sp. LM091	1904944	S	19	4	23	0.00002
ERR6913277	Stenotrophomonas sp. 169	2770322	S	5	0	5	0.00000
ERR6913277	Stenotrophomonas rhizophila	216778	S	9	1	10	0.00001
ERR6913277	Stenotrophomonas acidaminiphila	128780	S	5	6	11	0.00001
ERR6913277	Luteimonas sp. YGD11-2	2508168	S	45	12	57	0.00005
ERR6913277	Luteimonas sp. MC1750	2799326	S	16	3	19	0.00002
ERR6913277	Luteimonas sp. MC1825	2761107	S	6	1	7	0.00001
ERR6913277	Luteimonas granuli	1176533	S	15	2	17	0.00001
ERR6913277	Lysobacter oculi	2698682	S	22	13	35	0.00003
ERR6913277	Lysobacter sp. TY2-98	2290922	S	5	2	7	0.00001
ERR6913277	Lysobacter maris	1605891	S	8	10	18	0.00001
ERR6913277	Pseudoxanthomonas suwonensis	314722	S	16	2	18	0.00001
ERR6913277	Pseudoxanthomonas mexicana	128785	S	6	3	9	0.00001
ERR6913277	Pseudoxanthomonas sp. X-1	2571115	S	5	0	5	0.00000
ERR6913277	Thermomonas aquatica	2202149	S	6	2	8	0.00001
ERR6913277	Thermomonas brevis	215691	S	5	2	7	0.00001
ERR6913277	Thermomonas carbonis	1463158	S	5	0	5	0.00000
ERR6913277	Klebsiella pneumoniae	573	S	18	298	316	0.00026
ERR6913277	Klebsiella quasipneumoniae	1463165	S	13	6	19	0.00002
ERR6913277	Klebsiella grimontii	2058152	S	9	12	21	0.00002
ERR6913277	Klebsiella variicola	244366	S	7	9	16	0.00001
ERR6913277	Escherichia coli	562	S	42	439	481	0.00039
ERR6913277	Salmonella enterica	28901	S	31	710	741	0.00060
ERR6913277	Candidatus Mikella endobia	1778264	S	5	0	5	0.00000
ERR6913277	Plesiomonas shigelloides	703	S	5	0	5	0.00000
ERR6913277	Candidatus Ishikawaella capsulata	168169	S	5	0	5	0.00000
ERR6913277	Pantoea agglomerans	549	S	31	6	37	0.00003
ERR6913277	Pantoea eucrina	472693	S	16	0	16	0.00001
ERR6913277	Candidatus Pantoea carbekii	1235990	S	5	0	5	0.00000
ERR6913277	Buchnera aphidicola	9	S	22	0	22	0.00002
ERR6913277	Kalamiella piersonii	2364647	S	7	0	7	0.00001
ERR6913277	Duffyella gerundensis	1619313	S	6	0	6	0.00000
ERR6913277	Serratia marcescens	615	S	7	8	15	0.00001
ERR6913277	Rahnella aquatilis	34038	S	8	4	12	0.00001
ERR6913277	Ewingella americana	41202	S	11	0	11	0.00001
ERR6913277	Nissabacter sp. SGAir0207	2126321	S	5	0	5	0.00000
ERR6913277	Arsenophonus endosymbiont of Aphis craccivora	1231049	S	5	6	11	0.00001
ERR6913277	Morganella morganii	582	S	6	18	24	0.00002
ERR6913277	Sodalis ligni	2697027	S	7	0	7	0.00001
ERR6913277	Halomonas sp. JS92-SW72	2306583	S	117	35	152	0.00012
ERR6913277	Halomonas sp. GFAJ-1	1118153	S	7	0	7	0.00001
ERR6913277	Bacterioplanes sanyensis	1249553	S	8	0	8	0.00001
ERR6913277	Venatorbacter cucullus	2661630	S	7	0	7	0.00001
ERR6913277	Alcanivorax sp. N3-2A	2014542	S	5	5	10	0.00001
ERR6913277	Ketobacter alkanivorans	1917421	S	5	1	6	0.00000
ERR6913277	Endozoicomonas montiporae	1027273	S	5	0	5	0.00000
ERR6913277	Cardiobacterium hominis	2718	S	142	30	172	0.00014
ERR6913277	Cardiobacterium sp. Marseille-Q4385	2866573	S	13	2	15	0.00001
ERR6913277	Shewanella baltica	62322	S	6	3	9	0.00001
ERR6913277	Shewanella violacea	60217	S	6	0	6	0.00000
ERR6913277	Shewanella algae	38313	S	5	1	6	0.00000
ERR6913277	Shewanella putrefaciens	24	S	5	4	9	0.00001
ERR6913277	Alteromonas macleodii	28108	S	9	2	11	0.00001
ERR6913277	Agarivorans gilvus	680279	S	12	0	12	0.00001
ERR6913277	Saccharobesus litoralis	2172099	S	5	0	5	0.00000
ERR6913277	Cognaticolwellia beringensis	1967665	S	10	1	11	0.00001
ERR6913277	Rheinheimera sp. F8	1763998	S	14	9	23	0.00002
ERR6913277	Rheinheimera sp. D18	2545632	S	11	2	13	0.00001
ERR6913277	Acidihalobacter ferrooxydans	1765967	S	12	3	15	0.00001
ERR6913277	Thioalkalivibrio sulfidiphilus	1033854	S	7	2	9	0.00001
ERR6913277	Guyparkeria halophila	47960	S	14	1	15	0.00001
ERR6913277	Granulosicoccus antarcticus	437505	S	7	0	7	0.00001
ERR6913277	Vibrio harveyi	669	S	5	19	24	0.00002
ERR6913277	Vibrio parahaemolyticus	670	S	5	2	7	0.00001
ERR6913277	Vibrio cholerae	666	S	5	7	12	0.00001
ERR6913277	Thiomicrospira cyclica	147268	S	9	6	15	0.00001
ERR6913277	Piscirickettsia salmonis	1238	S	13	0	13	0.00001
ERR6913277	Thiosulfatimonas sediminis	2675054	S	9	8	17	0.00001
ERR6913277	Beggiatoa leptomitoformis	288004	S	12	0	12	0.00001
ERR6913277	Agarilytica rhodophyticola	1737490	S	37	3	40	0.00003
ERR6913277	Aeromonas salmonicida	645	S	17	4	21	0.00002
ERR6913277	Aeromonas dhakensis	196024	S	6	13	19	0.00002
ERR6913277	Aeromonas media	651	S	5	10	15	0.00001
ERR6913277	Legionella longbeachae	450	S	5	27	32	0.00003
ERR6913277	Methylobacter sp. S3L5C	2839024	S	9	14	23	0.00002
ERR6913277	Candidatus Endoriftia persephone	393765	S	17	2	19	0.00002
ERR6913277	Candidatus Nardonella dryophthoridicola	1971485	S	5	0	5	0.00000
ERR6913277	Solimonas sp. K1W22B-7	2303331	S	12	1	13	0.00001
ERR6913277	Sinimarinibacterium sp. NLF-5-8	2698684	S	5	0	5	0.00000
ERR6913277	Mesorhizobium terrae	2725666	S	192	203	395	0.00032
ERR6913277	Mesorhizobium australicum	536018	S	9	61	70	0.00006
ERR6913277	Bradyrhizobium sp. SK17	2057741	S	100	63	163	0.00013
ERR6913277	Bradyrhizobium sp. I71	2590772	S	14	20	34	0.00003
ERR6913277	Bradyrhizobium sp. 200	2782665	S	11	4	15	0.00001
ERR6913277	Bradyrhizobium sp. CCBAU 051011	858422	S	11	5	16	0.00001
ERR6913277	Bradyrhizobium sp. 170	2782641	S	9	4	13	0.00001
ERR6913277	Bradyrhizobium sp. BTAi1	288000	S	8	2	10	0.00001
ERR6913277	Bradyrhizobium sp. CCBAU 51765	1325102	S	8	12	20	0.00002
ERR6913277	Bradyrhizobium sp. CCGE-LA001	1223566	S	7	6	13	0.00001
ERR6913277	Bradyrhizobium sp. CCBAU 51753	1325100	S	5	2	7	0.00001
ERR6913277	Bradyrhizobium erythrophlei	1437360	S	8	1	9	0.00001
ERR6913277	Bradyrhizobium diazoefficiens	1355477	S	8	23	31	0.00003
ERR6913277	Bradyrhizobium oligotrophicum	44255	S	7	2	9	0.00001
ERR6913277	Bradyrhizobium genosp. L	83637	S	6	2	8	0.00001
ERR6913277	Bradyrhizobium icense	1274631	S	6	2	8	0.00001
ERR6913277	Bradyrhizobium sediminis	2840469	S	5	2	7	0.00001
ERR6913277	Bradyrhizobium quebecense	2748629	S	5	7	12	0.00001
ERR6913277	Bradyrhizobium paxllaeri	190148	S	5	2	7	0.00001
ERR6913277	Rhodopseudomonas palustris	1076	S	11	4	15	0.00001
ERR6913277	Rhodopseudomonas boonkerdii	475937	S	7	4	11	0.00001
ERR6913277	Rhodopseudomonas sp. P2A-2r	2991972	S	5	2	7	0.00001
ERR6913277	Variibacter gotjawalensis	1333996	S	6	0	6	0.00000
ERR6913277	Methylobacterium sp. FF17	2984843	S	98	36	134	0.00011
ERR6913277	Methylobacterium sp. WL1	2603276	S	7	6	13	0.00001
ERR6913277	Methylobacterium nodulans	114616	S	6	2	8	0.00001
ERR6913277	Methylobacterium brachiatum	269660	S	6	9	15	0.00001
ERR6913277	Methylobacterium aquaticum	270351	S	6	14	20	0.00002
ERR6913277	Methylobacterium durans	2202825	S	6	2	8	0.00001
ERR6913277	Methylorubrum populi	223967	S	18	24	42	0.00003
ERR6913277	Methylorubrum extorquens	408	S	7	22	29	0.00002
ERR6913277	Rhizobium pusense	648995	S	13	41	54	0.00004
ERR6913277	Rhizobium leguminosarum	384	S	8	18	26	0.00002
ERR6913277	Agrobacterium tumefaciens	358	S	15	6	21	0.00002
ERR6913277	Agrobacterium larrymoorei	160699	S	5	0	5	0.00000
ERR6913277	Pararhizobium sp. BT-229	2986923	S	5	0	5	0.00000
ERR6913277	Shinella sp. XGS7	2877941	S	8	3	11	0.00001
ERR6913277	Shinella zoogloeoides	352475	S	5	6	11	0.00001
ERR6913277	Candidatus Liberibacter solanacearum	556287	S	6	0	6	0.00000
ERR6913277	Hyphomicrobium sp. DMF-1	3019544	S	9	7	16	0.00001
ERR6913277	Hyphomicrobium sp. MC1	717785	S	8	4	12	0.00001
ERR6913277	Hyphomicrobium nitrativorans	1427356	S	9	9	18	0.00001
ERR6913277	Hyphomicrobium denitrificans	53399	S	7	3	10	0.00001
ERR6913277	Xanthobacter dioxanivorans	2528964	S	15	13	28	0.00002
ERR6913277	Ancylobacter sp. SL191	2995166	S	8	3	11	0.00001
ERR6913277	Aquabacter sp. L1I39	2820278	S	7	1	8	0.00001
ERR6913277	Devosia sp. JXJ CY 41	2917991	S	6	2	8	0.00001
ERR6913277	Devosia rhizoryzae	2774137	S	5	1	6	0.00000
ERR6913277	Devosia salina	2860336	S	5	5	10	0.00001
ERR6913277	Maritalea myrionectae	454601	S	14	0	14	0.00001
ERR6913277	Candidatus Hodgkinia cicadicola	573658	S	30	0	30	0.00002
ERR6913277	Nordella sp. HKS 07	2712222	S	5	0	5	0.00000
ERR6913277	Brucella intermedia	94625	S	7	8	15	0.00001
ERR6913277	Methylocystis parvus	134	S	5	4	9	0.00001
ERR6913277	Chenggangzhangella methanolivorans	1437009	S	7	2	9	0.00001
ERR6913277	Bosea sp. PAMC 26642	1792307	S	6	2	8	0.00001
ERR6913277	Bartonella harrusi	2961895	S	5	6	11	0.00001
ERR6913277	Aureimonas altamirensis	370622	S	5	4	9	0.00001
ERR6913277	Methylocella silvestris	199596	S	8	3	11	0.00001
ERR6913277	Methylocella tundrae	227605	S	5	1	6	0.00000
ERR6913277	Chelatococcus daeguensis	444444	S	5	2	7	0.00001
ERR6913277	Paracoccus sanguinis	1545044	S	321	87	408	0.00033
ERR6913277	Paracoccus yeei	147645	S	187	153	340	0.00028
ERR6913277	Paracoccus sp. MC1862	2760307	S	80	11	91	0.00007
ERR6913277	Paracoccus sp. AK26	2589076	S	52	8	60	0.00005
ERR6913277	Paracoccus sp. Arc7-R13	2500532	S	8	8	16	0.00001
ERR6913277	Paracoccus sp. MA	2895796	S	5	2	7	0.00001
ERR6913277	Paracoccus marcusii	59779	S	27	19	46	0.00004
ERR6913277	Paracoccus contaminans	1945662	S	19	4	23	0.00002
ERR6913277	Paracoccus everestensis	2903900	S	16	2	18	0.00001
ERR6913277	Paracoccus stylophorae	659350	S	13	4	17	0.00001
ERR6913277	Paracoccus liaowanqingii	2560053	S	9	1	10	0.00001
ERR6913277	Paracoccus kondratievae	135740	S	9	1	10	0.00001
ERR6913277	Paracoccus fistulariae	658446	S	7	1	8	0.00001
ERR6913277	Paracoccus aminovorans	34004	S	7	1	8	0.00001
ERR6913277	Paracoccus aminophilus	34003	S	7	0	7	0.00001
ERR6913277	Paracoccus pantotrophus	82367	S	6	2	8	0.00001
ERR6913277	Paracoccus suum	2259340	S	6	1	7	0.00001
ERR6913277	Gemmobacter fulva	2840474	S	11	3	14	0.00001
ERR6913277	Gemmobacter aquarius	2169400	S	8	2	10	0.00001
ERR6913277	Neotabrizicola shimadae	2807096	S	19	3	22	0.00002
ERR6913277	Pseudorhodobacter turbinis	2500533	S	18	1	19	0.00002
ERR6913277	Rhodobacter sp. CZR27	2033869	S	5	1	6	0.00000
ERR6913277	Rhodobacter capsulatus	1061	S	6	1	7	0.00001
ERR6913277	Rhodovulum sp. P5	1564506	S	8	3	11	0.00001
ERR6913277	Cereibacter sphaeroides	1063	S	5	6	11	0.00001
ERR6913277	Tabrizicola piscis	2494374	S	9	1	10	0.00001
ERR6913277	Thioclava electrotropha	1549850	S	7	1	8	0.00001
ERR6913277	Haematobacter massiliensis	195105	S	8	2	10	0.00001
ERR6913277	Pikeienuella piscinae	2748098	S	6	0	6	0.00000
ERR6913277	Frigidibacter mobilis	1335048	S	6	2	8	0.00001
ERR6913277	Abyssibius alkaniclasticus	2881234	S	5	0	5	0.00000
ERR6913277	Pukyongiella litopenaei	2605946	S	5	1	6	0.00000
ERR6913277	Fuscovulum blasticum	1075	S	5	0	5	0.00000
ERR6913277	Roseovarius indicus	540747	S	5	3	8	0.00001
ERR6913277	Brevundimonas naejangsanensis	588932	S	548	81	629	0.00051
ERR6913277	Brevundimonas sp. Bb-A	2560058	S	82	32	114	0.00009
ERR6913277	Brevundimonas sp. PAMC22021	2861285	S	56	5	61	0.00005
ERR6913277	Brevundimonas sp. BT-123	2986928	S	15	7	22	0.00002
ERR6913277	Brevundimonas sp. MF30-B	2561924	S	9	0	9	0.00001
ERR6913277	Brevundimonas sp. SL130	2995143	S	6	0	6	0.00000
ERR6913277	Brevundimonas sp. NIBR10	3015997	S	6	0	6	0.00000
ERR6913277	Brevundimonas sp. M20	2591463	S	5	0	5	0.00000
ERR6913277	Brevundimonas sp. AJA228-03	2752515	S	5	0	5	0.00000
ERR6913277	Brevundimonas albigilva	1312364	S	23	5	28	0.00002
ERR6913277	Brevundimonas diminuta	293	S	22	13	35	0.00003
ERR6913277	Brevundimonas pondensis	2774189	S	18	2	20	0.00002
ERR6913277	Brevundimonas vancanneytii	1325724	S	16	18	34	0.00003
ERR6913277	Brevundimonas vesicularis	41276	S	9	5	14	0.00001
ERR6913277	Brevundimonas mediterranea	74329	S	7	1	8	0.00001
ERR6913277	Brevundimonas subvibrioides	74313	S	5	0	5	0.00000
ERR6913277	Phenylobacterium zucineum	284016	S	19	3	22	0.00002
ERR6913277	Phenylobacterium sp. LH3H17	2903901	S	9	1	10	0.00001
ERR6913277	Phenylobacterium sp. NIBR 498073	3015177	S	6	0	6	0.00000
ERR6913277	Phenylobacterium parvum	2201350	S	7	0	7	0.00001
ERR6913277	Caulobacter sp. FWC26	69665	S	5	2	7	0.00001
ERR6913277	Caulobacter vibrioides	155892	S	7	3	10	0.00001
ERR6913277	Caulobacter segnis	88688	S	6	2	8	0.00001
ERR6913277	Sphingomonas sp. SUN019	2937788	S	10	6	16	0.00001
ERR6913277	Sphingomonas sp. NBWT7	2596913	S	9	11	20	0.00002
ERR6913277	Sphingomonas sp. CL5.1	2653203	S	8	10	18	0.00001
ERR6913277	Sphingomonas sp. MM-1	745310	S	8	26	34	0.00003
ERR6913277	Sphingomonas sp. SUN039	2937787	S	6	2	8	0.00001
ERR6913277	Sphingomonas sp. S2-65	2903960	S	5	4	9	0.00001
ERR6913277	Sphingomonas sp. PAMB00755	3012344	S	5	3	8	0.00001
ERR6913277	Sphingomonas sp. IC081	304378	S	5	63	68	0.00006
ERR6913277	Sphingomonas insulae	424800	S	8	11	19	0.00002
ERR6913277	Sphingomonas glaciei	2938948	S	7	3	10	0.00001
ERR6913277	Sphingomonas radiodurans	2890321	S	7	4	11	0.00001
ERR6913277	Sphingomonas aerolata	185951	S	6	8	14	0.00001
ERR6913277	Sphingomonas aliaeris	2759526	S	6	3	9	0.00001
ERR6913277	Sphingomonas lutea	1045317	S	6	2	8	0.00001
ERR6913277	Sphingomonas paucimobilis	13689	S	5	13	18	0.00001
ERR6913277	Sphingomonas panacisoli	1813879	S	5	3	8	0.00001
ERR6913277	Sphingomonas naphthae	1813468	S	5	8	13	0.00001
ERR6913277	Sphingobium sp. SYK-6	627192	S	6	6	12	0.00001
ERR6913277	Sphingobium sp. SCG-1	2072936	S	5	1	6	0.00000
ERR6913277	Sphingobium xenophagum	121428	S	8	23	31	0.00003
ERR6913277	Sphingopyxis sp. YF1	2482763	S	5	8	13	0.00001
ERR6913277	Sphingopyxis macrogoltabida	33050	S	7	12	19	0.00002
ERR6913277	Novosphingobium sp. EMRT-2	2571749	S	7	7	14	0.00001
ERR6913277	Novosphingobium decolorationis	2698673	S	7	8	15	0.00001
ERR6913277	Novosphingobium aromaticivorans	48935	S	6	8	14	0.00001
ERR6913277	Sphingorhabdus lacus	392610	S	8	0	8	0.00001
ERR6913277	Sphingorhabdus lutea	1913578	S	5	0	5	0.00000
ERR6913277	Hankyongella ginsenosidimutans	1763828	S	5	1	6	0.00000
ERR6913277	Erythrobacter aureus	2182384	S	6	3	9	0.00001
ERR6913277	Croceibacterium atlanticum	1267766	S	5	4	9	0.00001
ERR6913277	Roseomonas sp. S08	1750527	S	7	1	8	0.00001
ERR6913277	Roseomonas gilardii	257708	S	6	11	17	0.00001
ERR6913277	Komagataeibacter xylinus	28448	S	9	9	18	0.00001
ERR6913277	Sediminicoccus rosea	1225128	S	6	0	6	0.00000
ERR6913277	Oecophyllibacter saccharovorans	2558360	S	5	0	5	0.00000
ERR6913277	Neokomagataea tanensis	661191	S	5	0	5	0.00000
ERR6913277	Azospirillum oryzae	286727	S	5	11	16	0.00001
ERR6913277	Nitrospirillum amazonense	28077	S	6	1	7	0.00001
ERR6913277	Pararhodospirillum photometricum	1084	S	10	2	12	0.00001
ERR6913277	Candidatus Endolissoclinum faulkneri	1263979	S	5	-5	0	0.00000
ERR6913277	Tistrella mobilis	171437	S	5	1	6	0.00000
ERR6913277	Rickettsia endosymbiont of Oedothorax gibbosus	931099	S	8	14	22	0.00002
ERR6913277	Hirschia baltica	2724	S	11	0	11	0.00001
ERR6913277	Hydrogenophilus thermoluteolus	297	S	59	1	60	0.00005
ERR6913277	Fusobacterium nucleatum	851	S	700	421	1121	0.00091
ERR6913277	Fusobacterium hwasookii	1583098	S	19	41	60	0.00005
ERR6913277	Fusobacterium pseudoperiodonticum	2663009	S	12	8	20	0.00002
ERR6913277	Leptotrichia wadei	157687	S	289	110	399	0.00032
ERR6913277	Leptotrichia sp. oral taxon 212	712357	S	85	6	91	0.00007
ERR6913277	Leptotrichia sp. oral taxon 498	712368	S	29	10	39	0.00003
ERR6913277	Leptotrichia sp. oral taxon 218	712361	S	7	2	9	0.00001
ERR6913277	Leptotrichia buccalis	40542	S	67	21	88	0.00007
ERR6913277	Leptotrichia hongkongensis	554406	S	59	24	83	0.00007
ERR6913277	Leptotrichia hofstadii	157688	S	39	16	55	0.00004
ERR6913277	Leptotrichia trevisanii	109328	S	25	6	31	0.00003
ERR6913277	Leptotrichia shahii	157691	S	9	4	13	0.00001
ERR6913277	Streptobacillus moniliformis	34105	S	11	0	11	0.00001
ERR6913277	Treponema denticola	158	S	414	321	735	0.00060
ERR6913277	Treponema sp. OMZ 857	1643513	S	17	26	43	0.00003
ERR6913277	Treponema sp. OMZ 305	1659192	S	13	28	41	0.00003
ERR6913277	Treponema sp. OMZ 906	2563662	S	12	35	47	0.00004
ERR6913277	Treponema sp. OMZ 803	120682	S	10	29	39	0.00003
ERR6913277	Treponema sp. OMZ 838	1539298	S	9	29	38	0.00003
ERR6913277	Treponema sp. Marseille-Q4132	2766701	S	8	1	9	0.00001
ERR6913277	Treponema sp. OMZ 855	1643512	S	7	22	29	0.00002
ERR6913277	Treponema sp. B152	2749432	S	5	34	39	0.00003
ERR6913277	Treponema vincentii	69710	S	129	67	196	0.00016
ERR6913277	Treponema medium	58231	S	111	49	160	0.00013
ERR6913277	Treponema socranskii	53419	S	80	9	89	0.00007
ERR6913277	Treponema pallidum	160	S	42	101	143	0.00012
ERR6913277	Treponema putidum	221027	S	28	7	35	0.00003
ERR6913277	Treponema brennaborense	81028	S	13	0	13	0.00001
ERR6913277	Treponema primitia	88058	S	13	0	13	0.00001
ERR6913277	Treponema parvum	138851	S	8	0	8	0.00001
ERR6913277	Salinispira pacifica	1307761	S	12	0	12	0.00001
ERR6913277	Oceanispirochaeta crateris	2518645	S	7	0	7	0.00001
ERR6913277	Breznakiella homolactica	2798577	S	11	0	11	0.00001
ERR6913277	Leptospira kobayashii	1917830	S	9	21	30	0.00002
ERR6913277	Campylobacter rectus	203	S	150	1	151	0.00012
ERR6913277	Campylobacter gracilis	824	S	62	0	62	0.00005
ERR6913277	Campylobacter showae	204	S	38	0	38	0.00003
ERR6913277	Campylobacter sp. RM6914	1032243	S	14	13	27	0.00002
ERR6913277	Campylobacter concisus	199	S	28	0	28	0.00002
ERR6913277	Campylobacter curvus	200	S	9	0	9	0.00001
ERR6913277	Campylobacter jejuni	197	S	8	191	199	0.00016
ERR6913277	Campylobacter hominis	76517	S	7	0	7	0.00001
ERR6913277	Campylobacter canadensis	449520	S	6	0	6	0.00000
ERR6913277	Campylobacter ureolyticus	827	S	5	0	5	0.00000
ERR6913277	Arcobacter ellisii	913109	S	8	8	16	0.00001
ERR6913277	Arcobacter venerupis	1054033	S	5	2	7	0.00001
ERR6913277	Helicobacter pylori	210	S	20	95	115	0.00009
ERR6913277	Candidatus Sulfurimonas marisnigri	2740405	S	5	3	8	0.00001
ERR6913277	Sulfurospirillum diekertiae	1854492	S	6	0	6	0.00000
ERR6913277	Candidatus Nanosynbacter sp. HMT-352	2899133	S	274	57	331	0.00027
ERR6913277	Candidatus Nanosynbacter featherlites	2572088	S	34	5	39	0.00003
ERR6913277	Candidatus Nanosynbacter lyticus	2093824	S	15	6	21	0.00002
ERR6913277	Candidatus Saccharimonas aalborgensis	1332188	S	29	0	29	0.00002
ERR6913277	Candidatus Minimicrobia vallesae	2841264	S	40	18	58	0.00005
ERR6913277	Candidatus Mycosynbacter amalyticus	2665156	S	10	0	10	0.00001
ERR6913277	Candidatus Chromulinivorax destructor	2066483	S	11	0	11	0.00001
ERR6913277	Candidatus Absconditicoccus praedator	2735562	S	7	0	7	0.00001
ERR6913277	Gimesia aquarii	2527964	S	12	6	18	0.00001
ERR6913277	Planctomyces sp. SH-PL14	1632864	S	13	5	18	0.00001
ERR6913277	Fuerstiella marisgermanici	1891926	S	10	1	11	0.00001
ERR6913277	Planctopirus ephydatiae	2528019	S	5	3	8	0.00001
ERR6913277	Rubinisphaera brasiliensis	119	S	6	3	9	0.00001
ERR6913277	Calycomorphotria hydatis	2528027	S	5	1	6	0.00000
ERR6913277	Gemmata obscuriglobus	114	S	10	8	18	0.00001
ERR6913277	Limnoglobus roseus	2598579	S	16	3	19	0.00002
ERR6913277	Telmatocola sphagniphila	1123043	S	8	0	8	0.00001
ERR6913277	Urbifossiella limnaea	2528023	S	7	2	9	0.00001
ERR6913277	Pirellula staleyi	125	S	5	3	8	0.00001
ERR6913277	Thermogutta terrifontis	1331910	S	5	2	7	0.00001
ERR6913277	Tautonia plasticadhaerens	2527974	S	7	2	9	0.00001
ERR6913277	Aquisphaera giovannonii	406548	S	6	4	10	0.00001
ERR6913277	Humisphaera borealis	2807512	S	5	0	5	0.00000
ERR6913277	Luteolibacter sp. SL250	2995170	S	9	4	13	0.00001
ERR6913277	Luteolibacter ambystomatis	2824561	S	9	4	13	0.00001
ERR6913277	Verrucomicrobium spinosum	2736	S	20	7	27	0.00002
ERR6913277	Roseimicrobium sp. ORNL1	2711231	S	18	4	22	0.00002
ERR6913277	Sulfuriroseicoccus oceanibius	2707525	S	7	4	11	0.00001
ERR6913277	Akkermansia glycaniphila	1679444	S	9	10	19	0.00002
ERR6913277	Opitutus sp. GAS368	1882749	S	6	5	11	0.00001
ERR6913277	Ereboglobus luteus	1796921	S	7	1	8	0.00001
ERR6913277	Nibricoccus aquaticus	2576891	S	5	1	6	0.00000
ERR6913277	Ruficoccus sp. ZRK36	2866311	S	10	1	11	0.00001
ERR6913277	Parachlamydia acanthamoebae	83552	S	7	8	15	0.00001
ERR6913277	Chlamydia suis	83559	S	13	1	14	0.00001
ERR6913277	Kiritimatiella glycovorans	1307763	S	6	4	10	0.00001
ERR6913277	Fretibacterium fastidiosum	651822	S	55	2	57	0.00005
ERR6913277	Aminobacterium colombiense	81468	S	47	6	53	0.00004
ERR6913277	Thermovirga lienii	336261	S	51	9	60	0.00005
ERR6913277	Pyramidobacter piscolens	638849	S	23	9	32	0.00003
ERR6913277	Jonquetella anthropi	428712	S	7	3	10	0.00001
ERR6913277	Thermanaerovibrio acidaminovorans	81462	S	18	8	26	0.00002
ERR6913277	Cloacibacillus porcorum	1197717	S	13	1	14	0.00001
ERR6913277	Aminithiophilus ramosus	3029084	S	21	3	24	0.00002
ERR6913277	Polyangium aurulentum	2567896	S	10	10	20	0.00002
ERR6913277	Chondromyces crocatus	52	S	8	4	12	0.00001
ERR6913277	Pajaroellobacter abortibovis	1882918	S	5	0	5	0.00000
ERR6913277	Labilithrix luteola	1391654	S	16	6	22	0.00002
ERR6913277	Sandaracinus amylolyticus	927083	S	13	4	17	0.00001
ERR6913277	Nannocystis sp. fl3	2995304	S	14	1	15	0.00001
ERR6913277	Haliangium ochraceum	80816	S	7	0	7	0.00001
ERR6913277	Myxococcus stipitatus	83455	S	9	3	12	0.00001
ERR6913277	Archangium violaceum	83451	S	6	5	11	0.00001
ERR6913277	Desulfatibacillum aliphaticivorans	218208	S	5	6	11	0.00001
ERR6913277	Candidatus Koribacter versatilis	658062	S	11	4	15	0.00001
ERR6913277	Paludibaculum fermentans	1473598	S	14	0	14	0.00001
ERR6913277	Luteitalea pratensis	1855912	S	12	8	20	0.00002
ERR6913277	Luteitalea sp. TBR-22	2802971	S	5	4	9	0.00001
ERR6913277	Bdellovibrio sp. SKB1291214	1732569	S	6	6	12	0.00001
ERR6913277	Micavibrio aeruginosavorus	349221	S	10	-10	0	0.00000
ERR6913277	Halobacteriovorax sp. BALOs_7	2109558	S	7	0	7	0.00001
ERR6913277	Halobacteriovorax marinus	97084	S	5	0	5	0.00000
ERR6913277	Bacteriovorax stolpii	960	S	8	0	8	0.00001
ERR6913277	Pseudothermotoga thermarum	119394	S	11	1	12	0.00001
ERR6913277	Fervidobacterium nodosum	2424	S	5	1	6	0.00000
ERR6913277	Tepiditoga spiralis	2108365	S	6	3	9	0.00001
ERR6913277	Nitrospira moscoviensis	42253	S	5	9	14	0.00001
ERR6913277	Denitrovibrio acetiphilus	118000	S	5	0	5	0.00000
ERR6913277	Homo sapiens	9606	S	2464	88	2552	0.00207
ERR6913277	Malassezia restricta	76775	S	713	22	735	0.00060
ERR6913277	Sporisorium graminicola	280036	S	11	0	11	0.00001
ERR6913277	Rhizoctonia solani	456999	S	16	1	17	0.00001
ERR6913277	Marasmius oreades	181124	S	6	1	7	0.00001
ERR6913277	Psilocybe cubensis	181762	S	5	0	5	0.00000
ERR6913277	Puccinia striiformis	27350	S	17	12	29	0.00002
ERR6913277	Puccinia triticina	208348	S	13	1	14	0.00001
ERR6913277	Fusarium poae	36050	S	7	12	19	0.00002
ERR6913277	Fusarium fujikuroi	5127	S	8	7	15	0.00001
ERR6913277	Pochonia chlamydosporia	280754	S	11	4	15	0.00001
ERR6913277	Drechmeria coniospora	98403	S	8	4	12	0.00001
ERR6913277	Colletotrichum higginsianum	80884	S	13	10	23	0.00002
ERR6913277	Colletotrichum lupini	145971	S	8	2	10	0.00001
ERR6913277	Neurospora crassa	5141	S	13	6	19	0.00002
ERR6913277	Thermothielavioides terrestris	2587410	S	6	1	7	0.00001
ERR6913277	Botrytis cinerea	40559	S	13	1	14	0.00001
ERR6913277	Aspergillus luchuensis	1069201	S	6	3	9	0.00001
ERR6913277	Penicillium oxalicum	69781	S	6	6	12	0.00001
ERR6913277	Talaromyces rugulosus	121627	S	10	3	13	0.00001
ERR6913277	Cercospora beticola	122368	S	9	4	13	0.00001
ERR6913277	Fulvia fulva	5499	S	7	3	10	0.00001
ERR6913277	Ogataea parapolymorpha	1005962	S	23	7	30	0.00002
ERR6913277	Brettanomyces nanus	13502	S	8	5	13	0.00001
ERR6913277	Pichia kudriavzevii	4909	S	8	4	12	0.00001
ERR6913277	Saccharomyces cerevisiae	4932	S	5	3	8	0.00001
ERR6913277	Zygotorulaspora mrakii	42260	S	6	3	9	0.00001
ERR6913277	Schizosaccharomyces pombe	4896	S	38	4	42	0.00003
ERR6913277	Phaeodactylum tricornutum	2850	S	1410	72	1482	0.00120
ERR6913277	Thalassiosira pseudonana	35128	S	1192	101	1293	0.00105
ERR6913277	Plasmodium malariae	5858	S	27	3	30	0.00002
ERR6913277	Plasmodium vivax	5855	S	6	5	11	0.00001
ERR6913277	Plasmodium knowlesi	5850	S	5	5	10	0.00001
ERR6913277	Plasmodium sp. gorilla clade G2	880535	S	14	15	29	0.00002
ERR6913277	Plasmodium vinckei	5860	S	8	3	11	0.00001
ERR6913277	Plasmodium relictum	85471	S	10	2	12	0.00001
ERR6913277	Plasmodium coatneyi	208452	S	5	13	18	0.00001
ERR6913277	Babesia bigemina	5866	S	29	15	44	0.00004
ERR6913277	Babesia microti	5868	S	23	11	34	0.00003
ERR6913277	Babesia bovis	5865	S	14	10	24	0.00002
ERR6913277	Toxoplasma gondii	5811	S	37	49	86	0.00007
ERR6913277	Besnoitia besnoiti	94643	S	8	5	13	0.00001
ERR6913277	Cryptosporidium parvum	5807	S	44	4	48	0.00004
ERR6913277	Bigelowiella natans	227086	S	44	16	60	0.00005
ERR6913277	Guillardia theta	55529	S	80	19	99	0.00008
ERR6913277	Cryptomonas paramecium	2898	S	67	5	72	0.00006
ERR6913277	Hemiselmis andersenii	464988	S	7	0	7	0.00001
ERR6913277	Leishmania mexicana	5665	S	16	22	38	0.00003
ERR6913277	Leishmania panamensis	5679	S	5	15	20	0.00002
ERR6913277	Trypanosoma brucei	5691	S	10	9	19	0.00002
ERR6913277	Dictyostelium discoideum	44689	S	23	1	24	0.00002
ERR6913277	Trichomonas vaginalis	5722	S	14	0	14	0.00001
ERR6913277	Natronomonas moolapensis	416273	S	7	8	15	0.00001
ERR6913277	Halobacterium hubeiense	1407499	S	5	16	21	0.00002
ERR6913277	Streptococcus phage YMC-2011	1051631	S	226	4	230	0.00019
ERR6913277	Streptococcus phage PH10	644007	S	10	0	10	0.00001
ERR6913277	Streptococcus phage 5093	646413	S	7	1	8	0.00001
ERR6913277	Streptococcus phage CHPC663	2365039	S	13	8	21	0.00002
ERR6913277	Streptococcus phage vB_SthS_VA214	2069608	S	13	37	50	0.00004
ERR6913277	Streptococcus phage CHPC950	2365054	S	10	22	32	0.00003
ERR6913277	Streptococcus phage P7133	1971422	S	6	44	50	0.00004
ERR6913277	Streptococcus phage TP-778L	1385385	S	60	53	113	0.00009
ERR6913277	Brussowvirus bvO1205	85154	S	29	10	39	0.00003
ERR6913277	Brussowvirus ALQ132	682370	S	13	10	23	0.00002
ERR6913277	Skunavirus sv96603	2845187	S	6	8	14	0.00001
ERR6913277	Human mastadenovirus C	129951	S	33	0	33	0.00003
